,COUNTYFP20,VAP,AMINVAP,PRES20D,PRES20R,OVAP,TOT_VOTES,factor,AMINVAP_pct,OVAP_pct,PRES20None,PRES20D_pct,PRES20R_pct,PRES20None_pct
0,015,873,6,69,551,867,873,1.0,0.006872852233676976,0.993127147766323,253,0.07903780068728522,0.6311569301260023,0.2898052691867125
1,015,131,7,8,63,124,131,1.0,0.05343511450381679,0.9465648854961832,60,0.061068702290076333,0.48091603053435117,0.4580152671755725
2,015,144,4,13,84,140,144,1.0,0.027777777777777776,0.9722222222222222,47,0.09027777777777778,0.5833333333333334,0.3263888888888889
3,015,1086,71,119,564,1015,1086,1.0,0.06537753222836096,0.934622467771639,403,0.10957642725598526,0.5193370165745856,0.3710865561694291
4,015,19,0,3,15,19,19,1.0,0.0,1.0,1,0.15789473684210525,0.7894736842105263,0.05263157894736842
5,015,176,1,24,61,175,176,1.0,0.005681818181818182,0.9943181818181818,91,0.13636363636363635,0.3465909090909091,0.5170454545454546
6,015,924,88,144,387,836,924,1.0,0.09523809523809523,0.9047619047619048,393,0.15584415584415584,0.41883116883116883,0.4253246753246753
7,015,244,12,36,132,232,244,1.0,0.04918032786885246,0.9508196721311475,76,0.14754098360655737,0.5409836065573771,0.3114754098360656
8,015,683,20,76,323,663,683,1.0,0.029282576866764276,0.9707174231332357,284,0.11127379209370425,0.47291361639824303,0.4158125915080527
10,003,7,0,0,0,7,7,1.0,0.0,1.0,7,0.0,0.0,1.0
11,003,860,14,267,185,846,860,1.0,0.01627906976744186,0.9837209302325581,408,0.31046511627906975,0.21511627906976744,0.4744186046511628
12,003,1599,12,428,234,1587,1599,1.0,0.0075046904315197,0.9924953095684803,937,0.267667292057536,0.14634146341463414,0.5859912445278299
13,003,2777,53,843,459,2724,2777,1.0,0.019085343896290963,0.9809146561037091,1475,0.30356499819949584,0.16528628015844438,0.5311487216420597
14,003,660,5,203,167,655,660,1.0,0.007575757575757576,0.9924242424242424,290,0.30757575757575756,0.25303030303030305,0.4393939393939394
15,003,1526,10,518,502,1516,1526,1.0,0.00655307994757536,0.9934469200524246,506,0.3394495412844037,0.3289646133682831,0.3315858453473132
16,003,1462,1,560,730,1461,1462,1.0,0.0006839945280437756,0.9993160054719562,172,0.38303693570451436,0.4993160054719562,0.11764705882352941
17,003,1010,7,324,169,1003,1010,1.0,0.006930693069306931,0.9930693069306931,517,0.3207920792079208,0.16732673267326734,0.5118811881188119
19,003,1834,29,535,432,1805,1834,1.0,0.015812431842966195,0.9841875681570338,867,0.29171210468920394,0.23555070883315157,0.4727371864776445
20,003,1442,8,377,738,1434,1442,1.0,0.005547850208044383,0.9944521497919556,327,0.26144244105409153,0.5117891816920943,0.22676837725381416
21,003,1555,3,474,685,1552,1555,1.0,0.0019292604501607716,0.9980707395498393,396,0.3048231511254019,0.4405144694533762,0.2546623794212219
22,003,714,9,82,461,705,714,1.0,0.012605042016806723,0.9873949579831933,171,0.11484593837535013,0.6456582633053222,0.23949579831932774
23,003,2027,18,586,480,2009,2027,1.0,0.008880118401578688,0.9911198815984213,961,0.28909718796250616,0.23680315737543167,0.47409965466206216
24,003,1164,7,196,83,1157,1164,1.0,0.006013745704467354,0.9939862542955327,885,0.16838487972508592,0.07130584192439862,0.7603092783505154
25,003,1930,8,655,516,1922,1930,1.0,0.004145077720207254,0.9958549222797928,759,0.3393782383419689,0.26735751295336785,0.3932642487046632
26,003,2260,34,480,686,2226,2260,1.0,0.01504424778761062,0.9849557522123894,1094,0.21238938053097345,0.3035398230088496,0.484070796460177
27,003,1599,9,516,656,1590,1599,1.0,0.005628517823639775,0.9943714821763602,427,0.3227016885553471,0.41025641025641024,0.26704190118824267
28,003,1260,12,542,238,1248,1260,1.0,0.009523809523809525,0.9904761904761905,480,0.4301587301587302,0.18888888888888888,0.38095238095238093
29,003,1286,19,418,537,1267,1286,1.0,0.014774494556765163,0.9852255054432348,331,0.3250388802488336,0.4175738724727838,0.2573872472783826
30,003,30,2,0,0,28,30,1.0,0.06666666666666667,0.9333333333333333,30,0.0,0.0,1.0
31,003,2813,49,839,566,2764,2813,1.0,0.01741912548880199,0.982580874511198,1408,0.2982580874511198,0.2012086740135087,0.5005332385353715
32,003,380,1,72,49,379,380,1.0,0.002631578947368421,0.9973684210526316,259,0.18947368421052632,0.12894736842105264,0.6815789473684211
33,003,2447,26,784,894,2421,2447,1.0,0.010625255414793625,0.9893747445852064,769,0.32039231712300775,0.3653453208009808,0.31426236207601144
34,003,3000,8,1110,1136,2992,3000,1.0,0.0026666666666666666,0.9973333333333333,754,0.37,0.37866666666666665,0.25133333333333335
35,003,1233,15,396,274,1218,1233,1.0,0.012165450121654502,0.9878345498783455,563,0.32116788321167883,0.2222222222222222,0.45660989456609896
36,003,1753,8,550,453,1745,1753,1.0,0.004563605248146035,0.995436394751854,750,0.3137478608100399,0.25841414717626926,0.4278379920136908
37,003,2659,33,511,460,2626,2659,1.0,0.01241068070703272,0.9875893192929672,1688,0.19217751034223393,0.17299736743136518,0.6348251222264009
38,003,1281,12,432,546,1269,1281,1.0,0.00936768149882904,0.990632318501171,303,0.3372365339578454,0.4262295081967213,0.23653395784543327
39,003,1473,13,447,318,1460,1473,1.0,0.008825526137135099,0.991174473862865,708,0.3034623217922607,0.2158859470468432,0.48065173116089616
40,003,2662,35,811,509,2627,2662,1.0,0.01314800901577761,0.9868519909842224,1342,0.3046581517655898,0.19120961682945153,0.5041322314049587
41,003,455,1,194,195,454,455,1.0,0.002197802197802198,0.9978021978021978,66,0.42637362637362636,0.42857142857142855,0.14505494505494507
42,003,884,21,0,0,863,884,1.0,0.023755656108597284,0.9762443438914027,884,0.0,0.0,1.0
43,003,2412,19,910,102,2393,2412,1.0,0.007877280265339967,0.99212271973466,1400,0.37728026533996684,0.04228855721393035,0.5804311774461028
44,003,3013,29,852,701,2984,3013,1.0,0.009624958513109858,0.9903750414868902,1460,0.28277464321274476,0.23265847992034516,0.4845668768669101
45,003,771,10,258,222,761,771,1.0,0.01297016861219196,0.9870298313878081,291,0.3346303501945525,0.28793774319066145,0.377431906614786
46,003,3076,15,892,833,3061,3076,1.0,0.004876462938881665,0.9951235370611183,1351,0.28998699609882966,0.27080624187256175,0.4392067620286086
48,003,2561,16,789,653,2545,2561,1.0,0.006247559547051933,0.9937524404529481,1119,0.3080827801639984,0.254978524014057,0.43693869582194456
49,003,1469,15,355,230,1454,1469,1.0,0.010211027910142955,0.989788972089857,884,0.24166099387338325,0.15656909462219196,0.6017699115044248
50,003,1151,6,283,125,1145,1151,1.0,0.005212858384013901,0.9947871416159861,743,0.24587315377932234,0.10860121633362294,0.6455256298870548
51,003,1332,5,534,407,1327,1332,1.0,0.0037537537537537537,0.9962462462462462,391,0.4009009009009009,0.3055555555555556,0.29354354354354356
52,003,62,0,0,0,62,62,1.0,0.0,1.0,62,0.0,0.0,1.0
53,003,2321,27,705,606,2294,2321,1.0,0.011632916846186989,0.988367083153813,1010,0.3037483843171047,0.26109435588108576,0.4351572598018096
54,003,742,0,69,465,742,742,1.0,0.0,1.0,208,0.09299191374663072,0.6266846361185984,0.2803234501347709
55,003,272,3,72,98,269,272,1.0,0.011029411764705883,0.9889705882352942,102,0.2647058823529412,0.3602941176470588,0.375
56,003,2995,33,1039,651,2962,2995,1.0,0.011018363939899833,0.9889816360601001,1305,0.3469115191986644,0.21736227045075127,0.4357262103505843
57,003,1933,32,617,343,1901,1933,1.0,0.016554578375581996,0.983445421624418,973,0.31919296430419036,0.17744438696326953,0.5033626487325401
58,003,2606,25,751,1018,2581,2606,1.0,0.009593246354566385,0.9904067536454336,837,0.2881811204911742,0.3906369915579432,0.3211818879508826
59,003,1490,9,505,492,1481,1490,1.0,0.006040268456375839,0.9939597315436242,493,0.3389261744966443,0.3302013422818792,0.3308724832214765
60,003,1598,15,506,675,1583,1598,1.0,0.009386733416770964,0.990613266583229,417,0.3166458072590738,0.42240300375469336,0.2609511889862328
61,003,4374,51,890,411,4323,4374,1.0,0.011659807956104253,0.9883401920438958,3073,0.2034750800182899,0.09396433470507544,0.7025605852766347
62,003,2083,13,732,708,2070,2083,1.0,0.006240998559769563,0.9937590014402304,643,0.3514162265962554,0.3398943831012962,0.3086893903024484
63,003,2544,88,603,170,2456,2544,1.0,0.03459119496855346,0.9654088050314465,1771,0.23702830188679244,0.06682389937106918,0.6961477987421384
64,003,2704,26,743,473,2678,2704,1.0,0.009615384615384616,0.9903846153846154,1488,0.27477810650887574,0.17492603550295857,0.5502958579881657
65,003,3295,57,697,161,3238,3295,1.0,0.017298937784522003,0.982701062215478,2437,0.21153262518968133,0.04886191198786039,0.7396054628224583
66,003,2186,7,734,569,2179,2186,1.0,0.003202195791399817,0.9967978042086002,883,0.3357731015553522,0.26029277218664226,0.4039341262580055
67,003,1336,3,380,419,1333,1336,1.0,0.002245508982035928,0.9977544910179641,537,0.2844311377245509,0.31362275449101795,0.40194610778443113
68,003,2338,26,717,1217,2312,2338,1.0,0.011120615911035072,0.9888793840889649,404,0.306672369546621,0.520530367835757,0.1727972626176219
69,003,1853,20,509,833,1833,1853,1.0,0.010793308148947653,0.9892066918510524,511,0.2746896923907178,0.44954128440366975,0.27576902320561253
70,003,1153,7,475,227,1146,1153,1.0,0.006071118820468344,0.9939288811795317,451,0.411968777103209,0.19687771032090198,0.391153512575889
71,003,756,2,171,400,754,756,1.0,0.0026455026455026454,0.9973544973544973,185,0.2261904761904762,0.5291005291005291,0.2447089947089947
72,003,1211,12,313,504,1199,1211,1.0,0.00990916597853014,0.9900908340214699,394,0.2584640792733278,0.4161849710982659,0.32535094962840627
73,003,1176,5,450,323,1171,1176,1.0,0.004251700680272109,0.9957482993197279,403,0.3826530612244898,0.27465986394557823,0.342687074829932
74,003,1504,8,611,587,1496,1504,1.0,0.005319148936170213,0.9946808510638298,306,0.40625,0.39029255319148937,0.20345744680851063
75,003,2392,21,756,485,2371,2392,1.0,0.008779264214046822,0.9912207357859532,1151,0.31605351170568563,0.20275919732441472,0.48118729096989965
76,003,1233,8,426,171,1225,1233,1.0,0.006488240064882401,0.9935117599351176,636,0.34549878345498786,0.1386861313868613,0.5158150851581509
77,003,285,1,51,128,284,285,1.0,0.0035087719298245615,0.9964912280701754,106,0.17894736842105263,0.44912280701754387,0.3719298245614035
78,003,2109,32,620,367,2077,2109,1.0,0.015173067804646752,0.9848269321953532,1122,0.29397818871503084,0.17401612138454245,0.5320056899004267
79,003,2310,36,514,384,2274,2310,1.0,0.015584415584415584,0.9844155844155844,1412,0.22251082251082252,0.16623376623376623,0.6112554112554113
80,003,520,5,161,179,515,520,1.0,0.009615384615384616,0.9903846153846154,180,0.3096153846153846,0.34423076923076923,0.34615384615384615
81,003,2220,37,460,279,2183,2220,1.0,0.016666666666666666,0.9833333333333333,1481,0.2072072072072072,0.12567567567567567,0.6671171171171171
82,003,1716,10,745,218,1706,1716,1.0,0.005827505827505828,0.9941724941724942,753,0.43414918414918413,0.12703962703962704,0.4388111888111888
83,003,1159,17,419,374,1142,1159,1.0,0.014667817083692839,0.9853321829163072,366,0.361518550474547,0.32269197584124243,0.3157894736842105
85,003,2742,20,948,769,2722,2742,1.0,0.007293946024799417,0.9927060539752006,1025,0.34573304157549234,0.2804522246535376,0.3738147337709701
86,003,1706,23,525,459,1683,1706,1.0,0.013481828839390387,0.9865181711606096,722,0.30773739742086753,0.2690504103165299,0.4232121922626026
87,003,1045,7,341,558,1038,1045,1.0,0.0066985645933014355,0.9933014354066986,146,0.3263157894736842,0.5339712918660288,0.1397129186602871
88,003,2215,11,734,590,2204,2215,1.0,0.004966139954853273,0.9950338600451467,891,0.3313769751693002,0.26636568848758463,0.4022573363431151
89,003,1553,2,452,659,1551,1553,1.0,0.00128783000643915,0.9987121699935608,442,0.2910495814552479,0.42433998712169996,0.28461043142305215
90,003,35,0,9,22,35,35,1.0,0.0,1.0,4,0.2571428571428571,0.6285714285714286,0.11428571428571428
92,003,3146,27,1009,741,3119,3146,1.0,0.008582326764144946,0.9914176732358551,1396,0.32072472981563893,0.23553719008264462,0.44373808010171645
93,003,1238,8,310,648,1230,1238,1.0,0.006462035541195477,0.9935379644588045,280,0.25040387722132473,0.5234248788368336,0.22617124394184168
94,003,101,3,15,23,98,101,1.0,0.0297029702970297,0.9702970297029703,63,0.1485148514851485,0.22772277227722773,0.6237623762376238
95,003,1247,19,412,320,1228,1247,1.0,0.015236567762630313,0.9847634322373697,515,0.33039294306335204,0.2566158781074579,0.41299117882919006
96,003,2219,22,479,745,2197,2219,1.0,0.009914375844975214,0.9900856241550248,995,0.21586300135196035,0.33573681838666064,0.448400180261379
97,003,1429,7,460,633,1422,1429,1.0,0.00489853044086774,0.9951014695591323,336,0.3219034289713086,0.4429671098670399,0.2351294611616515
99,003,2291,45,670,577,2246,2291,1.0,0.01964207769532955,0.9803579223046704,1044,0.29244871235268444,0.25185508511567,0.45569620253164556
100,003,291,0,111,70,291,291,1.0,0.0,1.0,110,0.38144329896907214,0.24054982817869416,0.37800687285223367
101,003,1320,5,487,391,1315,1320,1.0,0.003787878787878788,0.9962121212121212,442,0.36893939393939396,0.2962121212121212,0.33484848484848484
102,003,18,2,0,0,16,18,1.0,0.1111111111111111,0.8888888888888888,18,0.0,0.0,1.0
103,003,1467,24,476,340,1443,1467,1.0,0.016359918200409,0.983640081799591,651,0.32447171097477845,0.23176550783912747,0.4437627811860941
104,003,312,8,81,84,304,312,1.0,0.02564102564102564,0.9743589743589743,147,0.25961538461538464,0.2692307692307692,0.47115384615384615
105,003,23,1,0,0,22,23,1.0,0.043478260869565216,0.9565217391304348,23,0.0,0.0,1.0
106,003,1059,8,351,462,1051,1059,1.0,0.007554296506137866,0.9924457034938622,246,0.3314447592067989,0.43626062322946174,0.23229461756373937
107,003,3289,72,471,184,3217,3289,1.0,0.021891152325934936,0.978108847674065,2634,0.14320462146549104,0.055944055944055944,0.800851322590453
108,003,1079,11,334,330,1068,1079,1.0,0.010194624652455977,0.989805375347544,415,0.30954587581093607,0.30583873957367935,0.38461538461538464
110,003,1653,18,381,155,1635,1653,1.0,0.010889292196007259,0.9891107078039928,1117,0.23049001814882034,0.09376890502117362,0.6757410768300061
111,003,2384,27,657,360,2357,2384,1.0,0.011325503355704697,0.9886744966442953,1367,0.27558724832214765,0.15100671140939598,0.5734060402684564
112,003,1330,12,483,453,1318,1330,1.0,0.009022556390977444,0.9909774436090225,394,0.3631578947368421,0.3406015037593985,0.2962406015037594
113,003,1869,15,624,548,1854,1869,1.0,0.008025682182985553,0.9919743178170144,697,0.33386837881219905,0.29320492241840557,0.3729266987693954
114,003,1644,30,417,170,1614,1644,1.0,0.01824817518248175,0.9817518248175182,1057,0.25364963503649635,0.10340632603406326,0.6429440389294404
115,003,1818,19,652,570,1799,1818,1.0,0.010451045104510451,0.9895489548954896,596,0.3586358635863586,0.31353135313531355,0.3278327832783278
116,003,1393,5,487,390,1388,1393,1.0,0.003589375448671931,0.9964106245513281,516,0.34960516870064606,0.2799712849964106,0.3704235463029433
117,003,3055,18,802,490,3037,3055,1.0,0.005891980360065467,0.9941080196399346,1763,0.2625204582651391,0.16039279869067102,0.5770867430441898
118,003,1675,24,596,409,1651,1675,1.0,0.014328358208955224,0.9856716417910448,670,0.35582089552238805,0.24417910447761193,0.4
119,003,26,0,12,12,26,26,1.0,0.0,1.0,2,0.46153846153846156,0.46153846153846156,0.07692307692307693
120,003,46,0,14,26,46,46,1.0,0.0,1.0,6,0.30434782608695654,0.5652173913043478,0.13043478260869565
121,003,19,0,14,3,19,19,1.0,0.0,1.0,2,0.7368421052631579,0.15789473684210525,0.10526315789473684
122,003,57,0,16,38,57,57,1.0,0.0,1.0,3,0.2807017543859649,0.6666666666666666,0.05263157894736842
126,003,1239,16,399,388,1223,1239,1.0,0.0129136400322841,0.9870863599677159,452,0.3220338983050847,0.3131557707828894,0.3648103309120258
127,003,2410,29,731,524,2381,2410,1.0,0.012033195020746889,0.9879668049792532,1155,0.3033195020746888,0.2174273858921162,0.47925311203319504
128,003,197,1,56,96,196,197,1.0,0.005076142131979695,0.9949238578680203,45,0.28426395939086296,0.4873096446700508,0.22842639593908629
129,003,1062,2,440,227,1060,1062,1.0,0.0018832391713747645,0.9981167608286252,395,0.4143126177024482,0.2137476459510358,0.371939736346516
130,003,726,10,280,174,716,726,1.0,0.013774104683195593,0.9862258953168044,272,0.3856749311294766,0.2396694214876033,0.3746556473829201
131,003,906,1,345,377,905,906,1.0,0.0011037527593818985,0.9988962472406181,184,0.38079470198675497,0.41611479028697573,0.20309050772626933
132,003,6,0,0,0,6,6,1.0,0.0,1.0,6,0.0,0.0,1.0
133,003,2,0,0,0,2,2,1.0,0.0,1.0,2,0.0,0.0,1.0
134,003,1603,36,361,136,1567,1603,1.0,0.022457891453524642,0.9775421085464754,1106,0.2252027448533999,0.08484092326887087,0.6899563318777293
135,003,1699,22,438,108,1677,1699,1.0,0.012948793407886992,0.987051206592113,1153,0.2577987051206592,0.06356680400235433,0.6786344908769865
136,003,1212,1,364,267,1211,1212,1.0,0.0008250825082508251,0.9991749174917491,581,0.30033003300330036,0.2202970297029703,0.4793729372937294
137,003,3264,28,1056,901,3236,3264,1.0,0.00857843137254902,0.991421568627451,1307,0.3235294117647059,0.2760416666666667,0.40042892156862747
138,003,1569,9,613,636,1560,1569,1.0,0.0057361376673040155,0.994263862332696,320,0.3906947100063735,0.40535372848948376,0.20395156150414276
139,003,815,1,324,401,814,815,1.0,0.001226993865030675,0.9987730061349693,90,0.39754601226993863,0.4920245398773006,0.11042944785276074
140,003,818,12,262,237,806,818,1.0,0.014669926650366748,0.9853300733496333,319,0.3202933985330073,0.28973105134474325,0.3899755501222494
141,003,2553,24,897,586,2529,2553,1.0,0.009400705052878966,0.9905992949471211,1070,0.35135135135135137,0.22953388170779476,0.4191147669408539
142,003,1558,8,411,261,1550,1558,1.0,0.005134788189987163,0.9948652118100129,886,0.2637997432605905,0.16752246469833118,0.5686777920410783
144,003,156,0,48,41,156,156,1.0,0.0,1.0,67,0.3076923076923077,0.26282051282051283,0.42948717948717946
145,003,1112,14,363,315,1098,1112,1.0,0.012589928057553957,0.987410071942446,434,0.32643884892086333,0.28327338129496404,0.3902877697841727
146,003,2893,53,632,260,2840,2893,1.0,0.018320082958866227,0.9816799170411338,2001,0.21845834773591427,0.08987210508123056,0.6916695471828551
147,003,2090,12,732,655,2078,2090,1.0,0.005741626794258373,0.9942583732057416,703,0.35023923444976074,0.3133971291866029,0.33636363636363636
148,003,1115,18,204,128,1097,1115,1.0,0.016143497757847534,0.9838565022421525,783,0.18295964125560538,0.1147982062780269,0.7022421524663677
149,003,2872,9,864,1559,2863,2872,1.0,0.0031337047353760445,0.996866295264624,449,0.3008356545961003,0.5428272980501393,0.15633704735376044
150,003,1208,8,352,436,1200,1208,1.0,0.006622516556291391,0.9933774834437086,420,0.2913907284768212,0.3609271523178808,0.347682119205298
151,003,1894,11,662,666,1883,1894,1.0,0.005807814149947202,0.9941921858500528,566,0.3495248152059134,0.35163674762407604,0.2988384371700106
152,003,1642,26,482,325,1616,1642,1.0,0.015834348355663823,0.9841656516443362,835,0.2935444579780755,0.19792935444579782,0.5085261875761267
153,003,2594,55,654,367,2539,2594,1.0,0.02120277563608327,0.9787972243639167,1573,0.25212027756360833,0.14148033924441017,0.6063993831919815
155,003,2000,30,669,515,1970,2000,1.0,0.015,0.985,816,0.3345,0.2575,0.408
156,003,1594,14,542,300,1580,1594,1.0,0.00878293601003764,0.9912170639899623,752,0.34002509410288584,0.18820577164366373,0.47176913425345046
157,003,673,15,213,263,658,673,1.0,0.022288261515601784,0.9777117384843982,197,0.3164933135215453,0.39078751857355126,0.29271916790490343
158,003,74,0,14,38,74,74,1.0,0.0,1.0,22,0.1891891891891892,0.5135135135135135,0.2972972972972973
159,003,1830,7,654,577,1823,1830,1.0,0.003825136612021858,0.9961748633879781,599,0.35737704918032787,0.3153005464480874,0.3273224043715847
160,003,578,5,185,247,573,578,1.0,0.00865051903114187,0.9913494809688581,146,0.32006920415224915,0.4273356401384083,0.25259515570934254
161,003,1274,12,291,706,1262,1274,1.0,0.009419152276295133,0.9905808477237049,277,0.22841444270015698,0.554160125588697,0.217425431711146
162,003,1048,6,342,439,1042,1048,1.0,0.0057251908396946565,0.9942748091603053,267,0.32633587786259544,0.41889312977099236,0.2547709923664122
163,003,2747,32,701,305,2715,2747,1.0,0.011649071714597743,0.9883509282854023,1741,0.2551874772479068,0.11103021477975973,0.6337823079723335
164,003,410,3,141,71,407,410,1.0,0.007317073170731708,0.9926829268292683,198,0.3439024390243902,0.17317073170731706,0.48292682926829267
165,003,1630,25,404,179,1605,1630,1.0,0.015337423312883436,0.9846625766871165,1047,0.24785276073619633,0.1098159509202454,0.6423312883435582
166,003,1563,21,459,414,1542,1563,1.0,0.013435700575815739,0.9865642994241842,690,0.29366602687140114,0.2648752399232246,0.44145873320537427
167,003,44,2,11,30,42,44,1.0,0.045454545454545456,0.9545454545454546,3,0.25,0.6818181818181818,0.06818181818181818
168,003,1866,19,520,252,1847,1866,1.0,0.010182207931404072,0.9898177920685959,1094,0.27867095391211144,0.13504823151125403,0.5862808145766345
169,003,414,1,119,153,413,414,1.0,0.0024154589371980675,0.9975845410628019,142,0.28743961352657005,0.3695652173913043,0.34299516908212563
171,003,2293,8,850,561,2285,2293,1.0,0.0034888791975577847,0.9965111208024422,882,0.3706934147405146,0.24465765372873965,0.38464893153074575
172,003,958,25,287,194,933,958,1.0,0.026096033402922755,0.9739039665970772,477,0.29958246346555323,0.20250521920668058,0.4979123173277662
173,003,3405,24,841,360,3381,3405,1.0,0.007048458149779736,0.9929515418502203,2204,0.24698972099853156,0.10572687224669604,0.6472834067547724
174,003,941,6,300,245,935,941,1.0,0.006376195536663124,0.9936238044633369,396,0.3188097768331562,0.2603613177470776,0.4208289054197662
175,003,1847,16,538,201,1831,1847,1.0,0.008662696264212236,0.9913373037357878,1108,0.29128316188413644,0.10882512181916622,0.5998917162966974
176,003,1805,49,288,103,1756,1805,1.0,0.027146814404432132,0.9728531855955679,1414,0.1595567867036011,0.05706371191135734,0.7833795013850415
177,003,7,0,0,0,7,7,1.0,0.0,1.0,7,0.0,0.0,1.0
184,003,11,0,0,0,11,11,1.0,0.0,1.0,11,0.0,0.0,1.0
185,003,2,0,0,0,2,2,1.0,0.0,1.0,2,0.0,0.0,1.0
186,003,2,0,0,0,2,2,1.0,0.0,1.0,2,0.0,0.0,1.0
187,003,385,9,53,18,376,385,1.0,0.023376623376623377,0.9766233766233766,314,0.13766233766233765,0.046753246753246755,0.8155844155844156
188,003,31,0,0,0,31,31,1.0,0.0,1.0,31,0.0,0.0,1.0
189,003,5,0,0,0,5,5,1.0,0.0,1.0,5,0.0,0.0,1.0
190,003,13,0,0,0,13,13,1.0,0.0,1.0,13,0.0,0.0,1.0
192,003,43,0,20,23,43,43,3.3076923076923075,0.0,1.0,0,0.46511627906976744,0.5348837209302325,0.0
194,003,8,0,0,0,8,8,1.0,0.0,1.0,8,0.0,0.0,1.0
200,003,292,1,98,59,291,292,1.0,0.003424657534246575,0.9965753424657534,135,0.3356164383561644,0.20205479452054795,0.4623287671232877
201,003,11,2,0,0,9,11,1.0,0.18181818181818182,0.8181818181818182,11,0.0,0.0,1.0
204,003,1930,35,739,469,1895,1930,1.0,0.018134715025906734,0.9818652849740933,722,0.3829015544041451,0.24300518134715027,0.37409326424870465
206,003,1895,18,489,240,1877,1895,1.0,0.00949868073878628,0.9905013192612138,1166,0.25804749340369393,0.1266490765171504,0.6153034300791557
207,003,1517,23,469,368,1494,1517,1.0,0.015161502966381015,0.984838497033619,680,0.3091628213579433,0.24258404746209625,0.44825313117996046
208,003,1775,15,543,713,1760,1775,1.0,0.008450704225352112,0.9915492957746479,519,0.3059154929577465,0.40169014084507043,0.2923943661971831
210,003,3554,81,650,367,3473,3554,1.0,0.022791221159257174,0.9772087788407429,2537,0.18289251547552055,0.10326392796848621,0.7138435565559933
211,003,1959,20,647,309,1939,1959,1.0,0.010209290454313425,0.9897907095456866,1003,0.3302705461970393,0.15773353751914243,0.5119959162838182
212,003,3827,44,1278,999,3783,3827,1.0,0.01149725633655605,0.9885027436634439,1550,0.33394303632087796,0.26103997909589755,0.40501698458322444
213,003,3605,17,1027,1200,3588,3605,1.0,0.004715672676837725,0.9952843273231623,1378,0.2848821081830791,0.332871012482663,0.382246879334258
214,003,4,0,0,0,4,4,1.0,0.0,1.0,4,0.0,0.0,1.0
215,003,1330,18,481,249,1312,1330,1.0,0.013533834586466165,0.9864661654135338,600,0.36165413533834584,0.18721804511278195,0.45112781954887216
217,003,1775,6,613,550,1769,1775,1.0,0.0033802816901408453,0.9966197183098592,612,0.3453521126760563,0.30985915492957744,0.3447887323943662
218,003,3494,62,858,553,3432,3494,1.0,0.017744705208929592,0.9822552947910704,2083,0.2455638236977676,0.15827132226674298,0.5961648540354894
219,003,2368,33,817,612,2335,2368,1.0,0.01393581081081081,0.9860641891891891,939,0.3450168918918919,0.25844594594594594,0.39653716216216217
220,003,1571,27,366,314,1544,1571,1.0,0.01718650541056652,0.9828134945894335,891,0.23297262889879058,0.19987269255251433,0.5671546785486951
222,003,892,7,239,444,885,892,1.0,0.007847533632286996,0.992152466367713,209,0.2679372197309417,0.4977578475336323,0.23430493273542602
223,003,2723,11,915,1336,2712,2723,1.0,0.004039662137348513,0.9959603378626515,472,0.336026441424899,0.4906353286816012,0.1733382298934998
224,003,46,0,7,32,46,46,1.0,0.0,1.0,7,0.15217391304347827,0.6956521739130435,0.15217391304347827
225,003,612,6,187,22,606,612,1.0,0.00980392156862745,0.9901960784313726,403,0.3055555555555556,0.03594771241830065,0.6584967320261438
226,003,1261,5,353,624,1256,1261,1.0,0.003965107057890563,0.9960348929421095,284,0.27993655828707376,0.4948453608247423,0.22521808088818399
227,003,1221,4,487,548,1217,1221,1.0,0.003276003276003276,0.9967239967239967,186,0.3988533988533989,0.4488124488124488,0.15233415233415235
229,003,2827,25,915,986,2802,2827,1.0,0.008843296781039971,0.99115670321896,926,0.323664662186063,0.3487796250442165,0.32755571276972056
230,003,1734,1,487,608,1733,1734,1.0,0.0005767012687427913,0.9994232987312572,639,0.2808535178777393,0.3506343713956171,0.3685121107266436
231,003,2039,42,540,247,1997,2039,1.0,0.020598332515939184,0.9794016674840608,1252,0.26483570377636095,0.1211378126532614,0.6140264835703776
232,003,1419,19,476,431,1400,1419,1.0,0.013389711064129669,0.9866102889358703,512,0.3354474982381959,0.3037350246652572,0.3608174770965469
233,003,2366,37,499,146,2329,2366,1.0,0.015638207945900255,0.9843617920540998,1721,0.21090448013524937,0.06170752324598478,0.7273879966187659
234,003,3268,47,750,291,3221,3268,1.0,0.01438188494492044,0.9856181150550796,2227,0.2294981640146879,0.0890452876376989,0.6814565483476133
235,003,2289,38,627,228,2251,2289,1.0,0.016601135867190912,0.9833988641328091,1434,0.27391874180865006,0.09960681520314547,0.6264744429882044
236,003,2167,24,782,263,2143,2167,1.0,0.011075219197046609,0.9889247808029534,1122,0.360867558837102,0.12136594370096908,0.5177664974619289
238,003,1892,12,634,957,1880,1892,1.0,0.006342494714587738,0.9936575052854123,301,0.33509513742071884,0.5058139534883721,0.1590909090909091
239,003,1174,3,355,494,1171,1174,1.0,0.002555366269165247,0.9974446337308348,325,0.3023850085178876,0.42078364565587734,0.2768313458262351
240,003,1423,11,353,396,1412,1423,1.0,0.007730147575544624,0.9922698524244554,674,0.24806746310611386,0.2782853127196065,0.4736472241742797
241,003,1528,13,381,356,1515,1528,1.0,0.008507853403141362,0.9914921465968587,791,0.2493455497382199,0.23298429319371727,0.5176701570680629
242,003,2278,19,417,161,2259,2278,1.0,0.008340649692712906,0.9916593503072871,1700,0.18305531167690958,0.07067603160667252,0.746268656716418
243,003,2804,18,927,354,2786,2804,1.0,0.006419400855920114,0.9935805991440799,1523,0.3305991440798859,0.1262482168330956,0.5431526390870185
244,003,872,6,271,94,866,872,1.0,0.006880733944954129,0.9931192660550459,507,0.31077981651376146,0.10779816513761468,0.5814220183486238
245,003,1820,21,570,471,1799,1820,1.0,0.011538461538461539,0.9884615384615385,779,0.3131868131868132,0.2587912087912088,0.428021978021978
246,003,1716,46,437,241,1670,1716,1.0,0.026806526806526808,0.9731934731934732,1038,0.25466200466200467,0.14044289044289043,0.6048951048951049
247,003,1377,9,468,461,1368,1377,1.0,0.006535947712418301,0.9934640522875817,448,0.33986928104575165,0.3347857661583152,0.3253449527959332
248,003,1822,12,527,338,1810,1822,1.0,0.006586169045005488,0.9934138309549945,957,0.2892425905598244,0.18551042810098792,0.5252469813391877
249,003,746,12,173,117,734,746,1.0,0.0160857908847185,0.9839142091152815,456,0.23190348525469168,0.15683646112600536,0.6112600536193029
250,003,2319,41,578,592,2278,2319,1.0,0.017680034497628287,0.9823199655023717,1149,0.2492453643811988,0.25528244933160843,0.49547218628719275
251,003,1080,5,404,272,1075,1080,1.0,0.004629629629629629,0.9953703703703703,404,0.37407407407407406,0.2518518518518518,0.37407407407407406
253,003,942,1,310,380,941,942,1.0,0.0010615711252653928,0.9989384288747346,252,0.32908704883227174,0.4033970276008493,0.267515923566879
254,003,1089,2,412,417,1087,1089,1.0,0.0018365472910927456,0.9981634527089073,260,0.3783287419651056,0.38292011019283745,0.23875114784205692
255,003,20,2,0,0,18,20,1.0,0.1,0.9,20,0.0,0.0,1.0
257,003,910,5,288,467,905,910,1.0,0.005494505494505495,0.9945054945054945,155,0.31648351648351647,0.5131868131868131,0.17032967032967034
258,003,1855,12,485,276,1843,1855,1.0,0.00646900269541779,0.9935309973045822,1094,0.261455525606469,0.14878706199460917,0.5897574123989219
259,003,1086,3,421,401,1083,1086,1.0,0.0027624309392265192,0.9972375690607734,264,0.3876611418047882,0.3692449355432781,0.2430939226519337
261,003,942,15,316,217,927,942,1.0,0.01592356687898089,0.9840764331210191,409,0.3354564755838641,0.23036093418259024,0.43418259023354566
262,003,3045,25,891,775,3020,3045,1.0,0.008210180623973728,0.9917898193760263,1379,0.29261083743842364,0.2545155993431856,0.4528735632183908
263,003,1670,27,681,284,1643,1670,1.0,0.016167664670658683,0.9838323353293413,705,0.40778443113772456,0.17005988023952096,0.4221556886227545
265,003,2285,45,675,230,2240,2285,1.0,0.019693654266958426,0.9803063457330415,1380,0.29540481400437635,0.10065645514223195,0.6039387308533917
266,003,1657,20,475,689,1637,1657,1.0,0.012070006035003017,0.987929993964997,493,0.2866626433313217,0.415811707905854,0.2975256487628244
267,003,905,0,278,355,905,905,1.0,0.0,1.0,272,0.30718232044198895,0.39226519337016574,0.3005524861878453
268,003,41,0,6,20,41,41,1.0,0.0,1.0,15,0.14634146341463414,0.4878048780487805,0.36585365853658536
269,003,1828,48,453,294,1780,1828,1.0,0.0262582056892779,0.973741794310722,1081,0.24781181619256018,0.16083150984682712,0.5913566739606126
270,003,1309,29,306,154,1280,1309,1.0,0.02215431627196333,0.9778456837280367,849,0.23376623376623376,0.11764705882352941,0.6485867074102368
271,003,1625,12,594,349,1613,1625,1.0,0.0073846153846153844,0.9926153846153846,682,0.36553846153846153,0.21476923076923077,0.4196923076923077
272,003,3,0,0,0,3,3,1.0,0.0,1.0,3,0.0,0.0,1.0
273,003,399,2,109,116,397,399,1.0,0.005012531328320802,0.9949874686716792,174,0.2731829573934837,0.2907268170426065,0.43609022556390975
274,003,1951,22,556,515,1929,1951,1.0,0.011276268580215274,0.9887237314197848,880,0.2849820604818042,0.2639671963095848,0.451050743208611
275,003,1121,4,283,202,1117,1121,1.0,0.003568242640499554,0.9964317573595004,636,0.25245316681534347,0.1801962533452275,0.567350579839429
276,003,1806,30,480,282,1776,1806,1.0,0.016611295681063124,0.9833887043189369,1044,0.26578073089701,0.15614617940199335,0.5780730897009967
277,003,1098,6,517,261,1092,1098,1.0,0.00546448087431694,0.994535519125683,320,0.470856102003643,0.23770491803278687,0.29143897996357016
278,003,1512,17,556,237,1495,1512,1.0,0.011243386243386243,0.9887566137566137,719,0.36772486772486773,0.15674603174603174,0.4755291005291005
279,003,1620,25,425,204,1595,1620,1.0,0.015432098765432098,0.9845679012345679,991,0.2623456790123457,0.1259259259259259,0.6117283950617284
280,003,1287,28,337,193,1259,1287,1.0,0.021756021756021756,0.9782439782439782,757,0.2618492618492618,0.14996114996114995,0.5881895881895882
281,003,1578,9,477,343,1569,1578,1.0,0.005703422053231939,0.9942965779467681,758,0.30228136882129275,0.2173637515842839,0.4803548795944233
282,003,353,5,53,69,348,353,1.0,0.014164305949008499,0.9858356940509915,231,0.1501416430594901,0.1954674220963173,0.6543909348441926
283,003,1800,24,472,161,1776,1800,1.0,0.013333333333333334,0.9866666666666667,1167,0.26222222222222225,0.08944444444444444,0.6483333333333333
284,003,1197,10,406,384,1187,1197,1.0,0.00835421888053467,0.9916457811194653,407,0.3391812865497076,0.3208020050125313,0.34001670843776105
286,003,4,0,0,0,4,4,1.0,0.0,1.0,4,0.0,0.0,1.0
288,003,1677,10,527,354,1667,1677,1.0,0.005963029218843173,0.9940369707811568,796,0.31425163983303517,0.2110912343470483,0.47465712581991654
289,003,1802,5,546,526,1797,1802,1.0,0.002774694783573807,0.9972253052164262,730,0.3029966703662597,0.29189789123196447,0.4051054384017758
290,003,10,0,0,0,10,10,1.0,0.0,1.0,10,0.0,0.0,1.0
291,003,2050,22,606,432,2028,2050,1.0,0.010731707317073172,0.9892682926829268,1012,0.29560975609756096,0.21073170731707316,0.49365853658536585
292,003,1911,3,616,736,1908,1911,1.0,0.0015698587127158557,0.9984301412872841,559,0.32234432234432236,0.38513867085295656,0.2925170068027211
293,003,2162,27,435,134,2135,2162,1.0,0.012488436632747455,0.9875115633672525,1593,0.20120259019426456,0.061979648473635525,0.7368177613320999
294,003,1753,30,502,880,1723,1753,1.0,0.017113519680547633,0.9828864803194524,371,0.28636622932116373,0.5019965772960638,0.2116371933827724
295,003,1669,21,502,274,1648,1669,1.0,0.012582384661473937,0.987417615338526,893,0.3007789095266627,0.16417016177351706,0.5350509286998203
296,003,1247,8,478,442,1239,1247,1.0,0.006415396952686447,0.9935846030473136,327,0.38331996792301526,0.35445068163592625,0.26222935044105855
297,003,2046,9,726,854,2037,2046,1.0,0.004398826979472141,0.9956011730205279,466,0.3548387096774194,0.4173998044965787,0.22776148582600195
298,003,1546,28,350,197,1518,1546,1.0,0.018111254851228976,0.981888745148771,999,0.22639068564036222,0.12742561448900389,0.6461836998706338
299,003,793,1,236,363,792,793,1.0,0.0012610340479192938,0.9987389659520807,194,0.29760403530895335,0.45775535939470363,0.244640605296343
300,003,2640,21,775,431,2619,2640,1.0,0.007954545454545454,0.9920454545454546,1434,0.2935606060606061,0.16325757575757577,0.5431818181818182
302,003,2108,41,551,126,2067,2108,1.0,0.019449715370018977,0.9805502846299811,1431,0.26138519924098674,0.05977229601518026,0.678842504743833
303,003,1323,14,385,471,1309,1323,1.0,0.010582010582010581,0.9894179894179894,467,0.291005291005291,0.35600907029478457,0.3529856386999244
304,003,1210,4,406,426,1206,1210,1.0,0.003305785123966942,0.996694214876033,378,0.33553719008264465,0.35206611570247937,0.31239669421487604
305,003,1246,11,484,398,1235,1246,1.0,0.00882825040128411,0.9911717495987159,364,0.3884430176565008,0.31942215088282505,0.29213483146067415
307,003,3072,54,1005,388,3018,3072,1.0,0.017578125,0.982421875,1679,0.3271484375,0.12630208333333334,0.5465494791666666
308,003,2325,14,670,1197,2311,2325,1.0,0.006021505376344086,0.993978494623656,458,0.28817204301075267,0.5148387096774194,0.19698924731182796
310,003,1809,13,550,412,1796,1809,1.0,0.007186290768380321,0.9928137092316197,847,0.30403537866224434,0.22775013819789938,0.46821448313985625
311,003,2948,83,802,301,2865,2948,1.0,0.028154681139755767,0.9718453188602443,1845,0.27204884667571233,0.10210312075983717,0.6258480325644504
312,003,1109,7,423,464,1102,1109,1.0,0.0063119927862939585,0.9936880072137061,222,0.3814247069431921,0.41839495040577096,0.20018034265103696
313,003,579,6,131,41,573,579,1.0,0.010362694300518135,0.9896373056994818,407,0.22625215889464595,0.07081174438687392,0.7029360967184801
314,003,2370,45,737,432,2325,2370,1.0,0.0189873417721519,0.9810126582278481,1201,0.3109704641350211,0.18227848101265823,0.5067510548523206
315,003,1687,11,496,428,1676,1687,1.0,0.006520450503852994,0.993479549496147,763,0.2940130409010077,0.25370480142264373,0.45228215767634855
316,003,2265,23,823,472,2242,2265,1.0,0.010154525386313467,0.9898454746136865,970,0.363355408388521,0.20838852097130242,0.4282560706401766
317,003,2495,20,822,689,2475,2495,1.0,0.008016032064128256,0.9919839679358717,984,0.3294589178356713,0.2761523046092184,0.3943887775551102
318,003,1431,14,524,465,1417,1431,1.0,0.009783368273934312,0.9902166317260657,442,0.36617749825296997,0.3249475890985325,0.30887491264849753
319,003,1478,2,427,668,1476,1478,1.0,0.0013531799729364006,0.9986468200270636,383,0.2889039242219215,0.4519621109607578,0.2591339648173207
320,003,1567,6,503,563,1561,1567,1.0,0.0038289725590299937,0.99617102744097,501,0.3209955328653478,0.35928525845564774,0.31971920867900444
321,003,2696,64,632,161,2632,2696,1.0,0.02373887240356083,0.9762611275964391,1903,0.2344213649851632,0.059718100890207716,0.7058605341246291
322,003,1177,2,489,494,1175,1177,1.0,0.0016992353440951572,0.9983007646559049,194,0.4154630416312659,0.41971112999150384,0.16482582837723025
323,003,249,1,63,128,248,249,1.0,0.004016064257028112,0.9959839357429718,58,0.25301204819277107,0.5140562248995983,0.23293172690763053
325,003,665,8,157,279,657,665,1.0,0.012030075187969926,0.98796992481203,229,0.23609022556390977,0.4195488721804511,0.3443609022556391
326,003,1410,14,396,291,1396,1410,1.0,0.009929078014184398,0.9900709219858156,723,0.28085106382978725,0.20638297872340425,0.5127659574468085
327,003,1821,19,426,768,1802,1821,1.0,0.01043382756727073,0.9895661724327293,627,0.23393739703459637,0.42174629324546953,0.3443163097199341
328,003,1138,40,496,65,1098,1138,1.0,0.0351493848857645,0.9648506151142355,577,0.4358523725834798,0.05711775043936731,0.5070298769771528
329,003,1021,11,377,348,1010,1021,1.0,0.010773751224289911,0.9892262487757101,296,0.3692458374142997,0.34084231145935356,0.2899118511263467
330,003,2117,26,602,381,2091,2117,1.0,0.01228153046764289,0.9877184695323571,1134,0.2843646669815777,0.17997165800661313,0.5356636750118091
331,003,843,3,445,262,840,843,1.0,0.0035587188612099642,0.99644128113879,136,0.527876631079478,0.3107947805456702,0.16132858837485173
332,003,2023,19,598,500,2004,2023,1.0,0.009391992090954029,0.990608007909046,925,0.29560059317844783,0.24715768660405338,0.45724172021749876
333,003,197,2,45,116,195,197,1.0,0.01015228426395939,0.9898477157360406,36,0.22842639593908629,0.5888324873096447,0.18274111675126903
336,003,1386,11,427,485,1375,1386,1.0,0.007936507936507936,0.9920634920634921,474,0.30808080808080807,0.3499278499278499,0.341991341991342
337,003,727,4,194,187,723,727,1.0,0.005502063273727648,0.9944979367262724,346,0.2668500687757909,0.25722145804676755,0.4759284731774415
338,003,17,0,0,0,17,17,1.0,0.0,1.0,17,0.0,0.0,1.0
339,003,1196,11,373,378,1185,1196,1.0,0.00919732441471572,0.9908026755852842,445,0.31187290969899667,0.31605351170568563,0.3720735785953177
341,003,138,0,29,85,138,138,1.0,0.0,1.0,24,0.21014492753623187,0.6159420289855072,0.17391304347826086
342,003,849,7,256,166,842,849,1.0,0.008244994110718492,0.9917550058892816,427,0.30153121319199055,0.1955241460541814,0.502944640753828
343,003,1197,9,355,336,1188,1197,1.0,0.007518796992481203,0.9924812030075187,506,0.29657477025898077,0.2807017543859649,0.4227234753550543
345,003,1047,11,288,185,1036,1047,1.0,0.010506208213944603,0.9894937917860553,574,0.27507163323782235,0.1766953199617956,0.5482330468003821
346,003,127,0,44,54,127,127,1.0,0.0,1.0,29,0.3464566929133858,0.4251968503937008,0.2283464566929134
347,003,207,7,41,48,200,207,1.0,0.033816425120772944,0.966183574879227,118,0.19806763285024154,0.2318840579710145,0.5700483091787439
348,003,9,0,0,0,9,9,1.0,0.0,1.0,9,0.0,0.0,1.0
349,003,2560,30,961,227,2530,2560,1.0,0.01171875,0.98828125,1372,0.375390625,0.088671875,0.5359375
350,003,1210,1,466,403,1209,1210,1.0,0.0008264462809917355,0.9991735537190083,341,0.3851239669421488,0.3330578512396694,0.2818181818181818
351,003,3590,14,1051,1035,3576,3590,1.0,0.0038997214484679664,0.996100278551532,1504,0.2927576601671309,0.2883008356545961,0.41894150417827297
352,003,1601,12,532,585,1589,1601,1.0,0.007495315427857589,0.9925046845721424,484,0.33229231730168646,0.3653966271080575,0.3023110555902561
353,003,2175,22,575,981,2153,2175,1.0,0.010114942528735632,0.9898850574712643,619,0.26436781609195403,0.4510344827586207,0.2845977011494253
354,003,2302,104,567,230,2198,2302,1.0,0.045178105994787145,0.9548218940052129,1505,0.2463075586446568,0.0999131190269331,0.6537793223284101
356,003,1934,23,623,548,1911,1934,1.0,0.011892450879007239,0.9881075491209927,763,0.32213029989658737,0.28335056876938985,0.3945191313340228
357,003,1192,25,336,140,1167,1192,1.0,0.02097315436241611,0.9790268456375839,716,0.28187919463087246,0.1174496644295302,0.6006711409395973
358,003,1731,11,618,567,1720,1731,1.0,0.006354708261120739,0.9936452917388793,546,0.35701906412478335,0.3275563258232236,0.31542461005199307
359,003,23,0,0,0,23,23,1.0,0.0,1.0,23,0.0,0.0,1.0
360,003,914,8,239,121,906,914,1.0,0.0087527352297593,0.9912472647702407,554,0.2614879649890591,0.1323851203501094,0.6061269146608315
361,003,1441,2,516,710,1439,1441,1.0,0.0013879250520471894,0.9986120749479528,215,0.35808466342817485,0.49271339347675225,0.14920194309507287
362,003,1269,21,258,160,1248,1269,1.0,0.016548463356973995,0.983451536643026,851,0.2033096926713948,0.12608353033884948,0.6706067769897557
363,003,50,0,8,34,50,50,1.0,0.0,1.0,8,0.16,0.68,0.16
364,003,1721,28,521,420,1693,1721,1.0,0.016269610691458453,0.9837303893085415,780,0.3027309703660662,0.24404416037187682,0.45322486926205696
365,003,764,2,212,473,762,764,1.0,0.002617801047120419,0.9973821989528796,79,0.2774869109947644,0.6191099476439791,0.10340314136125654
367,003,1024,5,341,348,1019,1024,1.0,0.0048828125,0.9951171875,335,0.3330078125,0.33984375,0.3271484375
369,003,1746,11,598,703,1735,1746,1.0,0.006300114547537228,0.9936998854524628,445,0.3424971363115693,0.40263459335624285,0.25486827033218784
370,003,1523,18,495,272,1505,1523,1.0,0.011818778726198293,0.9881812212738017,756,0.325016414970453,0.17859487852921865,0.4963887065003283
371,003,2705,32,943,627,2673,2705,1.0,0.011829944547134935,0.9881700554528651,1135,0.34861367837338264,0.23179297597042514,0.4195933456561922
372,003,937,20,283,177,917,937,1.0,0.021344717182497332,0.9786552828175027,477,0.30202774813233724,0.18890074706510138,0.5090715048025614
373,003,1174,10,348,236,1164,1174,1.0,0.008517887563884156,0.9914821124361158,590,0.29642248722316866,0.2010221465076661,0.5025553662691652
374,003,1224,21,344,191,1203,1224,1.0,0.01715686274509804,0.9828431372549019,689,0.28104575163398693,0.15604575163398693,0.5629084967320261
375,003,2167,10,575,324,2157,2167,1.0,0.0046146746654360865,0.9953853253345639,1268,0.265343793262575,0.1495154591601292,0.5851407475772958
377,003,2353,35,790,651,2318,2353,1.0,0.014874628134296642,0.9851253718657034,912,0.3357416064598385,0.27666808329791753,0.38759031024224394
378,003,1939,10,600,467,1929,1939,1.0,0.005157297576070139,0.9948427024239299,872,0.30943785456420836,0.2408457968024755,0.44971634863331617
379,003,77,0,29,18,77,77,1.0,0.0,1.0,30,0.37662337662337664,0.23376623376623376,0.38961038961038963
380,003,1844,3,620,592,1841,1844,1.0,0.0016268980477223427,0.9983731019522777,632,0.3362255965292842,0.3210412147505423,0.34273318872017355
381,003,2200,18,697,607,2182,2200,1.0,0.008181818181818182,0.9918181818181818,896,0.31681818181818183,0.2759090909090909,0.4072727272727273
382,003,806,6,269,290,800,806,1.0,0.007444168734491315,0.9925558312655087,247,0.3337468982630273,0.3598014888337469,0.3064516129032258
383,003,2082,24,541,303,2058,2082,1.0,0.011527377521613832,0.9884726224783862,1238,0.2598463016330452,0.14553314121037464,0.5946205571565802
387,003,1394,14,455,338,1380,1394,1.0,0.010043041606886656,0.9899569583931134,601,0.32639885222381637,0.242467718794835,0.43113342898134865
388,003,1213,20,440,435,1193,1213,1.0,0.016488046166529265,0.9835119538334708,338,0.36273701566364386,0.3586150041220115,0.2786479802143446
389,003,925,10,261,201,915,925,1.0,0.010810810810810811,0.9891891891891892,463,0.28216216216216217,0.2172972972972973,0.5005405405405405
390,003,92,0,11,32,92,92,1.0,0.0,1.0,49,0.11956521739130435,0.34782608695652173,0.532608695652174
392,003,237,2,60,44,235,237,1.0,0.008438818565400843,0.9915611814345991,133,0.25316455696202533,0.18565400843881857,0.5611814345991561
393,003,398,5,65,37,393,398,1.0,0.01256281407035176,0.9874371859296482,296,0.16331658291457288,0.09296482412060302,0.7437185929648241
394,003,58,0,20,34,58,58,1.0,0.0,1.0,4,0.3448275862068966,0.5862068965517241,0.06896551724137931
395,003,3,0,0,0,3,3,1.0,0.0,1.0,3,0.0,0.0,1.0
397,003,7,0,0,0,7,7,1.0,0.0,1.0,7,0.0,0.0,1.0
398,003,668,4,147,44,664,668,1.0,0.005988023952095809,0.9940119760479041,477,0.22005988023952097,0.0658682634730539,0.7140718562874252
399,003,1,0,0,0,1,1,1.0,0.0,1.0,1,0.0,0.0,1.0
400,003,1177,11,464,386,1166,1177,1.0,0.009345794392523364,0.9906542056074766,327,0.39422259983007646,0.32795242141036535,0.2778249787595582
401,003,15,0,7,8,15,15,1.6666666666666667,0.0,1.0,0,0.4666666666666667,0.5333333333333333,0.0
402,003,196,0,51,138,196,196,1.0,0.0,1.0,7,0.2602040816326531,0.7040816326530612,0.03571428571428571
403,003,1,0,0,0,1,1,1.0,0.0,1.0,1,0.0,0.0,1.0
410,003,2614,15,801,681,2599,2614,1.0,0.005738332058148432,0.9942616679418516,1132,0.30642693190512627,0.2605202754399388,0.43305279265493496
411,003,1271,14,379,348,1257,1271,1.0,0.011014948859166011,0.988985051140834,544,0.2981904012588513,0.2738001573564123,0.42800944138473646
412,003,245,3,39,94,242,245,1.0,0.012244897959183673,0.9877551020408163,112,0.15918367346938775,0.3836734693877551,0.45714285714285713
414,003,739,1,52,50,738,739,1.0,0.0013531799729364006,0.9986468200270636,637,0.07036535859269283,0.06765899864682003,0.8619756427604871
415,003,1747,16,448,861,1731,1747,1.0,0.009158557527189467,0.9908414424728106,438,0.2564396107613051,0.4928448769318832,0.25071551230681166
416,003,1512,4,616,651,1508,1512,1.0,0.0026455026455026454,0.9973544973544973,245,0.4074074074074074,0.4305555555555556,0.16203703703703703
417,003,4366,13,1757,1856,4353,4366,1.0,0.002977553825011452,0.9970224461749886,753,0.40242785158039396,0.42510306917086577,0.17246907924874028
418,003,700,24,72,24,676,700,1.0,0.03428571428571429,0.9657142857142857,604,0.10285714285714286,0.03428571428571429,0.8628571428571429
419,003,202,1,20,31,201,202,1.0,0.0049504950495049506,0.995049504950495,151,0.09900990099009901,0.15346534653465346,0.7475247524752475
420,003,2609,20,866,523,2589,2609,1.0,0.007665772326561901,0.9923342276734382,1220,0.3319279417401303,0.20045994633959371,0.46761211192027596
421,003,3451,69,907,444,3382,3451,1.0,0.01999420457838308,0.9800057954216169,2100,0.2628223703274413,0.12865835989568242,0.6085192697768763
422,003,1988,34,718,326,1954,1988,1.0,0.01710261569416499,0.9828973843058351,944,0.3611670020120724,0.16398390342052313,0.47484909456740443
423,003,750,1,101,322,749,750,1.0,0.0013333333333333333,0.9986666666666667,327,0.13466666666666666,0.42933333333333334,0.436
424,003,3227,33,812,411,3194,3227,1.0,0.010226216299969011,0.989773783700031,2004,0.25162689804772237,0.12736287573597768,0.6210102262163
425,003,714,5,240,281,709,714,1.0,0.0070028011204481795,0.9929971988795518,193,0.33613445378151263,0.39355742296918766,0.2703081232492997
426,003,1649,12,188,938,1637,1649,1.0,0.0072771376591873865,0.9927228623408126,523,0.11400848999393572,0.5688295936931473,0.3171619163129169
428,003,3157,10,735,1510,3147,3157,1.0,0.0031675641431738993,0.9968324358568261,912,0.2328159645232816,0.4783021856192588,0.2888818498574596
429,003,3017,11,901,693,3006,3017,1.0,0.003646005966191581,0.9963539940338084,1423,0.29864103413987403,0.2296983758700696,0.47166058999005633
430,003,1197,10,245,666,1187,1197,1.0,0.00835421888053467,0.9916457811194653,286,0.2046783625730994,0.556390977443609,0.23893065998329155
431,003,1931,11,620,509,1920,1931,1.0,0.005696530295183843,0.9943034697048162,802,0.32107716209218023,0.26359399274987055,0.41532884515794927
432,003,2569,15,700,498,2554,2569,1.0,0.0058388478007006615,0.9941611521992993,1371,0.2724795640326976,0.19384974698326196,0.5336706889840405
433,003,1841,45,447,225,1796,1841,1.0,0.024443237370994023,0.9755567626290059,1169,0.242802824551874,0.12221618685497013,0.6349809885931559
434,003,1655,12,453,316,1643,1655,1.0,0.0072507552870090634,0.992749244712991,886,0.2737160120845921,0.19093655589123867,0.5353474320241692
435,003,1509,11,383,826,1498,1509,1.0,0.00728959575878065,0.9927104042412194,300,0.2538104705102717,0.5473823724320742,0.1988071570576541
436,003,1233,8,405,513,1225,1233,1.0,0.006488240064882401,0.9935117599351176,315,0.3284671532846715,0.41605839416058393,0.25547445255474455
437,003,1575,10,530,690,1565,1575,1.0,0.006349206349206349,0.9936507936507937,355,0.33650793650793653,0.4380952380952381,0.2253968253968254
438,003,2193,40,480,349,2153,2193,1.0,0.01823985408116735,0.9817601459188326,1364,0.2188782489740082,0.15914272685818515,0.6219790241678067
440,003,1876,2,695,495,1874,1876,1.0,0.0010660980810234541,0.9989339019189766,686,0.3704690831556503,0.2638592750533049,0.3656716417910448
441,003,6,0,0,0,6,6,1.0,0.0,1.0,6,0.0,0.0,1.0
442,003,1138,0,364,318,1138,1138,1.0,0.0,1.0,456,0.31985940246045697,0.27943760984182775,0.4007029876977153
443,003,123,1,6,10,122,123,1.0,0.008130081300813009,0.991869918699187,107,0.04878048780487805,0.08130081300813008,0.8699186991869918
444,003,1492,27,550,272,1465,1492,1.0,0.018096514745308313,0.9819034852546917,670,0.36863270777479895,0.18230563002680966,0.44906166219839144
445,003,2191,28,612,293,2163,2191,1.0,0.012779552715654952,0.987220447284345,1286,0.27932450935645825,0.13372889091738932,0.5869465997261525
446,003,31,1,7,17,30,31,1.0,0.03225806451612903,0.967741935483871,7,0.22580645161290322,0.5483870967741935,0.22580645161290322
447,003,3150,20,826,405,3130,3150,1.0,0.006349206349206349,0.9936507936507937,1919,0.26222222222222225,0.12857142857142856,0.6092063492063492
448,003,1832,10,483,989,1822,1832,1.0,0.0054585152838427945,0.9945414847161572,360,0.263646288209607,0.5398471615720524,0.1965065502183406
449,003,1471,2,461,507,1469,1471,1.0,0.0013596193065941536,0.9986403806934059,503,0.3133922501699524,0.34466349422161796,0.3419442556084296
450,003,4619,15,1320,989,4604,4619,1.0,0.003247456159341849,0.9967525438406581,2310,0.2857761420220827,0.21411560943927258,0.5001082485386448
451,003,1249,20,213,26,1229,1249,1.0,0.016012810248198558,0.9839871897518014,1010,0.17053642914331466,0.020816653322658127,0.8086469175340272
452,003,964,10,274,458,954,964,1.0,0.01037344398340249,0.9896265560165975,232,0.2842323651452282,0.475103734439834,0.24066390041493776
453,003,2645,16,849,782,2629,2645,1.0,0.0060491493383742915,0.9939508506616257,1014,0.3209829867674858,0.2956521739130435,0.3833648393194707
454,003,2245,17,657,576,2228,2245,1.0,0.0075723830734966595,0.9924276169265034,1012,0.29265033407572383,0.25657015590200444,0.45077951002227173
455,003,3203,13,787,1653,3190,3203,1.0,0.004058694973462379,0.9959413050265377,763,0.2457071495472994,0.516078676241024,0.23821417421167657
456,003,1513,14,453,336,1499,1513,1.0,0.009253139458030404,0.9907468605419696,724,0.29940515532055517,0.22207534699272968,0.47851949768671515
459,003,2210,37,286,80,2173,2210,1.0,0.0167420814479638,0.9832579185520361,1844,0.12941176470588237,0.03619909502262444,0.8343891402714932
460,003,6,0,0,0,6,6,1.0,0.0,1.0,6,0.0,0.0,1.0
461,003,5,0,0,0,5,5,1.0,0.0,1.0,5,0.0,0.0,1.0
463,003,925,10,285,266,915,925,1.0,0.010810810810810811,0.9891891891891892,374,0.3081081081081081,0.2875675675675676,0.4043243243243243
464,003,328,3,98,136,325,328,1.0,0.009146341463414634,0.9908536585365854,94,0.29878048780487804,0.4146341463414634,0.2865853658536585
466,003,363,0,155,93,363,363,1.0,0.0,1.0,115,0.42699724517906334,0.256198347107438,0.3168044077134986
467,003,768,0,274,186,768,768,1.0,0.0,1.0,308,0.3567708333333333,0.2421875,0.4010416666666667
468,003,68,2,27,30,66,68,1.0,0.029411764705882353,0.9705882352941176,11,0.39705882352941174,0.4411764705882353,0.16176470588235295
469,003,2532,34,787,376,2498,2532,1.0,0.013428120063191154,0.9865718799368088,1369,0.3108214849921011,0.1484992101105845,0.5406793048973144
470,003,762,10,211,243,752,762,1.0,0.013123359580052493,0.9868766404199475,308,0.2769028871391076,0.3188976377952756,0.4041994750656168
471,003,67,0,0,0,67,67,1.0,0.0,1.0,67,0.0,0.0,1.0
473,003,1862,14,642,684,1848,1862,1.0,0.007518796992481203,0.9924812030075187,536,0.3447905477980666,0.3673469387755102,0.2878625134264232
475,003,999,5,352,350,994,999,1.0,0.005005005005005005,0.994994994994995,297,0.35235235235235235,0.35035035035035034,0.2972972972972973
476,003,1,1,0,0,0,1,1.0,1.0,0.0,1,0.0,0.0,1.0
477,003,1309,20,435,338,1289,1309,1.0,0.015278838808250574,0.9847211611917495,536,0.33231474407944994,0.2582123758594347,0.4094728800611154
478,003,30,0,6,20,30,30,1.0,0.0,1.0,4,0.2,0.6666666666666666,0.13333333333333333
479,003,665,2,164,372,663,665,1.0,0.0030075187969924814,0.9969924812030075,129,0.24661654135338346,0.5593984962406015,0.19398496240601504
480,003,1532,11,516,382,1521,1532,1.0,0.007180156657963447,0.9928198433420365,634,0.3368146214099217,0.24934725848563968,0.41383812010443866
481,003,366,13,82,20,353,366,1.0,0.03551912568306011,0.9644808743169399,264,0.22404371584699453,0.0546448087431694,0.7213114754098361
483,003,1424,42,387,196,1382,1424,1.0,0.02949438202247191,0.9705056179775281,841,0.2717696629213483,0.13764044943820225,0.5905898876404494
484,003,536,1,170,215,535,536,1.0,0.0018656716417910447,0.9981343283582089,151,0.31716417910447764,0.40111940298507465,0.28171641791044777
485,003,857,8,283,256,849,857,1.0,0.009334889148191364,0.9906651108518086,318,0.33022170361726955,0.29871645274212366,0.3710618436406068
486,003,451,7,111,55,444,451,1.0,0.015521064301552107,0.9844789356984479,285,0.24611973392461198,0.12195121951219512,0.6319290465631929
487,003,1362,14,449,364,1348,1362,1.0,0.010279001468428781,0.9897209985315712,549,0.32966226138032306,0.26725403817914833,0.40308370044052866
488,003,1026,9,338,161,1017,1026,1.0,0.008771929824561403,0.9912280701754386,527,0.32943469785575047,0.15692007797270954,0.51364522417154
490,003,1,0,0,0,1,1,1.0,0.0,1.0,1,0.0,0.0,1.0
492,003,81,1,32,36,80,81,1.0,0.012345679012345678,0.9876543209876543,13,0.3950617283950617,0.4444444444444444,0.16049382716049382
495,003,7,0,0,0,7,7,1.0,0.0,1.0,7,0.0,0.0,1.0
496,003,3,1,0,0,2,3,1.0,0.3333333333333333,0.6666666666666666,3,0.0,0.0,1.0
497,003,4,0,0,0,4,4,1.0,0.0,1.0,4,0.0,0.0,1.0
499,003,320,0,104,49,320,320,1.0,0.0,1.0,167,0.325,0.153125,0.521875
500,003,14,0,6,8,14,14,1.2727272727272727,0.0,1.0,0,0.42857142857142855,0.5714285714285714,0.0
501,003,426,0,149,112,426,426,1.0,0.0,1.0,165,0.34976525821596244,0.26291079812206575,0.3873239436619718
502,003,311,0,167,110,311,311,1.0,0.0,1.0,34,0.5369774919614148,0.3536977491961415,0.10932475884244373
504,003,1698,12,483,483,1686,1698,1.0,0.007067137809187279,0.9929328621908127,732,0.284452296819788,0.284452296819788,0.43109540636042404
505,003,1081,1,402,434,1080,1081,1.0,0.0009250693802035153,0.9990749306197965,245,0.37187789084181316,0.40148011100832565,0.22664199814986125
506,003,1414,37,290,122,1377,1414,1.0,0.02616690240452617,0.9738330975954739,1002,0.2050919377652051,0.08628005657708628,0.7086280056577087
507,003,1634,0,575,774,1634,1634,1.0,0.0,1.0,285,0.3518971848225214,0.47368421052631576,0.1744186046511628
508,003,570,3,126,206,567,570,1.0,0.005263157894736842,0.9947368421052631,238,0.22105263157894736,0.36140350877192984,0.41754385964912283
509,003,3439,27,1047,743,3412,3439,1.0,0.007851119511485897,0.9921488804885141,1649,0.30444896772317537,0.21605117766792672,0.47949985460889794
510,003,2171,54,440,161,2117,2171,1.0,0.02487333026255182,0.9751266697374482,1570,0.2026715799170889,0.07415937356057116,0.7231690465223399
512,003,2943,45,694,453,2898,2943,1.0,0.01529051987767584,0.9847094801223242,1796,0.23581379544682296,0.15392456676860347,0.6102616377845735
513,003,3193,22,916,657,3171,3193,1.0,0.006890072032571249,0.9931099279674287,1620,0.28687754462887566,0.20576260569996868,0.5073598496711557
514,003,2713,19,877,778,2694,2713,1.0,0.007003317360855142,0.9929966826391449,1058,0.3232583855510505,0.2867674161444895,0.38997419830446
515,003,979,34,350,112,945,979,1.0,0.03472931562819203,0.965270684371808,517,0.3575076608784474,0.11440245148110317,0.5280898876404494
516,003,1790,23,506,298,1767,1790,1.0,0.012849162011173185,0.9871508379888269,986,0.28268156424581004,0.1664804469273743,0.5508379888268157
517,003,1593,25,468,228,1568,1593,1.0,0.015693659761456372,0.9843063402385436,897,0.2937853107344633,0.1431261770244821,0.5630885122410546
518,003,1417,11,397,648,1406,1417,1.0,0.0077628793225123505,0.9922371206774877,372,0.2801693719124912,0.4573041637261821,0.26252646436132676
519,003,1769,4,569,520,1765,1769,1.0,0.0022611644997173543,0.9977388355002826,680,0.32165065008479365,0.29395138496325607,0.3843979649519503
520,003,1678,13,504,511,1665,1678,1.0,0.0077473182359952325,0.9922526817640047,663,0.300357568533969,0.3045292014302741,0.3951132300357569
521,003,1703,23,600,411,1680,1703,1.0,0.013505578391074574,0.9864944216089254,692,0.35231943628890194,0.24133881385789782,0.40634174985320026
522,003,1233,17,277,205,1216,1233,1.0,0.013787510137875101,0.986212489862125,751,0.22465531224655313,0.16626115166261152,0.6090835360908353
523,003,2113,36,557,135,2077,2113,1.0,0.017037387600567912,0.9829626123994321,1421,0.2636062470421202,0.06389020350212968,0.6725035494557501
524,003,1609,13,490,686,1596,1609,1.0,0.008079552517091361,0.9919204474829086,433,0.3045369794903667,0.42635177128651336,0.26911124922311996
525,003,3544,64,803,300,3480,3544,1.0,0.01805869074492099,0.981941309255079,2441,0.22658013544018057,0.08465011286681716,0.6887697516930023
526,003,1268,17,339,213,1251,1268,1.0,0.013406940063091483,0.9865930599369085,716,0.26735015772870663,0.16798107255520506,0.5646687697160884
527,003,1963,7,644,743,1956,1963,1.0,0.003565970453387672,0.9964340295466123,576,0.3280692817116658,0.37850229240957717,0.293428425878757
528,003,2105,28,654,464,2077,2105,1.0,0.01330166270783848,0.9866983372921615,987,0.3106888361045131,0.22042755344418052,0.4688836104513064
529,003,1928,15,629,544,1913,1928,1.0,0.007780082987551867,0.9922199170124482,755,0.3262448132780083,0.2821576763485477,0.391597510373444
530,003,1557,3,533,582,1554,1557,1.0,0.0019267822736030828,0.9980732177263969,442,0.34232498394348104,0.3737957610789981,0.28387925497752087
531,003,1359,3,435,521,1356,1359,1.0,0.002207505518763797,0.9977924944812362,403,0.3200883002207506,0.3833701250919794,0.29654157468727005
532,003,3646,18,1669,1235,3628,3646,1.0,0.004936917169500823,0.9950630828304992,742,0.45776193088315964,0.33872737246297313,0.20351069665386726
533,003,1266,12,376,294,1254,1266,1.0,0.009478672985781991,0.990521327014218,596,0.296998420221169,0.23222748815165878,0.4707740916271722
534,003,2303,13,743,908,2290,2303,1.0,0.005644811115935736,0.9943551888840643,652,0.3226226660877117,0.3942683456361268,0.28310898827616154
535,003,3134,87,821,180,3047,3134,1.0,0.027760051052967454,0.9722399489470326,2133,0.26196553924696875,0.0574345883854499,0.6805998723675813
537,003,2908,49,630,151,2859,2908,1.0,0.01685006877579092,0.9831499312242091,2127,0.21664374140302614,0.051925722145804674,0.7314305364511692
538,003,1555,27,295,96,1528,1555,1.0,0.017363344051446947,0.9826366559485531,1164,0.18971061093247588,0.06173633440514469,0.7485530546623794
539,003,1560,11,446,810,1549,1560,1.0,0.007051282051282051,0.992948717948718,304,0.2858974358974359,0.5192307692307693,0.19487179487179487
541,003,1438,30,400,349,1408,1438,1.0,0.02086230876216968,0.9791376912378303,689,0.27816411682892905,0.2426981919332406,0.47913769123783034
542,003,3664,59,829,441,3605,3664,1.0,0.016102620087336244,0.9838973799126638,2394,0.22625545851528384,0.12036026200873362,0.6533842794759825
543,003,1382,24,406,284,1358,1382,1.0,0.017366136034732273,0.9826338639652678,692,0.2937771345875543,0.20549927641099855,0.5007235890014472
545,003,609,12,163,310,597,609,1.0,0.019704433497536946,0.9802955665024631,136,0.2676518883415435,0.5090311986863711,0.2233169129720854
546,003,1379,21,383,240,1358,1379,1.0,0.015228426395939087,0.9847715736040609,756,0.27773749093546046,0.17403915881073242,0.5482233502538071
549,003,2887,29,847,335,2858,2887,1.0,0.010045029442327675,0.9899549705576723,1705,0.29338413578108763,0.11603740907516454,0.5905784551437478
550,003,1312,14,437,378,1298,1312,1.0,0.010670731707317074,0.989329268292683,497,0.3330792682926829,0.28810975609756095,0.3788109756097561
551,003,1986,37,572,284,1949,1986,1.0,0.01863041289023162,0.9813695871097684,1130,0.2880161127895267,0.14300100704934543,0.5689828801611279
552,003,1293,5,516,402,1288,1293,1.0,0.0038669760247486465,0.9961330239752514,375,0.3990719257540603,0.3109048723897912,0.2900232018561485
553,003,2904,55,801,624,2849,2904,1.0,0.01893939393939394,0.9810606060606061,1479,0.27582644628099173,0.21487603305785125,0.5092975206611571
554,003,1427,12,441,356,1415,1427,1.0,0.008409250175192713,0.9915907498248073,630,0.3090399439383322,0.24947442186405044,0.4414856341976174
555,003,1872,16,577,353,1856,1872,1.0,0.008547008547008548,0.9914529914529915,942,0.30822649572649574,0.18856837606837606,0.5032051282051282
556,003,1052,2,423,458,1050,1052,1.0,0.0019011406844106464,0.9980988593155894,171,0.40209125475285173,0.435361216730038,0.16254752851711027
557,003,2713,50,522,185,2663,2713,1.0,0.018429782528566162,0.9815702174714338,2006,0.19240692959823075,0.0681901953556948,0.7394028750460745
558,003,1407,10,449,492,1397,1407,1.0,0.007107320540156361,0.9928926794598436,466,0.3191186922530206,0.34968017057569295,0.3312011371712864
559,003,1393,16,445,269,1377,1393,1.0,0.01148600143575018,0.9885139985642498,679,0.3194544149318019,0.19310839913854988,0.48743718592964824
560,003,2560,81,702,248,2479,2560,1.0,0.031640625,0.968359375,1610,0.27421875,0.096875,0.62890625
561,003,946,8,202,388,938,946,1.0,0.008456659619450317,0.9915433403805497,356,0.2135306553911205,0.41014799154334036,0.3763213530655391
562,003,1259,5,339,701,1254,1259,1.0,0.003971405877680699,0.9960285941223193,219,0.2692613185067514,0.556791104050834,0.17394757744241462
563,003,1397,39,519,427,1358,1397,1.0,0.02791696492483894,0.972083035075161,451,0.37151037938439513,0.30565497494631355,0.3228346456692913
564,003,1551,15,493,484,1536,1551,1.0,0.009671179883945842,0.9903288201160542,574,0.31785944551902,0.3120567375886525,0.37008381689232756
566,003,58,0,0,0,58,58,1.0,0.0,1.0,58,0.0,0.0,1.0
567,003,1770,50,420,144,1720,1770,1.0,0.02824858757062147,0.9717514124293786,1206,0.23728813559322035,0.08135593220338982,0.6813559322033899
568,003,5945,81,986,485,5864,5945,1.0,0.013624894869638351,0.9863751051303616,4474,0.16585365853658537,0.0815811606391926,0.7525651808242221
569,003,180,132,63,19,48,180,1.0,0.7333333333333333,0.26666666666666666,98,0.35,0.10555555555555556,0.5444444444444444
570,003,1292,4,516,599,1288,1292,1.0,0.0030959752321981426,0.9969040247678018,177,0.3993808049535604,0.46362229102167185,0.1369969040247678
571,003,2812,61,643,299,2751,2812,1.0,0.021692745376955903,0.9783072546230441,1870,0.2286628733997155,0.10633001422475107,0.6650071123755334
572,003,3026,40,543,212,2986,3026,1.0,0.013218770654329148,0.9867812293456708,2271,0.1794448116325182,0.07005948446794448,0.7504957038995373
573,003,2069,13,724,323,2056,2069,1.0,0.006283228612856452,0.9937167713871435,1022,0.3499275012083132,0.15611406476558723,0.49395843402609957
574,003,1677,18,533,355,1659,1677,1.0,0.01073345259391771,0.9892665474060823,789,0.3178294573643411,0.2116875372689326,0.47048300536672627
575,003,2481,57,477,297,2424,2481,1.0,0.022974607013301087,0.9770253929866989,1707,0.19226118500604594,0.11970979443772672,0.6880290205562273
576,003,33,0,2,24,33,33,1.0,0.0,1.0,7,0.06060606060606061,0.7272727272727273,0.21212121212121213
577,003,1476,18,336,844,1458,1476,1.0,0.012195121951219513,0.9878048780487805,296,0.22764227642276422,0.5718157181571816,0.2005420054200542
578,003,2517,22,855,831,2495,2517,1.0,0.00874056416368693,0.991259435836313,831,0.3396901072705602,0.3301549463647199,0.3301549463647199
579,003,2885,33,1104,503,2852,2885,1.0,0.011438474870017331,0.9885615251299826,1278,0.3826689774696707,0.17435008665511265,0.44298093587521664
580,003,1664,5,515,590,1659,1664,1.0,0.0030048076923076925,0.9969951923076923,559,0.3094951923076923,0.3545673076923077,0.3359375
581,003,1909,32,567,295,1877,1909,1.0,0.01676270298585647,0.9832372970141435,1047,0.2970141435306443,0.15453116815086432,0.5484546883184913
582,003,582,4,167,224,578,582,1.0,0.006872852233676976,0.993127147766323,191,0.2869415807560137,0.3848797250859107,0.3281786941580756
584,003,1840,40,521,508,1800,1840,1.0,0.021739130434782608,0.9782608695652174,811,0.2831521739130435,0.27608695652173915,0.4407608695652174
585,003,44,2,12,22,42,44,1.0,0.045454545454545456,0.9545454545454546,10,0.2727272727272727,0.5,0.22727272727272727
586,003,2968,53,829,295,2915,2968,1.0,0.017857142857142856,0.9821428571428571,1844,0.27931266846361186,0.09939353099730458,0.6212938005390836
587,003,1128,14,121,71,1114,1128,1.0,0.012411347517730497,0.9875886524822695,936,0.10726950354609929,0.06294326241134751,0.8297872340425532
588,003,2470,51,506,172,2419,2470,1.0,0.020647773279352227,0.9793522267206478,1792,0.2048582995951417,0.06963562753036437,0.725506072874494
589,003,1832,10,565,888,1822,1832,1.0,0.0054585152838427945,0.9945414847161572,379,0.3084061135371179,0.4847161572052402,0.20687772925764192
590,003,1400,10,460,251,1390,1400,1.0,0.007142857142857143,0.9928571428571429,689,0.32857142857142857,0.1792857142857143,0.49214285714285716
591,003,2276,52,645,382,2224,2276,1.0,0.022847100175746926,0.9771528998242531,1249,0.28339191564147626,0.1678383128295255,0.5487697715289982
592,003,1399,14,505,393,1385,1399,1.0,0.010007147962830594,0.9899928520371694,501,0.36097212294496067,0.2809149392423159,0.35811293781272335
593,003,2776,49,982,219,2727,2776,1.0,0.017651296829971182,0.9823487031700289,1575,0.3537463976945245,0.07889048991354466,0.5673631123919308
594,003,1926,15,687,263,1911,1926,1.0,0.00778816199376947,0.9922118380062306,976,0.35669781931464173,0.13655244029075805,0.5067497403946002
595,003,3776,60,859,314,3716,3776,1.0,0.015889830508474576,0.9841101694915254,2603,0.227489406779661,0.08315677966101695,0.689353813559322
596,003,1670,32,380,136,1638,1670,1.0,0.019161676646706587,0.9808383233532935,1154,0.2275449101796407,0.081437125748503,0.6910179640718563
597,003,1086,17,335,215,1069,1086,1.0,0.01565377532228361,0.9843462246777164,536,0.30847145488029465,0.19797421731123388,0.49355432780847147
598,003,13,0,1,11,13,13,1.0,0.0,1.0,1,0.07692307692307693,0.8461538461538461,0.07692307692307693
599,003,2217,13,747,589,2204,2217,1.0,0.005863779882724403,0.9941362201172756,881,0.33694181326116374,0.2656743346865133,0.39738385205232296
600,003,1340,8,419,666,1332,1340,1.0,0.005970149253731343,0.9940298507462687,255,0.3126865671641791,0.49701492537313435,0.19029850746268656
601,003,2077,63,311,96,2014,2077,1.0,0.03033220991815118,0.9696677900818488,1670,0.14973519499277804,0.046220510351468465,0.8040442946557534
602,003,1026,3,331,584,1023,1026,1.0,0.0029239766081871343,0.9970760233918129,111,0.3226120857699805,0.5692007797270955,0.10818713450292397
603,003,3619,78,987,277,3541,3619,1.0,0.021552915169936446,0.9784470848300636,2355,0.2727272727272727,0.07654048079579995,0.6507322464769273
604,003,1513,11,454,625,1502,1513,1.0,0.007270323859881031,0.992729676140119,434,0.30006609385327165,0.41308658294778583,0.2868473231989425
605,003,3088,19,914,858,3069,3088,1.0,0.006152849740932643,0.9938471502590673,1316,0.2959844559585492,0.2778497409326425,0.4261658031088083
606,003,2505,32,796,741,2473,2505,1.0,0.01277445109780439,0.9872255489021956,968,0.31776447105788425,0.2958083832335329,0.38642714570858283
607,003,2018,18,9,25,2000,2018,1.0,0.008919722497522299,0.9910802775024777,1984,0.0044598612487611496,0.012388503468780971,0.9831516352824579
608,003,3751,29,1162,1497,3722,3751,1.0,0.007731271660890429,0.9922687283391096,1092,0.3097840575846441,0.3990935750466542,0.2911223673687017
609,003,1151,6,465,306,1145,1151,1.0,0.005212858384013901,0.9947871416159861,380,0.40399652476107734,0.26585577758470896,0.3301476976542137
612,003,7,0,0,0,7,7,1.0,0.0,1.0,7,0.0,0.0,1.0
613,003,2282,33,620,274,2249,2282,1.0,0.014460999123575811,0.9855390008764242,1388,0.27169149868536374,0.1200701139351446,0.6082383873794917
614,003,1099,1,175,186,1098,1099,1.0,0.0009099181073703367,0.9990900818926297,738,0.1592356687898089,0.16924476797088261,0.6715195632393085
615,003,4038,19,1575,1431,4019,4038,1.0,0.0047052996532937095,0.9952947003467063,1032,0.3900445765230312,0.35438335809806837,0.2555720653789004
616,003,2711,27,627,242,2684,2711,1.0,0.009959424566580598,0.9900405754334194,1842,0.23127997049059387,0.08926595352268536,0.6794540759867208
617,003,4539,53,1446,771,4486,4539,1.0,0.011676580744657413,0.9883234192553426,2322,0.3185723727693325,0.16986120290812953,0.511566424322538
618,003,2215,71,385,183,2144,2215,1.0,0.032054176072234764,0.9679458239277653,1647,0.17381489841986456,0.08261851015801354,0.7435665914221219
621,003,3229,32,569,229,3197,3229,1.0,0.009910188912976153,0.9900898110870239,2431,0.17621554660885724,0.0709197894084856,0.7528646639826572
622,003,18,1,0,0,17,18,1.0,0.05555555555555555,0.9444444444444444,18,0.0,0.0,1.0
623,003,2487,42,651,186,2445,2487,1.0,0.016887816646562123,0.9831121833534379,1650,0.2617611580217129,0.07478890229191798,0.6634499396863691
625,003,3099,30,955,485,3069,3099,1.0,0.00968054211035818,0.9903194578896418,1659,0.30816392384640207,0.15650209745079058,0.5353339787028074
626,003,2,0,0,0,2,2,1.0,0.0,1.0,2,0.0,0.0,1.0
627,003,2156,28,431,229,2128,2156,1.0,0.012987012987012988,0.987012987012987,1496,0.19990723562152132,0.1062152133580705,0.6938775510204082
628,003,1985,15,556,249,1970,1985,1.0,0.007556675062972292,0.9924433249370277,1180,0.2801007556675063,0.12544080604534005,0.5944584382871536
629,003,2,0,0,0,2,2,1.0,0.0,1.0,2,0.0,0.0,1.0
630,003,1574,37,448,294,1537,1574,1.0,0.023506988564167726,0.9764930114358322,832,0.2846251588310038,0.18678526048284624,0.5285895806861499
631,003,4088,94,718,194,3994,4088,1.0,0.02299412915851272,0.9770058708414873,3176,0.17563600782778865,0.0474559686888454,0.776908023483366
632,003,2402,14,955,925,2388,2402,1.0,0.005828476269775187,0.9941715237302248,522,0.39758534554537883,0.3850957535387177,0.21731890091590342
633,003,1889,10,641,728,1879,1889,1.0,0.005293806246691371,0.9947061937533086,520,0.3393329804129169,0.3853890947591318,0.27527792482795127
634,003,1137,7,351,314,1130,1137,1.0,0.006156552330694811,0.9938434476693052,472,0.3087071240105541,0.27616534740545295,0.415127528583993
635,003,1447,25,388,258,1422,1447,1.0,0.017277125086385625,0.9827228749136143,801,0.2681409813407049,0.17829993089149965,0.5535590877677954
636,003,2974,44,757,527,2930,2974,1.0,0.014794889038332213,0.9852051109616677,1690,0.25453934095494285,0.17720242098184263,0.5682582380632145
637,003,1724,18,542,496,1706,1724,1.0,0.010440835266821345,0.9895591647331786,686,0.314385150812065,0.2877030162412993,0.39791183294663574
638,003,1119,4,342,539,1115,1119,1.0,0.0035746201966041107,0.9964253798033958,238,0.30563002680965146,0.48168007149240394,0.2126899016979446
639,003,836,10,311,289,826,836,1.0,0.011961722488038277,0.9880382775119617,236,0.37200956937799046,0.3456937799043062,0.2822966507177033
640,003,1104,10,246,649,1094,1104,1.0,0.009057971014492754,0.9909420289855072,209,0.22282608695652173,0.5878623188405797,0.18931159420289856
641,003,1609,2,644,782,1607,1609,1.0,0.001243008079552517,0.9987569919204475,183,0.4002486016159105,0.4860161591050342,0.11373523927905531
642,003,37,0,7,14,37,37,1.0,0.0,1.0,16,0.1891891891891892,0.3783783783783784,0.43243243243243246
643,003,3730,84,779,213,3646,3730,1.0,0.022520107238605896,0.9774798927613941,2738,0.20884718498659519,0.05710455764075067,0.7340482573726541
644,003,1692,2,470,998,1690,1692,1.0,0.001182033096926714,0.9988179669030733,224,0.2777777777777778,0.5898345153664303,0.13238770685579196
645,003,2485,5,792,790,2480,2485,1.0,0.002012072434607646,0.9979879275653923,903,0.3187122736418511,0.317907444668008,0.36338028169014086
646,003,637,8,225,174,629,637,1.0,0.012558869701726845,0.9874411302982732,238,0.3532182103610675,0.2731554160125589,0.37362637362637363
647,003,1277,29,334,184,1248,1277,1.0,0.022709475332811275,0.9772905246671887,759,0.2615505090054816,0.14408770555990602,0.5943617854346124
648,003,1536,22,582,413,1514,1536,1.0,0.014322916666666666,0.9856770833333334,541,0.37890625,0.2688802083333333,0.3522135416666667
649,003,1382,2,386,734,1380,1382,1.0,0.001447178002894356,0.9985528219971056,262,0.2793053545586107,0.5311143270622286,0.18958031837916064
650,003,1789,25,522,428,1764,1789,1.0,0.013974287311347122,0.9860257126886529,839,0.2917831190609279,0.23923979877026272,0.4689770821688094
651,003,1658,7,527,501,1651,1658,1.0,0.004221954161640531,0.9957780458383595,630,0.3178528347406514,0.30217129071170085,0.37997587454764775
652,003,3158,13,839,526,3145,3158,1.0,0.004116529449018366,0.9958834705509816,1793,0.2656744775174161,0.16656111462951234,0.5677644078530716
653,003,2263,16,760,526,2247,2263,1.0,0.007070260715863898,0.9929297392841361,977,0.33583738400353513,0.23243482103402563,0.43172779496243924
654,003,2217,55,540,165,2162,2217,1.0,0.02480829950383401,0.975191700496166,1512,0.2435723951285521,0.07442489851150202,0.6820027063599459
655,003,1245,9,476,474,1236,1245,1.0,0.007228915662650603,0.9927710843373494,295,0.3823293172690763,0.38072289156626504,0.23694779116465864
657,003,1039,3,364,527,1036,1039,1.0,0.0028873917228103944,0.9971126082771896,148,0.3503368623676612,0.507218479307026,0.1424446583253128
658,003,1479,7,442,563,1472,1479,1.0,0.004732927653820149,0.9952670723461798,474,0.2988505747126437,0.38066260987153483,0.3204868154158215
659,003,2714,36,652,430,2678,2714,1.0,0.013264554163596167,0.9867354458364038,1632,0.24023581429624172,0.1584377302873987,0.6013264554163597
660,003,1553,14,429,685,1539,1553,1.0,0.00901481004507405,0.9909851899549259,439,0.2762395363811977,0.44108177720540886,0.28267868641339344
661,003,3602,135,941,256,3467,3602,1.0,0.03747917823431427,0.9625208217656858,2405,0.26124375347029427,0.07107162687395892,0.6676846196557468
662,003,2496,34,845,729,2462,2496,1.0,0.013621794871794872,0.9863782051282052,922,0.3385416666666667,0.2920673076923077,0.36939102564102566
663,003,1253,21,332,252,1232,1253,1.0,0.01675977653631285,0.9832402234636871,669,0.2649640861931365,0.2011173184357542,0.5339185953711093
665,003,3869,26,1165,761,3843,3869,1.0,0.006720082708710261,0.9932799172912897,1943,0.30111139829413286,0.19669165158955804,0.5021969501163092
668,003,1368,7,493,487,1361,1368,1.0,0.005116959064327485,0.9948830409356725,388,0.3603801169590643,0.35599415204678364,0.28362573099415206
669,003,1361,36,451,353,1325,1361,1.0,0.02645113886847906,0.973548861131521,557,0.331373989713446,0.25936811168258633,0.40925789860396766
670,003,1738,26,459,310,1712,1738,1.0,0.014959723820483314,0.9850402761795167,969,0.26409666283084005,0.17836593785960875,0.5575373993095513
671,003,1138,9,421,479,1129,1138,1.0,0.007908611599297012,0.992091388400703,238,0.36994727592267135,0.4209138840070299,0.20913884007029876
672,003,1784,19,591,553,1765,1784,1.0,0.010650224215246636,0.9893497757847534,640,0.3312780269058296,0.3099775784753363,0.35874439461883406
673,003,3458,25,1498,946,3433,3458,1.0,0.007229612492770388,0.9927703875072296,1014,0.4331983805668016,0.27356853672643144,0.2932330827067669
674,003,2416,35,810,464,2381,2416,1.0,0.014486754966887417,0.9855132450331126,1142,0.3352649006622517,0.19205298013245034,0.472682119205298
675,003,363,6,82,35,357,363,1.0,0.01652892561983471,0.9834710743801653,246,0.22589531680440772,0.09641873278236915,0.6776859504132231
677,003,2163,34,664,447,2129,2163,1.0,0.01571890892279242,0.9842810910772076,1052,0.3069810448451225,0.20665742024965325,0.4863615349052242
678,003,3892,43,594,304,3849,3892,1.0,0.011048304213771839,0.9889516957862282,2994,0.1526207605344296,0.07810894141829394,0.7692702980472764
679,003,2396,19,738,935,2377,2396,1.0,0.007929883138564273,0.9920701168614358,723,0.3080133555926544,0.3902337228714524,0.30175292153589317
680,003,1437,3,524,590,1434,1437,1.0,0.0020876826722338203,0.9979123173277662,323,0.36464857341684065,0.41057759220598466,0.22477383437717466
681,003,1805,15,584,333,1790,1805,1.0,0.008310249307479225,0.9916897506925207,888,0.3235457063711911,0.18448753462603878,0.4919667590027701
682,003,19,3,0,0,16,19,1.0,0.15789473684210525,0.8421052631578947,19,0.0,0.0,1.0
683,003,22,1,9,6,21,22,1.0,0.045454545454545456,0.9545454545454546,7,0.4090909090909091,0.2727272727272727,0.3181818181818182
684,003,1348,4,364,219,1344,1348,1.0,0.002967359050445104,0.9970326409495549,765,0.27002967359050445,0.16246290801186944,0.5675074183976261
686,003,1938,26,525,324,1912,1938,1.0,0.013415892672858616,0.9865841073271414,1089,0.2708978328173375,0.16718266253869968,0.5619195046439629
687,003,1387,17,301,149,1370,1387,1.0,0.012256669069935111,0.9877433309300648,937,0.21701514059120403,0.10742609949531362,0.6755587599134824
688,003,1798,5,623,757,1793,1798,1.0,0.0027808676307007787,0.9972191323692993,418,0.346496106785317,0.42102335928809786,0.2324805339265851
689,003,1321,16,306,762,1305,1321,1.0,0.012112036336109008,0.987887963663891,253,0.23164269492808479,0.5768357305071915,0.19152157456472368
690,003,1700,22,551,406,1678,1700,1.0,0.012941176470588235,0.9870588235294118,743,0.3241176470588235,0.2388235294117647,0.4370588235294118
691,003,770,9,287,351,761,770,1.0,0.011688311688311689,0.9883116883116884,132,0.37272727272727274,0.45584415584415583,0.17142857142857143
692,003,3101,38,933,227,3063,3101,1.0,0.012254111576910674,0.9877458884230893,1941,0.3008706868752015,0.07320219284101903,0.6259271202837794
693,003,2505,33,601,282,2472,2505,1.0,0.013173652694610778,0.9868263473053892,1622,0.23992015968063873,0.1125748502994012,0.6475049900199601
694,003,833,5,280,330,828,833,1.0,0.006002400960384154,0.9939975990396158,223,0.33613445378151263,0.39615846338535415,0.26770708283313327
695,003,1950,27,665,395,1923,1950,1.0,0.013846153846153847,0.9861538461538462,890,0.34102564102564104,0.20256410256410257,0.4564102564102564
696,003,1375,22,349,81,1353,1375,1.0,0.016,0.984,945,0.25381818181818183,0.05890909090909091,0.6872727272727273
697,003,2723,52,764,282,2671,2723,1.0,0.019096584649283876,0.9809034153507161,1677,0.2805728975394785,0.10356224752111641,0.615864854939405
698,003,1244,8,341,302,1236,1244,1.0,0.006430868167202572,0.9935691318327974,601,0.2741157556270096,0.2427652733118971,0.48311897106109325
699,003,4046,58,712,349,3988,4046,1.0,0.014335145823035097,0.9856648541769649,2985,0.175976272862086,0.08625803262481463,0.7377656945130994
700,003,635,1,183,388,634,635,1.0,0.0015748031496062992,0.9984251968503937,64,0.28818897637795277,0.6110236220472441,0.10078740157480315
701,003,2055,31,662,731,2024,2055,1.0,0.01508515815085158,0.9849148418491485,662,0.3221411192214112,0.3557177615571776,0.3221411192214112
702,003,1374,30,432,335,1344,1374,1.0,0.021834061135371178,0.9781659388646288,607,0.314410480349345,0.2438136826783115,0.4417758369723435
703,003,1172,7,287,660,1165,1172,1.0,0.005972696245733789,0.9940273037542662,225,0.24488054607508533,0.5631399317406144,0.19197952218430034
704,003,2108,37,627,311,2071,2108,1.0,0.017552182163187855,0.9824478178368121,1170,0.297438330170778,0.14753320683111953,0.5550284629981025
705,003,1724,27,521,235,1697,1724,1.0,0.015661252900232018,0.984338747099768,968,0.30220417633410673,0.13631090487238978,0.5614849187935035
706,003,2167,15,682,496,2152,2167,1.0,0.00692201199815413,0.9930779880018459,989,0.3147208121827411,0.22888786340562992,0.456391324411629
707,003,1305,10,532,559,1295,1305,1.0,0.007662835249042145,0.9923371647509579,214,0.4076628352490421,0.42835249042145596,0.16398467432950192
708,003,2005,34,647,651,1971,2005,1.0,0.016957605985037406,0.9830423940149626,707,0.3226932668329177,0.32468827930174565,0.35261845386533663
709,003,2485,45,593,253,2440,2485,1.0,0.018108651911468814,0.9818913480885312,1639,0.2386317907444668,0.10181086519114688,0.6595573440643863
710,003,1909,9,584,511,1900,1909,1.0,0.004714510214772132,0.9952854897852279,814,0.30591932949188055,0.2676794133053955,0.4264012572027239
711,003,1160,7,347,448,1153,1160,1.0,0.00603448275862069,0.9939655172413793,365,0.2991379310344828,0.38620689655172413,0.3146551724137931
712,003,1388,19,335,665,1369,1388,1.0,0.013688760806916427,0.9863112391930836,388,0.2413544668587896,0.47910662824207495,0.27953890489913547
713,003,3618,46,945,449,3572,3618,1.0,0.01271420674405749,0.9872857932559425,2224,0.26119402985074625,0.12410171365395246,0.6147042564953012
714,003,1738,11,590,327,1727,1738,1.0,0.006329113924050633,0.9936708860759493,821,0.3394706559263521,0.18814729574223246,0.4723820483314154
715,003,2736,24,808,497,2712,2736,1.0,0.008771929824561403,0.9912280701754386,1431,0.2953216374269006,0.18165204678362573,0.5230263157894737
716,003,2242,33,658,460,2209,2242,1.0,0.014719000892060661,0.9852809991079393,1124,0.29348795718108833,0.20517395182872436,0.5013380909901873
717,003,2810,11,861,555,2799,2810,1.0,0.003914590747330961,0.9960854092526691,1394,0.3064056939501779,0.19750889679715303,0.49608540925266903
718,003,2580,35,672,383,2545,2580,1.0,0.013565891472868217,0.9864341085271318,1525,0.26046511627906976,0.14844961240310078,0.5910852713178295
720,003,1760,22,341,841,1738,1760,1.0,0.0125,0.9875,578,0.19375,0.4778409090909091,0.32840909090909093
721,003,1225,11,449,456,1214,1225,1.0,0.008979591836734694,0.9910204081632653,320,0.36653061224489797,0.3722448979591837,0.2612244897959184
723,003,829,7,338,278,822,829,1.0,0.008443908323281062,0.991556091676719,213,0.4077201447527141,0.3353437876960193,0.2569360675512666
724,003,983,7,373,486,976,983,1.0,0.007121057985757884,0.9928789420142421,124,0.37945066124109866,0.49440488301119023,0.12614445574771108
725,003,463,24,86,24,439,463,1.0,0.05183585313174946,0.9481641468682506,353,0.1857451403887689,0.05183585313174946,0.7624190064794817
726,003,725,2,279,256,723,725,1.0,0.002758620689655172,0.9972413793103448,190,0.38482758620689655,0.35310344827586204,0.2620689655172414
727,003,2221,64,461,199,2157,2221,1.0,0.028815848716794237,0.9711841512832058,1561,0.2075641602881585,0.08959927960378208,0.7028365601080594
728,003,749,3,251,317,746,749,1.0,0.004005340453938585,0.9959946595460614,181,0.33511348464619495,0.4232309746328438,0.2416555407209613
729,003,2989,37,967,441,2952,2989,1.0,0.012378721980595517,0.9876212780194045,1581,0.3235195717631315,0.14754098360655737,0.5289394446303112
730,003,1287,17,373,226,1270,1287,1.0,0.01320901320901321,0.9867909867909868,688,0.2898212898212898,0.17560217560217561,0.5345765345765345
731,003,1358,18,133,84,1340,1358,1.0,0.013254786450662739,0.9867452135493373,1141,0.0979381443298969,0.061855670103092786,0.8402061855670103
732,003,1916,35,454,164,1881,1916,1.0,0.01826722338204593,0.9817327766179541,1298,0.23695198329853862,0.08559498956158663,0.6774530271398748
733,003,1496,5,508,593,1491,1496,1.0,0.0033422459893048127,0.9966577540106952,395,0.339572192513369,0.3963903743315508,0.2640374331550802
734,003,1138,3,479,528,1135,1138,1.0,0.0026362038664323375,0.9973637961335676,131,0.4209138840070299,0.46397188049209137,0.11511423550087874
735,003,2448,10,659,643,2438,2448,1.0,0.004084967320261438,0.9959150326797386,1146,0.26919934640522875,0.26266339869281047,0.4681372549019608
737,003,1772,24,461,458,1748,1772,1.0,0.013544018058690745,0.9864559819413092,853,0.2601580135440181,0.2584650112866817,0.4813769751693002
738,003,1530,20,423,362,1510,1530,1.0,0.013071895424836602,0.9869281045751634,745,0.27647058823529413,0.23660130718954248,0.4869281045751634
740,003,768,2,275,389,766,768,1.0,0.0026041666666666665,0.9973958333333334,104,0.3580729166666667,0.5065104166666666,0.13541666666666666
741,003,1340,8,380,541,1332,1340,1.0,0.005970149253731343,0.9940298507462687,419,0.2835820895522388,0.40373134328358207,0.3126865671641791
742,003,1470,39,580,109,1431,1470,1.0,0.026530612244897958,0.9734693877551021,781,0.3945578231292517,0.07414965986394557,0.5312925170068027
743,003,833,8,299,228,825,833,1.0,0.009603841536614645,0.9903961584633854,306,0.3589435774309724,0.2737094837935174,0.3673469387755102
744,003,1836,20,646,395,1816,1836,1.0,0.010893246187363835,0.9891067538126361,795,0.35185185185185186,0.21514161220043573,0.43300653594771243
745,003,1293,10,384,549,1283,1293,1.0,0.007733952049497293,0.9922660479505027,360,0.29698375870069604,0.4245939675174014,0.27842227378190254
746,003,2728,16,959,1173,2712,2728,1.0,0.005865102639296188,0.9941348973607038,596,0.35153958944281527,0.42998533724340177,0.218475073313783
747,003,1542,14,537,468,1528,1542,1.0,0.009079118028534372,0.9909208819714657,537,0.34824902723735407,0.3035019455252918,0.34824902723735407
748,003,1752,21,529,378,1731,1752,1.0,0.011986301369863013,0.988013698630137,845,0.3019406392694064,0.21575342465753425,0.4823059360730594
749,003,1824,26,502,351,1798,1824,1.0,0.01425438596491228,0.9857456140350878,971,0.27521929824561403,0.1924342105263158,0.5323464912280702
750,003,2570,25,579,301,2545,2570,1.0,0.009727626459143969,0.9902723735408561,1690,0.22529182879377432,0.11712062256809339,0.6575875486381323
751,003,2274,25,458,233,2249,2274,1.0,0.010993843447669306,0.9890061565523307,1583,0.20140721196130168,0.10246262093227793,0.6961301671064204
752,003,1604,19,348,179,1585,1604,1.0,0.011845386533665835,0.9881546134663342,1077,0.2169576059850374,0.11159600997506235,0.6714463840399002
753,003,1953,16,617,624,1937,1953,1.0,0.00819252432155658,0.9918074756784434,712,0.3159242191500256,0.3195084485407066,0.3645673323092678
754,003,1434,0,389,663,1434,1434,1.0,0.0,1.0,382,0.2712691771269177,0.46234309623430964,0.26638772663877264
755,003,1751,21,555,705,1730,1751,1.0,0.011993146773272416,0.9880068532267275,491,0.316961736150771,0.402627070245574,0.2804111936036551
756,003,2322,33,710,372,2289,2322,1.0,0.014211886304909561,0.9857881136950905,1240,0.305770887166236,0.16020671834625322,0.5340223944875108
757,003,2816,15,819,462,2801,2816,1.0,0.005326704545454545,0.9946732954545454,1535,0.2908380681818182,0.1640625,0.5450994318181818
758,003,2319,33,793,720,2286,2319,1.0,0.014230271668822769,0.9857697283311773,806,0.34195774040534715,0.31047865459249674,0.3475636050021561
759,003,1837,1,688,644,1836,1837,1.0,0.0005443658138268917,0.9994556341861731,505,0.3745236799129015,0.3505715841045182,0.2749047359825803
760,003,252,1,71,143,251,252,1.0,0.003968253968253968,0.996031746031746,38,0.28174603174603174,0.5674603174603174,0.15079365079365079
761,003,5880,60,355,88,5820,5880,1.0,0.01020408163265306,0.9897959183673469,5437,0.06037414965986394,0.014965986394557823,0.9246598639455782
762,003,1187,11,339,282,1176,1187,1.0,0.009267059814658803,0.9907329401853412,566,0.2855939342881213,0.2375737152485257,0.476832350463353
763,003,3511,25,1090,610,3486,3511,1.0,0.007120478496154941,0.9928795215038451,1811,0.3104528624323555,0.17373967530618056,0.515807462261464
764,003,1895,50,626,381,1845,1895,1.0,0.026385224274406333,0.9736147757255936,888,0.33034300791556725,0.20105540897097626,0.46860158311345645
765,003,1810,2,497,953,1808,1810,1.0,0.0011049723756906078,0.9988950276243094,360,0.274585635359116,0.5265193370165746,0.19889502762430938
766,003,1152,16,517,95,1136,1152,1.0,0.013888888888888888,0.9861111111111112,540,0.4487847222222222,0.08246527777777778,0.46875
767,003,1471,15,503,479,1456,1471,1.0,0.010197144799456152,0.9898028552005439,489,0.3419442556084296,0.3256288239292998,0.33242692046227057
768,003,748,3,311,330,745,748,1.0,0.004010695187165776,0.9959893048128342,107,0.4157754010695187,0.4411764705882353,0.14304812834224598
769,003,2250,40,431,188,2210,2250,1.0,0.017777777777777778,0.9822222222222222,1631,0.19155555555555556,0.08355555555555555,0.7248888888888889
770,003,2342,60,517,253,2282,2342,1.0,0.025619128949615714,0.9743808710503843,1572,0.22075149444918873,0.10802732707087959,0.6712211784799317
771,003,2997,20,1069,563,2977,2997,1.0,0.00667334000667334,0.9933266599933267,1365,0.35669002335669003,0.18785452118785453,0.45545545545545546
772,003,21,0,0,0,21,21,1.0,0.0,1.0,21,0.0,0.0,1.0
773,003,1438,29,269,78,1409,1438,1.0,0.020166898470097356,0.9798331015299027,1091,0.1870653685674548,0.054242002781641166,0.758692628650904
774,003,1534,17,475,541,1517,1534,1.0,0.01108213820078227,0.9889178617992177,518,0.30964797913950454,0.35267275097783574,0.3376792698826597
775,003,3331,19,1155,422,3312,3331,1.0,0.005703992794956469,0.9942960072050435,1754,0.34674271990393274,0.1266886820774542,0.526568598018613
776,003,1940,22,544,153,1918,1940,1.0,0.01134020618556701,0.988659793814433,1243,0.2804123711340206,0.0788659793814433,0.6407216494845361
777,003,396,4,118,156,392,396,1.0,0.010101010101010102,0.98989898989899,122,0.29797979797979796,0.3939393939393939,0.30808080808080807
778,003,339,7,86,154,332,339,1.0,0.02064896755162242,0.9793510324483776,99,0.2536873156342183,0.45427728613569324,0.2920353982300885
780,003,18,2,0,0,16,18,1.0,0.1111111111111111,0.8888888888888888,18,0.0,0.0,1.0
782,003,204,2,56,90,202,204,1.0,0.00980392156862745,0.9901960784313726,58,0.27450980392156865,0.4411764705882353,0.28431372549019607
783,003,2312,15,737,568,2297,2312,1.0,0.006487889273356401,0.9935121107266436,1007,0.3187716262975779,0.24567474048442905,0.43555363321799306
784,003,61,0,15,6,61,61,1.0,0.0,1.0,40,0.2459016393442623,0.09836065573770492,0.6557377049180327
785,003,34,0,8,22,34,34,1.0,0.0,1.0,4,0.23529411764705882,0.6470588235294118,0.11764705882352941
786,003,172,3,59,20,169,172,1.0,0.01744186046511628,0.9825581395348837,93,0.3430232558139535,0.11627906976744186,0.5406976744186046
787,003,1423,19,373,292,1404,1423,1.0,0.013352073085031623,0.9866479269149684,758,0.26212227687983136,0.20520028109627547,0.5326774420238932
788,003,55,0,23,23,55,55,1.0,0.0,1.0,9,0.41818181818181815,0.41818181818181815,0.16363636363636364
789,003,1888,3,545,404,1885,1888,1.0,0.0015889830508474577,0.9984110169491526,939,0.2886652542372881,0.21398305084745764,0.4973516949152542
790,003,3,0,0,0,3,3,1.0,0.0,1.0,3,0.0,0.0,1.0
791,003,2146,38,639,437,2108,2146,1.0,0.017707362534948742,0.9822926374650512,1070,0.2977632805219012,0.20363466915191053,0.49860205032618826
792,003,4742,34,1184,472,4708,4742,1.0,0.007169970476592155,0.9928300295234078,3086,0.24968367777309153,0.09953606073386756,0.6507802614930409
793,003,3193,19,1068,914,3174,3193,1.0,0.005950516755402443,0.9940494832445975,1211,0.3344816786720952,0.2862511744440965,0.3792671468838083
794,003,2288,10,690,575,2278,2288,1.0,0.004370629370629371,0.9956293706293706,1023,0.30157342657342656,0.2513111888111888,0.44711538461538464
795,003,1062,3,448,407,1059,1062,1.0,0.002824858757062147,0.9971751412429378,207,0.4218455743879473,0.3832391713747646,0.19491525423728814
796,003,1322,9,476,497,1313,1322,1.0,0.00680786686838124,0.9931921331316188,349,0.3600605143721634,0.37594553706505296,0.2639939485627837
797,003,3055,47,1087,482,3008,3055,1.0,0.015384615384615385,0.9846153846153847,1486,0.355810147299509,0.15777414075286417,0.48641571194762684
798,003,91,0,20,52,91,91,1.0,0.0,1.0,19,0.21978021978021978,0.5714285714285714,0.2087912087912088
799,003,782,13,212,304,769,782,1.0,0.016624040920716114,0.9833759590792839,266,0.2710997442455243,0.3887468030690537,0.340153452685422
800,003,1570,11,514,442,1559,1570,1.0,0.0070063694267515925,0.9929936305732484,614,0.3273885350318471,0.28152866242038216,0.3910828025477707
801,003,1855,18,663,582,1837,1855,1.0,0.009703504043126684,0.9902964959568733,610,0.3574123989218329,0.3137466307277628,0.3288409703504043
802,003,2787,30,751,363,2757,2787,1.0,0.010764262648008612,0.9892357373519914,1673,0.2694653749551489,0.1302475780409042,0.6002870470039469
803,003,1964,15,559,735,1949,1964,1.0,0.007637474541751527,0.9923625254582484,670,0.2846232179226069,0.3742362525458248,0.3411405295315682
804,003,3084,48,646,264,3036,3084,1.0,0.01556420233463035,0.9844357976653697,2174,0.20946822308690013,0.08560311284046693,0.704928664072633
805,003,4096,63,914,327,4033,4096,1.0,0.015380859375,0.984619140625,2855,0.22314453125,0.079833984375,0.697021484375
806,003,1232,0,439,354,1232,1232,1.0,0.0,1.0,439,0.35633116883116883,0.28733766233766234,0.35633116883116883
807,003,790,10,309,206,780,790,1.0,0.012658227848101266,0.9873417721518988,275,0.3911392405063291,0.2607594936708861,0.34810126582278483
808,003,2079,25,618,332,2054,2079,1.0,0.012025012025012025,0.987974987974988,1129,0.2972582972582973,0.1596921596921597,0.543049543049543
809,003,1771,42,562,379,1729,1771,1.0,0.023715415019762844,0.9762845849802372,830,0.31733483907396953,0.2140033879164314,0.4686617730095991
810,003,1184,9,278,684,1175,1184,1.0,0.007601351351351352,0.9923986486486487,222,0.23479729729729729,0.5777027027027027,0.1875
811,003,2973,16,854,746,2957,2973,1.0,0.0053817692566431215,0.9946182307433569,1373,0.2872519340733266,0.2509249915909855,0.46182307433568787
812,003,2281,37,554,514,2244,2281,1.0,0.016220955721174924,0.9837790442788251,1213,0.24287593160894344,0.2253397632617273,0.5317843051293293
813,003,1483,4,399,541,1479,1483,1.0,0.0026972353337828725,0.9973027646662171,543,0.26904922454484154,0.3648010788941335,0.366149696561025
814,003,1813,45,525,257,1768,1813,1.0,0.024820739106453393,0.9751792608935466,1031,0.28957528957528955,0.14175399889685603,0.5686707115278544
816,003,710,8,184,234,702,710,1.0,0.011267605633802818,0.9887323943661972,292,0.2591549295774648,0.3295774647887324,0.4112676056338028
817,003,1504,7,641,406,1497,1504,1.0,0.004654255319148936,0.995345744680851,457,0.4261968085106383,0.2699468085106383,0.3038563829787234
818,003,2211,27,742,536,2184,2211,1.0,0.012211668928086838,0.9877883310719131,933,0.3355947535052013,0.24242424242424243,0.42198100407055633
819,003,1660,38,491,323,1622,1660,1.0,0.02289156626506024,0.9771084337349397,846,0.2957831325301205,0.19457831325301206,0.5096385542168674
820,003,1155,11,253,93,1144,1155,1.0,0.009523809523809525,0.9904761904761905,809,0.21904761904761905,0.08051948051948052,0.7004329004329004
821,003,2045,9,697,903,2036,2045,1.0,0.004400977995110024,0.9955990220048899,445,0.3408312958435208,0.4415647921760391,0.2176039119804401
822,003,4088,70,1035,311,4018,4088,1.0,0.017123287671232876,0.9828767123287672,2742,0.25318003913894327,0.07607632093933464,0.6707436399217221
823,003,1624,17,456,487,1607,1624,1.0,0.010467980295566502,0.9895320197044335,681,0.28078817733990147,0.2998768472906404,0.41933497536945813
824,003,2424,40,847,448,2384,2424,1.0,0.0165016501650165,0.9834983498349835,1129,0.3494224422442244,0.1848184818481848,0.46575907590759075
825,003,3497,38,716,1094,3459,3497,1.0,0.010866456963111238,0.9891335430368887,1687,0.20474692593651703,0.3128395767800972,0.4824134972833858
826,003,1501,12,459,450,1489,1501,1.0,0.007994670219853431,0.9920053297801465,592,0.30579613590939375,0.29980013324450366,0.3944037308461026
827,003,1894,29,664,344,1865,1894,1.0,0.015311510031678986,0.984688489968321,886,0.3505807814149947,0.1816261879619852,0.4677930306230201
828,003,1430,21,474,407,1409,1430,1.0,0.014685314685314685,0.9853146853146854,549,0.33146853146853145,0.2846153846153846,0.3839160839160839
829,003,1843,6,508,470,1837,1843,1.0,0.0032555615843733042,0.9967444384156267,865,0.27563754747693975,0.25501899077590884,0.46934346174715136
830,003,1058,4,369,552,1054,1058,1.0,0.003780718336483932,0.996219281663516,137,0.3487712665406427,0.5217391304347826,0.12948960302457466
831,003,1292,0,469,662,1292,1292,1.0,0.0,1.0,161,0.36300309597523217,0.5123839009287926,0.12461300309597523
832,003,1295,7,384,674,1288,1295,1.0,0.005405405405405406,0.9945945945945946,237,0.2965250965250965,0.5204633204633204,0.18301158301158302
833,003,2408,36,705,457,2372,2408,1.0,0.014950166112956811,0.9850498338870431,1246,0.29277408637873753,0.1897840531561462,0.5174418604651163
834,003,1775,14,449,370,1761,1775,1.0,0.007887323943661971,0.992112676056338,956,0.25295774647887326,0.2084507042253521,0.5385915492957747
835,003,1219,2,367,462,1217,1219,1.0,0.0016406890894175555,0.9983593109105825,390,0.3010664479081214,0.37899917965545526,0.3199343724364233
836,003,2234,22,860,439,2212,2234,1.0,0.009847806624888093,0.990152193375112,935,0.38495971351835273,0.19650850492390332,0.41853178155774395
837,003,1806,15,595,619,1791,1806,1.0,0.008305647840531562,0.9916943521594684,592,0.32945736434108525,0.3427464008859358,0.327796234772979
838,003,3567,91,580,279,3476,3567,1.0,0.025511634426689096,0.9744883655733109,2708,0.16260162601626016,0.0782169890664424,0.7591813849172975
839,003,1965,16,687,733,1949,1965,1.0,0.008142493638676845,0.9918575063613232,545,0.34961832061068704,0.37302798982188295,0.27735368956743
840,003,3014,73,492,148,2941,3014,1.0,0.024220305242203054,0.9757796947577969,2374,0.16323822163238222,0.0491041804910418,0.787657597876576
841,003,1336,16,477,324,1320,1336,1.0,0.011976047904191617,0.9880239520958084,535,0.3570359281437126,0.24251497005988024,0.4004491017964072
842,003,2165,11,483,196,2154,2165,1.0,0.005080831408775982,0.994919168591224,1486,0.223094688221709,0.09053117782909931,0.6863741339491917
844,003,604,10,179,164,594,604,1.0,0.016556291390728478,0.9834437086092715,261,0.29635761589403975,0.271523178807947,0.43211920529801323
845,003,447,1,55,38,446,447,1.0,0.0022371364653243847,0.9977628635346756,354,0.12304250559284116,0.08501118568232663,0.7919463087248322
846,003,1989,25,546,916,1964,1989,1.0,0.01256913021618904,0.987430869783811,527,0.27450980392156865,0.4605329311211664,0.26495726495726496
847,003,2909,16,907,508,2893,2909,1.0,0.005500171880371262,0.9944998281196288,1494,0.3117909934685459,0.17463045720178755,0.5135785493296665
848,003,1995,1,710,573,1994,1995,1.0,0.0005012531328320802,0.9994987468671679,712,0.3558897243107769,0.28721804511278193,0.3568922305764411
849,003,1025,6,324,414,1019,1025,1.0,0.005853658536585366,0.9941463414634146,287,0.31609756097560976,0.40390243902439027,0.28
850,003,1524,9,506,441,1515,1524,1.0,0.005905511811023622,0.9940944881889764,577,0.3320209973753281,0.28937007874015747,0.37860892388451445
851,003,1344,14,450,354,1330,1344,1.0,0.010416666666666666,0.9895833333333334,540,0.33482142857142855,0.26339285714285715,0.4017857142857143
852,003,230,4,118,80,226,230,1.0,0.017391304347826087,0.9826086956521739,32,0.5130434782608696,0.34782608695652173,0.1391304347826087
853,003,665,2,175,32,663,665,1.0,0.0030075187969924814,0.9969924812030075,458,0.2631578947368421,0.0481203007518797,0.6887218045112782
854,003,416,0,174,140,416,416,1.0,0.0,1.0,102,0.4182692307692308,0.33653846153846156,0.24519230769230768
855,003,1351,9,434,355,1342,1351,1.0,0.006661732050333087,0.993338267949667,562,0.32124352331606215,0.2627683197631384,0.41598815692079943
856,003,1104,7,251,672,1097,1104,1.0,0.006340579710144928,0.9936594202898551,181,0.22735507246376813,0.6086956521739131,0.16394927536231885
858,003,2718,47,727,305,2671,2718,1.0,0.017292126563649743,0.9827078734363502,1686,0.26747608535688006,0.11221486387049301,0.6203090507726269
859,003,1329,2,433,603,1327,1329,1.0,0.0015048908954100827,0.9984951091045899,293,0.3258088788562829,0.45372460496614,0.22046651617757712
860,003,9,0,0,0,9,9,1.0,0.0,1.0,9,0.0,0.0,1.0
861,003,1114,8,410,380,1106,1114,1.0,0.00718132854578097,0.992818671454219,324,0.36804308797127466,0.34111310592459604,0.29084380610412924
862,003,1832,20,648,497,1812,1832,1.0,0.010917030567685589,0.9890829694323144,687,0.3537117903930131,0.2712882096069869,0.375
863,003,2030,24,599,311,2006,2030,1.0,0.011822660098522168,0.9881773399014778,1120,0.29507389162561576,0.15320197044334977,0.5517241379310345
864,003,110,0,38,21,110,110,1.0,0.0,1.0,51,0.34545454545454546,0.19090909090909092,0.4636363636363636
866,003,1340,23,322,169,1317,1340,1.0,0.017164179104477612,0.9828358208955223,849,0.24029850746268658,0.12611940298507462,0.6335820895522388
867,003,987,5,307,303,982,987,1.0,0.005065856129685917,0.9949341438703141,377,0.3110435663627153,0.3069908814589666,0.3819655521783181
868,003,1925,13,432,233,1912,1925,1.0,0.006753246753246753,0.9932467532467533,1260,0.22441558441558443,0.12103896103896104,0.6545454545454545
869,003,599,0,110,22,599,599,1.0,0.0,1.0,467,0.18363939899833054,0.03672787979966611,0.7796327212020033
870,003,9,0,0,0,9,9,1.0,0.0,1.0,9,0.0,0.0,1.0
872,017,174,8,30,86,166,174,1.0,0.04597701149425287,0.9540229885057471,58,0.1724137931034483,0.4942528735632184,0.3333333333333333
873,017,739,9,95,395,730,739,1.0,0.012178619756427604,0.9878213802435724,249,0.12855209742895804,0.5345060893098782,0.33694181326116374
875,031,2,0,0,0,2,2,1.0,0.0,1.0,2,0.0,0.0,1.0
876,031,16,0,0,0,16,16,1.0,0.0,1.0,16,0.0,0.0,1.0
877,031,7,0,0,0,7,7,1.0,0.0,1.0,7,0.0,0.0,1.0
878,031,1209,10,404,136,1199,1209,1.0,0.008271298593879239,0.9917287014061208,669,0.33416046319272125,0.11248966087675766,0.5533498759305211
879,031,211,6,54,41,205,211,1.0,0.02843601895734597,0.9715639810426541,116,0.2559241706161137,0.1943127962085308,0.5497630331753555
882,031,242,1,100,82,241,242,1.0,0.004132231404958678,0.9958677685950413,60,0.4132231404958678,0.33884297520661155,0.24793388429752067
885,031,665,16,232,305,649,665,1.0,0.02406015037593985,0.9759398496240601,128,0.34887218045112783,0.45864661654135336,0.1924812030075188
888,031,5,0,0,0,5,5,1.0,0.0,1.0,5,0.0,0.0,1.0
895,031,1,0,0,0,1,1,1.0,0.0,1.0,1,0.0,0.0,1.0
896,031,195,0,58,72,195,195,1.0,0.0,1.0,65,0.29743589743589743,0.36923076923076925,0.3333333333333333
897,031,227,117,85,57,110,227,1.0,0.5154185022026432,0.4845814977973568,85,0.3744493392070485,0.2511013215859031,0.3744493392070485
898,031,1652,38,332,142,1614,1652,1.0,0.023002421307506054,0.9769975786924939,1178,0.2009685230024213,0.08595641646489104,0.7130750605326877
899,031,337,311,165,18,26,337,1.0,0.9228486646884273,0.0771513353115727,154,0.4896142433234421,0.05341246290801187,0.456973293768546
900,031,1527,53,336,272,1474,1527,1.0,0.03470857891290111,0.9652914210870989,919,0.2200392927308448,0.17812704649639816,0.601833660772757
903,031,332,308,200,32,24,332,1.0,0.927710843373494,0.07228915662650602,100,0.6024096385542169,0.0963855421686747,0.30120481927710846
904,031,1022,32,299,86,990,1022,1.0,0.03131115459882583,0.9686888454011742,637,0.2925636007827789,0.08414872798434442,0.6232876712328768
905,031,1335,36,379,304,1299,1335,1.0,0.02696629213483146,0.9730337078651685,652,0.28389513108614234,0.22771535580524344,0.4883895131086142
906,031,682,17,246,128,665,682,1.0,0.024926686217008796,0.9750733137829912,308,0.36070381231671556,0.187683284457478,0.45161290322580644
907,031,952,13,301,426,939,952,1.0,0.01365546218487395,0.9863445378151261,225,0.3161764705882353,0.4474789915966387,0.23634453781512604
908,031,32,3,1,14,29,32,1.0,0.09375,0.90625,17,0.03125,0.4375,0.53125
909,031,1004,12,179,563,992,1004,1.0,0.01195219123505976,0.9880478087649402,262,0.17828685258964144,0.5607569721115537,0.26095617529880477
910,031,467,16,93,65,451,467,1.0,0.034261241970021415,0.9657387580299786,309,0.19914346895074947,0.139186295503212,0.6616702355460385
911,031,236,3,76,70,233,236,1.0,0.012711864406779662,0.9872881355932204,90,0.3220338983050847,0.2966101694915254,0.3813559322033898
912,031,2918,55,813,304,2863,2918,1.0,0.018848526387936944,0.981151473612063,1801,0.27861549006168607,0.1041809458533242,0.6172035640849897
919,031,1,0,0,0,1,1,1.0,0.0,1.0,1,0.0,0.0,1.0
920,031,12,2,0,0,10,12,1.0,0.16666666666666666,0.8333333333333334,12,0.0,0.0,1.0
925,031,11,0,0,0,11,11,1.0,0.0,1.0,11,0.0,0.0,1.0
926,031,22,0,0,0,22,22,1.0,0.0,1.0,22,0.0,0.0,1.0
927,031,91,0,32,59,91,91,2.1666666666666665,0.0,1.0,0,0.3516483516483517,0.6483516483516484,0.0
929,031,1,0,0,0,1,1,1.0,0.0,1.0,1,0.0,0.0,1.0
931,031,36,0,10,7,36,36,1.0,0.0,1.0,19,0.2777777777777778,0.19444444444444445,0.5277777777777778
932,031,10,0,0,0,10,10,1.0,0.0,1.0,10,0.0,0.0,1.0
935,031,11,0,0,0,11,11,1.0,0.0,1.0,11,0.0,0.0,1.0
937,031,75,0,24,47,75,75,1.0,0.0,1.0,4,0.32,0.6266666666666667,0.05333333333333334
940,031,35,1,8,17,34,35,1.0,0.02857142857142857,0.9714285714285714,10,0.22857142857142856,0.4857142857142857,0.2857142857142857
941,031,2214,32,828,935,2182,2214,1.0,0.014453477868112014,0.985546522131888,451,0.37398373983739835,0.4223125564588979,0.2037037037037037
942,031,11,6,0,0,5,11,1.0,0.5454545454545454,0.45454545454545453,11,0.0,0.0,1.0
943,031,20,0,3,12,20,20,1.0,0.0,1.0,5,0.15,0.6,0.25
944,031,2045,36,435,357,2009,2045,1.0,0.017603911980440097,0.9823960880195599,1253,0.21271393643031786,0.1745721271393643,0.6127139364303178
947,031,2058,10,756,1026,2048,2058,1.0,0.004859086491739553,0.9951409135082604,276,0.3673469387755102,0.49854227405247814,0.13411078717201166
948,031,81,2,21,59,79,81,1.0389610389610389,0.024691358024691357,0.9753086419753086,1,0.25925925925925924,0.7283950617283951,0.012345679012345678
949,031,189,6,24,74,183,189,1.0,0.031746031746031744,0.9682539682539683,91,0.12698412698412698,0.3915343915343915,0.48148148148148145
953,031,3026,52,918,977,2974,3026,1.0,0.017184401850627893,0.9828155981493721,1131,0.30337078651685395,0.3228684732319894,0.37376074025115663
954,031,2659,27,425,138,2632,2659,1.0,0.010154193305754042,0.9898458066942459,2096,0.15983452425723957,0.051899210229409555,0.7882662655133509
955,031,3618,55,568,297,3563,3618,1.0,0.015201768933112217,0.9847982310668878,2753,0.15699281370923163,0.08208955223880597,0.7609176340519624
956,031,957,10,292,301,947,957,1.0,0.01044932079414838,0.9895506792058516,364,0.3051201671891327,0.31452455590386624,0.38035527690700105
957,031,1212,27,177,133,1185,1212,1.0,0.022277227722772276,0.9777227722772277,902,0.14603960396039603,0.10973597359735973,0.7442244224422442
958,031,40,2,13,12,38,40,1.0,0.05,0.95,15,0.325,0.3,0.375
960,031,279,9,74,148,270,279,1.0,0.03225806451612903,0.967741935483871,57,0.26523297491039427,0.5304659498207885,0.20430107526881722
961,031,457,3,168,172,454,457,1.0,0.006564551422319475,0.9934354485776805,117,0.3676148796498906,0.37636761487964987,0.25601750547045954
962,031,14,0,0,0,14,14,1.0,0.0,1.0,14,0.0,0.0,1.0
963,031,1241,24,290,125,1217,1241,1.0,0.019339242546333603,0.9806607574536664,826,0.233682514101531,0.10072522159548751,0.6655922643029815
966,031,918,10,377,301,908,918,1.0,0.010893246187363835,0.9891067538126361,240,0.4106753812636166,0.32788671023965144,0.26143790849673204
969,031,62,3,22,11,59,62,1.0,0.04838709677419355,0.9516129032258065,29,0.3548387096774194,0.1774193548387097,0.46774193548387094
979,031,1792,38,505,562,1754,1792,1.0,0.021205357142857144,0.9787946428571429,725,0.2818080357142857,0.31361607142857145,0.40457589285714285
982,031,1221,9,453,498,1212,1221,1.0,0.007371007371007371,0.9926289926289926,270,0.371007371007371,0.40786240786240785,0.22113022113022113
983,031,425,1,120,155,424,425,1.0,0.002352941176470588,0.9976470588235294,150,0.2823529411764706,0.36470588235294116,0.35294117647058826
988,031,122,1,34,68,121,122,1.0,0.00819672131147541,0.9918032786885246,20,0.2786885245901639,0.5573770491803278,0.16393442622950818
989,031,38,0,6,22,38,38,1.0,0.0,1.0,10,0.15789473684210525,0.5789473684210527,0.2631578947368421
991,031,818,19,274,208,799,818,1.0,0.023227383863080684,0.9767726161369193,336,0.33496332518337407,0.254278728606357,0.41075794621026895
993,031,272,2,85,61,270,272,1.0,0.007352941176470588,0.9926470588235294,126,0.3125,0.22426470588235295,0.4632352941176471
994,031,648,5,219,186,643,648,1.0,0.007716049382716049,0.9922839506172839,243,0.33796296296296297,0.28703703703703703,0.375
995,031,30,0,14,6,30,30,1.0,0.0,1.0,10,0.4666666666666667,0.2,0.3333333333333333
996,031,74,0,36,12,74,74,1.0,0.0,1.0,26,0.4864864864864865,0.16216216216216217,0.35135135135135137
997,031,1501,21,319,292,1480,1501,1.0,0.013990672884743505,0.9860093271152565,890,0.21252498334443704,0.19453697534976683,0.5929380413057961
998,031,341,2,115,130,339,341,1.0,0.005865102639296188,0.9941348973607038,96,0.33724340175953077,0.3812316715542522,0.28152492668621704
999,031,24,2,0,0,22,24,1.0,0.08333333333333333,0.9166666666666666,24,0.0,0.0,1.0
1000,031,2634,70,577,379,2564,2634,1.0,0.026575550493545937,0.973424449506454,1678,0.2190584662110858,0.14388762338648445,0.6370539104024298
1001,031,953,30,354,210,923,953,1.0,0.03147953830010493,0.968520461699895,389,0.37145855194123817,0.2203567681007345,0.40818467995802726
1004,031,1163,12,505,506,1151,1163,1.0,0.010318142734307825,0.9896818572656921,152,0.4342218400687876,0.4350816852966466,0.13069647463456577
1005,031,1445,5,485,488,1440,1445,1.0,0.0034602076124567475,0.9965397923875432,472,0.3356401384083045,0.33771626297577856,0.32664359861591696
1007,031,2,0,0,0,2,2,1.0,0.0,1.0,2,0.0,0.0,1.0
1009,031,56,0,19,9,56,56,1.0,0.0,1.0,28,0.3392857142857143,0.16071428571428573,0.5
1013,011,250,2,16,137,248,250,1.0,0.008,0.992,97,0.064,0.548,0.388
1014,011,385,0,41,247,385,385,1.0,0.0,1.0,97,0.10649350649350649,0.6415584415584416,0.2519480519480519
1015,011,389,1,20,171,388,389,1.0,0.002570694087403599,0.9974293059125964,198,0.05141388174807198,0.43958868894601544,0.5089974293059126
1016,011,425,5,27,332,420,425,1.0,0.011764705882352941,0.9882352941176471,66,0.06352941176470588,0.7811764705882352,0.15529411764705883
1017,510,1885,22,588,886,1863,1885,1.0,0.011671087533156498,0.9883289124668435,411,0.3119363395225464,0.470026525198939,0.2180371352785146
1018,510,1507,10,494,705,1497,1507,1.0,0.006635700066357001,0.993364299933643,308,0.3278035832780358,0.4678168546781685,0.20437956204379562
1019,510,2646,50,660,691,2596,2646,1.0,0.01889644746787604,0.981103552532124,1295,0.2494331065759637,0.26114890400604684,0.4894179894179894
1020,510,1082,8,445,583,1074,1082,1.0,0.0073937153419593345,0.9926062846580407,54,0.411275415896488,0.5388170055452866,0.04990757855822551
1021,510,1923,50,515,529,1873,1923,1.0,0.026001040041601663,0.9739989599583984,879,0.26781071242849713,0.2750910036401456,0.45709828393135726
1022,510,2128,31,701,823,2097,2128,1.0,0.01456766917293233,0.9854323308270677,604,0.3294172932330827,0.3867481203007519,0.28383458646616544
1023,510,1154,10,484,548,1144,1154,1.0,0.008665511265164644,0.9913344887348353,122,0.4194107452339688,0.4748700173310225,0.10571923743500866
1024,510,1311,18,382,537,1293,1311,1.0,0.013729977116704805,0.9862700228832952,392,0.2913806254767353,0.4096109839816934,0.2990083905415713
1025,510,1956,39,539,648,1917,1956,1.0,0.019938650306748466,0.9800613496932515,769,0.27556237218813906,0.3312883435582822,0.39314928425357876
1026,510,1560,171,607,584,1389,1560,1.0,0.10961538461538461,0.8903846153846153,369,0.3891025641025641,0.37435897435897436,0.23653846153846153
1027,510,3788,85,932,873,3703,3788,1.0,0.022439281942977826,0.9775607180570222,1983,0.24604012671594508,0.23046462513199578,0.5234952481520592
1028,510,3702,201,567,1054,3501,3702,1.0,0.05429497568881685,0.9457050243111832,2081,0.15316045380875204,0.2847109670448406,0.5621285791464073
1029,510,1306,18,363,546,1288,1306,1.0,0.013782542113323124,0.9862174578866769,397,0.277947932618683,0.41807044410413474,0.30398162327718226
1030,510,1645,39,375,453,1606,1645,1.0,0.02370820668693009,0.9762917933130699,817,0.22796352583586627,0.2753799392097264,0.4966565349544073
1031,510,833,3,249,481,830,833,1.0,0.003601440576230492,0.9963985594237695,103,0.29891956782713086,0.5774309723889556,0.12364945978391356
1032,510,2376,67,661,676,2309,2376,1.0,0.0281986531986532,0.9718013468013468,1039,0.2781986531986532,0.2845117845117845,0.4372895622895623
1033,510,2250,66,489,698,2184,2250,1.0,0.029333333333333333,0.9706666666666667,1063,0.21733333333333332,0.31022222222222223,0.47244444444444444
1034,510,2721,29,702,871,2692,2721,1.0,0.01065784638000735,0.9893421536199927,1148,0.2579933847850055,0.3201029033443587,0.4219037118706358
1035,510,1835,36,468,563,1799,1835,1.0,0.019618528610354225,0.9803814713896458,804,0.2550408719346049,0.3068119891008174,0.43814713896457763
1036,510,2134,39,646,722,2095,2134,1.0,0.018275538894095594,0.9817244611059044,766,0.302717900656045,0.338331771321462,0.358950328022493
1037,510,2806,73,436,542,2733,2806,1.0,0.02601568068424804,0.9739843193157519,1828,0.15538132573057734,0.1931575196008553,0.6514611546685674
1038,510,1409,23,496,687,1386,1409,1.0,0.016323633782824698,0.9836763662171752,226,0.3520227111426544,0.48757984386089426,0.1603974449964514
1039,510,1798,29,428,461,1769,1798,1.0,0.016129032258064516,0.9838709677419355,909,0.23804226918798665,0.25639599555061177,0.5055617352614016
1040,510,1645,15,503,938,1630,1645,1.0,0.00911854103343465,0.9908814589665653,204,0.3057750759878419,0.5702127659574469,0.12401215805471125
1041,027,2128,100,162,585,2028,2128,1.0,0.046992481203007516,0.9530075187969925,1381,0.07612781954887218,0.274906015037594,0.6489661654135338
1042,027,995,19,52,171,976,995,1.0,0.019095477386934675,0.9809045226130654,772,0.05226130653266332,0.17185929648241205,0.7758793969849246
1043,027,234,2,14,109,232,234,1.0,0.008547008547008548,0.9914529914529915,111,0.05982905982905983,0.4658119658119658,0.47435897435897434
1044,027,792,6,80,398,786,792,1.0,0.007575757575757576,0.9924242424242424,314,0.10101010101010101,0.5025252525252525,0.39646464646464646
1045,027,634,30,110,203,604,634,1.0,0.0473186119873817,0.9526813880126183,321,0.17350157728706625,0.32018927444794953,0.5063091482649842
1046,027,632,19,129,265,613,632,1.0,0.030063291139240507,0.9699367088607594,238,0.20411392405063292,0.41930379746835444,0.37658227848101267
1047,007,791,19,131,279,772,791,1.0,0.02402022756005057,0.9759797724399494,381,0.16561314791403287,0.3527180783817952,0.48166877370417194
1048,007,1920,22,203,1264,1898,1920,1.0,0.011458333333333333,0.9885416666666667,453,0.10572916666666667,0.6583333333333333,0.2359375
1049,007,924,127,154,323,797,924,1.0,0.13744588744588745,0.8625541125541125,447,0.16666666666666666,0.3495670995670996,0.4837662337662338
1050,007,845,26,168,347,819,845,1.0,0.03076923076923077,0.9692307692307692,330,0.19881656804733727,0.4106508875739645,0.3905325443786982
1051,007,1625,46,183,342,1579,1625,1.0,0.028307692307692308,0.9716923076923077,1100,0.11261538461538462,0.21046153846153845,0.676923076923077
1052,007,1993,43,292,928,1950,1993,1.0,0.021575514300050176,0.9784244856999498,773,0.14651279478173607,0.46562970396387354,0.3878575012543904
1053,007,1236,22,123,695,1214,1236,1.0,0.01779935275080906,0.982200647249191,418,0.09951456310679611,0.5622977346278317,0.33818770226537215
1054,007,2091,20,264,1270,2071,2091,1.0,0.009564801530368245,0.9904351984696318,557,0.12625538020086083,0.6073648971783836,0.2663797226207556
1055,007,1968,38,327,321,1930,1968,1.0,0.019308943089430895,0.9806910569105691,1320,0.16615853658536586,0.16310975609756098,0.6707317073170732
1056,007,138,1,18,99,137,138,1.0,0.007246376811594203,0.9927536231884058,21,0.13043478260869565,0.717391304347826,0.15217391304347827
1057,007,708,617,98,29,91,708,1.0,0.8714689265536724,0.1285310734463277,581,0.1384180790960452,0.04096045197740113,0.8206214689265536
1058,007,15,0,0,0,15,15,1.0,0.0,1.0,15,0.0,0.0,1.0
1059,007,149,3,9,82,146,149,1.0,0.020134228187919462,0.9798657718120806,58,0.06040268456375839,0.5503355704697986,0.38926174496644295
1060,007,630,5,31,342,625,630,1.0,0.007936507936507936,0.9920634920634921,257,0.049206349206349205,0.5428571428571428,0.40793650793650793
1061,007,960,19,67,376,941,960,1.0,0.019791666666666666,0.9802083333333333,517,0.06979166666666667,0.39166666666666666,0.5385416666666667
1062,007,581,75,41,381,506,581,1.0,0.12908777969018934,0.8709122203098106,159,0.07056798623063683,0.6557659208261618,0.2736660929432014
1063,007,957,25,83,443,932,957,1.0,0.02612330198537095,0.9738766980146291,431,0.08672936259143156,0.46290491118077326,0.4503657262277952
1064,007,872,18,124,337,854,872,1.0,0.020642201834862386,0.9793577981651376,411,0.14220183486238533,0.38646788990825687,0.4713302752293578
1065,007,1199,54,188,524,1145,1199,1.0,0.045037531276063386,0.9549624687239366,487,0.15679733110925773,0.4370308590492077,0.4061718098415346
1066,007,797,21,99,514,776,797,1.0,0.026348808030112924,0.973651191969887,184,0.12421580928481807,0.644918444165621,0.23086574654956085
1067,007,193,3,18,101,190,193,1.0,0.015544041450777202,0.9844559585492227,74,0.09326424870466321,0.5233160621761658,0.38341968911917096
1068,007,1404,40,75,750,1364,1404,1.0,0.02849002849002849,0.9715099715099715,579,0.053418803418803416,0.5341880341880342,0.41239316239316237
1069,007,130,4,10,114,126,130,1.0,0.03076923076923077,0.9692307692307692,6,0.07692307692307693,0.8769230769230769,0.046153846153846156
1070,007,1594,55,232,712,1539,1594,1.0,0.03450439146800502,0.965495608531995,650,0.14554579673776663,0.4466750313676286,0.4077791718946048
1071,007,689,18,104,341,671,689,1.0,0.026124818577648767,0.9738751814223512,244,0.1509433962264151,0.4949201741654572,0.35413642960812775
1072,007,1631,383,220,750,1248,1631,1.0,0.23482526057633354,0.7651747394236664,661,0.134886572654813,0.4598405885959534,0.4052728387492336
1073,007,1758,56,156,295,1702,1758,1.0,0.03185437997724687,0.9681456200227532,1307,0.08873720136518772,0.16780432309442547,0.7434584755403868
1074,007,1386,52,134,361,1334,1386,1.0,0.03751803751803752,0.9624819624819625,891,0.09668109668109669,0.26046176046176045,0.6428571428571429
1075,007,44,2,12,24,42,44,1.0,0.045454545454545456,0.9545454545454546,8,0.2727272727272727,0.5454545454545454,0.18181818181818182
1076,007,1669,15,168,1155,1654,1669,1.0,0.008987417615338526,0.9910125823846615,346,0.1006590772917915,0.6920311563810665,0.20730976632714201
1077,007,1597,37,179,1024,1560,1597,1.0,0.023168440826549782,0.9768315591734502,394,0.11208515967438948,0.641202254226675,0.2467125860989355
1078,007,1426,22,101,741,1404,1426,1.0,0.015427769985974754,0.9845722300140253,584,0.07082748948106592,0.5196353436185134,0.40953716690042075
1079,007,1214,23,136,515,1191,1214,1.0,0.018945634266886325,0.9810543657331137,563,0.11202635914332784,0.4242174629324547,0.46375617792421747
1080,007,315,2,16,103,313,315,1.0,0.006349206349206349,0.9936507936507937,196,0.050793650793650794,0.326984126984127,0.6222222222222222
1081,007,125,5,11,97,120,125,1.0,0.04,0.96,17,0.088,0.776,0.136
1082,007,472,26,52,190,446,472,1.0,0.05508474576271186,0.9449152542372882,230,0.11016949152542373,0.4025423728813559,0.4872881355932203
1083,007,675,7,125,92,668,675,1.0,0.01037037037037037,0.9896296296296296,458,0.18518518518518517,0.1362962962962963,0.6785185185185185
1084,007,172,0,22,97,172,172,1.0,0.0,1.0,53,0.12790697674418605,0.563953488372093,0.3081395348837209
1085,007,59,5,5,47,54,59,1.0,0.0847457627118644,0.9152542372881356,7,0.0847457627118644,0.7966101694915254,0.11864406779661017
1086,007,474,50,76,233,424,474,1.0,0.10548523206751055,0.8945147679324894,165,0.16033755274261605,0.49156118143459915,0.34810126582278483
1087,007,982,41,100,96,941,982,1.0,0.04175152749490835,0.9582484725050916,786,0.10183299389002037,0.09775967413441955,0.8004073319755601
1088,001,866,395,199,270,471,866,1.0,0.4561200923787529,0.5438799076212472,397,0.22979214780600463,0.3117782909930716,0.45842956120092376
1089,001,687,12,84,269,675,687,1.0,0.017467248908296942,0.982532751091703,334,0.1222707423580786,0.3915574963609898,0.4861717612809316
1090,001,1197,19,176,700,1178,1197,1.0,0.015873015873015872,0.9841269841269841,321,0.14703425229741018,0.5847953216374269,0.2681704260651629
1091,001,789,17,129,363,772,789,1.0,0.021546261089987327,0.9784537389100126,297,0.1634980988593156,0.4600760456273764,0.376425855513308
1092,001,1654,46,230,857,1608,1654,1.0,0.02781136638452237,0.9721886336154776,567,0.13905683192261184,0.5181378476420798,0.34280532043530837
1093,001,674,69,119,347,605,674,1.0,0.10237388724035608,0.8976261127596439,208,0.17655786350148367,0.5148367952522255,0.3086053412462908
1094,001,628,12,89,305,616,628,1.0,0.01910828025477707,0.9808917197452229,234,0.14171974522292993,0.4856687898089172,0.37261146496815284
1095,001,876,20,117,504,856,876,1.0,0.0228310502283105,0.9771689497716894,255,0.13356164383561644,0.5753424657534246,0.2910958904109589
1096,001,914,9,112,528,905,914,1.0,0.009846827133479213,0.9901531728665208,274,0.12253829321663019,0.5776805251641138,0.29978118161925604
1097,001,1029,22,184,595,1007,1029,1.0,0.021379980563654033,0.9786200194363459,250,0.17881438289601556,0.5782312925170068,0.24295432458697766
1098,001,1583,23,265,888,1560,1583,1.0,0.014529374605180037,0.98547062539482,430,0.16740366392924827,0.5609602021478206,0.2716361339229311
1099,001,792,13,100,500,779,792,1.0,0.016414141414141416,0.9835858585858586,192,0.12626262626262627,0.6313131313131313,0.24242424242424243
1100,001,1124,60,142,365,1064,1124,1.0,0.05338078291814947,0.9466192170818505,617,0.12633451957295375,0.32473309608540923,0.548932384341637
1101,001,1380,37,216,383,1343,1380,1.0,0.02681159420289855,0.9731884057971014,781,0.1565217391304348,0.27753623188405796,0.5659420289855073
1102,001,623,5,68,396,618,623,1.0,0.008025682182985553,0.9919743178170144,159,0.10914927768860354,0.6356340288924559,0.2552166934189406
1103,001,1571,44,266,498,1527,1571,1.0,0.028007638446849142,0.9719923615531508,807,0.16931890515595163,0.316995544239338,0.5136855506047103
1104,001,1334,23,227,510,1311,1334,1.0,0.017241379310344827,0.9827586206896551,597,0.1701649175412294,0.3823088455772114,0.44752623688155924
1105,001,911,36,151,352,875,911,1.0,0.03951701427003293,0.960482985729967,408,0.16575192096597147,0.38638858397365533,0.4478594950603732
1106,001,1149,12,174,737,1137,1149,1.0,0.010443864229765013,0.9895561357702349,238,0.1514360313315927,0.6414273281114012,0.2071366405570061
1107,009,98,10,4,42,88,98,1.0,0.10204081632653061,0.8979591836734694,52,0.04081632653061224,0.42857142857142855,0.5306122448979592
1108,009,215,3,36,178,212,215,1.1204188481675392,0.013953488372093023,0.986046511627907,1,0.16744186046511628,0.827906976744186,0.004651162790697674
1109,009,22,0,2,11,22,22,1.0,0.0,1.0,9,0.09090909090909091,0.5,0.4090909090909091
1110,009,17,0,0,0,17,17,1.0,0.0,1.0,17,0.0,0.0,1.0
1111,009,268,10,30,164,258,268,1.0,0.03731343283582089,0.9626865671641791,74,0.11194029850746269,0.6119402985074627,0.27611940298507465
1112,013,345,2,37,195,343,345,1.0,0.005797101449275362,0.9942028985507246,113,0.1072463768115942,0.5652173913043478,0.32753623188405795
1113,013,243,6,29,126,237,243,1.0,0.024691358024691357,0.9753086419753086,88,0.11934156378600823,0.5185185185185185,0.36213991769547327
1114,013,238,10,23,133,228,238,1.0,0.04201680672268908,0.957983193277311,82,0.09663865546218488,0.5588235294117647,0.3445378151260504
1115,013,487,13,51,240,474,487,1.0,0.026694045174537988,0.973305954825462,196,0.10472279260780287,0.4928131416837782,0.4024640657084189
1116,013,1275,33,124,781,1242,1275,1.0,0.02588235294117647,0.9741176470588235,370,0.09725490196078432,0.6125490196078431,0.2901960784313726
1117,013,931,7,94,564,924,931,1.0,0.007518796992481203,0.9924812030075187,273,0.10096670247046187,0.6058002148227712,0.2932330827067669
1118,013,299,3,18,219,296,299,1.0,0.010033444816053512,0.9899665551839465,62,0.06020066889632107,0.7324414715719063,0.20735785953177258
1119,013,308,186,65,48,122,308,1.0,0.6038961038961039,0.3961038961038961,195,0.21103896103896103,0.15584415584415584,0.6331168831168831
1120,013,177,1,10,94,176,177,1.0,0.005649717514124294,0.9943502824858758,73,0.05649717514124294,0.5310734463276836,0.4124293785310734
1121,013,1797,18,217,875,1779,1797,1.0,0.01001669449081803,0.989983305509182,705,0.12075681691708402,0.4869226488592098,0.39232053422370616
1122,013,1328,34,181,512,1294,1328,1.0,0.025602409638554216,0.9743975903614458,635,0.13629518072289157,0.3855421686746988,0.47816265060240964
1123,013,1585,62,221,448,1523,1585,1.0,0.039116719242902206,0.9608832807570978,916,0.13943217665615143,0.28264984227129336,0.5779179810725552
1124,013,1278,17,241,770,1261,1278,1.0,0.013302034428794992,0.986697965571205,267,0.18857589984350548,0.6025039123630673,0.20892018779342722
1125,013,1357,23,215,434,1334,1357,1.0,0.01694915254237288,0.9830508474576272,708,0.1584377302873987,0.3198231392778187,0.5217391304347826
1126,013,1108,50,157,423,1058,1108,1.0,0.04512635379061372,0.9548736462093863,528,0.14169675090252706,0.38176895306859204,0.47653429602888087
1127,005,1224,17,339,595,1207,1224,1.0,0.013888888888888888,0.9861111111111112,290,0.2769607843137255,0.4861111111111111,0.2369281045751634
1128,005,1763,10,406,950,1753,1763,1.0,0.005672149744753261,0.9943278502552467,407,0.23028927963698242,0.5388542257515598,0.23085649461145774
1129,005,275,254,97,40,21,275,1.0,0.9236363636363636,0.07636363636363637,138,0.3527272727272727,0.14545454545454545,0.5018181818181818
1130,005,1355,15,376,820,1340,1355,1.0,0.01107011070110701,0.988929889298893,159,0.2774907749077491,0.6051660516605166,0.11734317343173432
1131,005,854,13,267,429,841,854,1.0,0.01522248243559719,0.9847775175644028,158,0.3126463700234192,0.5023419203747073,0.18501170960187355
1132,005,1243,11,289,829,1232,1243,1.0,0.008849557522123894,0.9911504424778761,125,0.2325020112630732,0.666934835076428,0.1005631536604988
1133,005,502,4,113,305,498,502,1.0,0.00796812749003984,0.9920318725099602,84,0.2250996015936255,0.6075697211155379,0.16733067729083664
1134,005,942,9,218,655,933,942,1.0,0.009554140127388535,0.9904458598726115,69,0.23142250530785563,0.6953290870488322,0.0732484076433121
1135,005,1701,43,378,999,1658,1701,1.0,0.025279247501469725,0.9747207524985303,324,0.2222222222222222,0.5873015873015873,0.19047619047619047
1136,005,549,3,140,388,546,549,1.0,0.00546448087431694,0.994535519125683,21,0.2550091074681239,0.7067395264116576,0.03825136612021858
1137,005,916,5,318,497,911,916,1.0,0.0054585152838427945,0.9945414847161572,101,0.3471615720524017,0.5425764192139738,0.11026200873362445
1138,005,1569,17,461,650,1552,1569,1.0,0.010834926704907584,0.9891650732950924,458,0.29381771829190567,0.41427660930529,0.29190567240280435
1139,005,953,11,222,608,942,953,1.0,0.011542497376705142,0.9884575026232949,123,0.23294858342077648,0.6379853095487933,0.12906610703043023
1140,005,719,6,217,349,713,719,1.0,0.008344923504867872,0.9916550764951322,153,0.30180806675938804,0.4853963838664812,0.21279554937413073
1141,005,929,10,340,489,919,929,1.0,0.010764262648008612,0.9892357373519914,100,0.36598493003229277,0.5263724434876211,0.10764262648008611
1142,005,995,19,213,648,976,995,1.0,0.019095477386934675,0.9809045226130654,134,0.21407035175879396,0.6512562814070352,0.13467336683417086
1143,005,1310,23,301,499,1287,1310,1.0,0.017557251908396947,0.982442748091603,510,0.2297709923664122,0.38091603053435114,0.3893129770992366
1144,005,773,10,215,435,763,773,1.0,0.0129366106080207,0.9870633893919794,123,0.278137128072445,0.5627425614489003,0.1591203104786546
1145,005,1732,17,436,915,1715,1732,1.0,0.009815242494226328,0.9901847575057737,381,0.2517321016166282,0.5282909930715936,0.2199769053117783
1146,005,1518,20,384,803,1498,1518,1.0,0.013175230566534914,0.9868247694334651,331,0.25296442687747034,0.5289855072463768,0.21805006587615283
1147,005,1474,17,335,642,1457,1474,1.0,0.011533242876526458,0.9884667571234735,497,0.22727272727272727,0.4355495251017639,0.33717774762550884
1148,005,8,1,0,0,7,8,1.0,0.125,0.875,8,0.0,0.0,1.0
1149,005,597,4,157,343,593,597,1.0,0.006700167504187605,0.9932998324958124,97,0.2629815745393635,0.5745393634840871,0.1624790619765494
1150,005,1265,10,310,830,1255,1265,1.0,0.007905138339920948,0.9920948616600791,125,0.2450592885375494,0.6561264822134387,0.09881422924901186
1151,005,1703,23,496,748,1680,1703,1.0,0.013505578391074574,0.9864944216089254,459,0.2912507339988256,0.4392248972401644,0.26952436876101
1152,005,597,10,167,310,587,597,1.0,0.01675041876046901,0.983249581239531,120,0.2797319932998325,0.5192629815745393,0.20100502512562815
1153,005,1156,2,371,556,1154,1156,1.0,0.0017301038062283738,0.9982698961937716,229,0.3209342560553633,0.4809688581314879,0.1980968858131488
1154,005,1657,42,494,789,1615,1657,1.0,0.025347012673506336,0.9746529873264936,374,0.29812914906457455,0.47616173808086903,0.22570911285455642
1155,005,962,7,288,614,955,962,1.0,0.007276507276507277,0.9927234927234927,60,0.2993762993762994,0.6382536382536382,0.062370062370062374
1156,005,797,7,237,500,790,797,1.0,0.00878293601003764,0.9912170639899623,60,0.2973651191969887,0.6273525721455459,0.07528230865746549
1157,005,734,6,199,500,728,734,1.0,0.008174386920980926,0.9918256130790191,35,0.27111716621253407,0.6811989100817438,0.047683923705722074
1158,005,627,3,229,301,624,627,1.0,0.004784688995215311,0.9952153110047847,97,0.3652312599681021,0.4800637958532695,0.1547049441786284
1159,005,785,6,353,301,779,785,1.0,0.007643312101910828,0.9923566878980892,131,0.4496815286624204,0.3834394904458599,0.16687898089171974
1160,005,496,2,165,280,494,496,1.0,0.004032258064516129,0.9959677419354839,51,0.3326612903225806,0.5645161290322581,0.1028225806451613
1161,005,522,1,155,286,521,522,1.0,0.0019157088122605363,0.9980842911877394,81,0.29693486590038315,0.5478927203065134,0.15517241379310345
1162,005,972,6,514,342,966,972,1.0,0.006172839506172839,0.9938271604938271,116,0.5288065843621399,0.35185185185185186,0.11934156378600823
1163,005,491,2,135,124,489,491,1.0,0.004073319755600814,0.9959266802443992,232,0.27494908350305497,0.2525458248472505,0.4725050916496945
1164,005,1057,8,445,457,1049,1057,1.0,0.007568590350047304,0.9924314096499527,155,0.4210028382213813,0.4323557237464522,0.1466414380321665
1165,005,666,9,110,360,657,666,1.0,0.013513513513513514,0.9864864864864865,196,0.16516516516516516,0.5405405405405406,0.29429429429429427
1166,005,1425,31,306,793,1394,1425,1.0,0.02175438596491228,0.9782456140350877,326,0.21473684210526317,0.5564912280701755,0.2287719298245614
1167,005,1408,22,374,644,1386,1408,1.0,0.015625,0.984375,390,0.265625,0.45738636363636365,0.27698863636363635
1168,033,1257,44,26,150,1213,1257,1.0,0.035003977724741446,0.9649960222752586,1081,0.020684168655529037,0.11933174224343675,0.8599840891010342
1169,033,129,9,67,61,120,129,1.0,0.06976744186046512,0.9302325581395349,1,0.5193798449612403,0.4728682170542636,0.007751937984496124
1170,033,1491,136,172,934,1355,1491,1.0,0.09121395036887994,0.9087860496311201,385,0.1153588195841717,0.6264252179745138,0.25821596244131456
1171,033,635,13,94,324,622,635,1.0,0.02047244094488189,0.9795275590551181,217,0.14803149606299212,0.510236220472441,0.3417322834645669
1172,033,813,27,99,408,786,813,1.0,0.033210332103321034,0.966789667896679,306,0.12177121771217712,0.5018450184501845,0.3763837638376384
1173,033,675,18,110,389,657,675,1.0,0.02666666666666667,0.9733333333333334,176,0.16296296296296298,0.5762962962962963,0.2607407407407407
1174,033,331,5,37,142,326,331,1.0,0.015105740181268883,0.9848942598187311,152,0.11178247734138973,0.42900302114803623,0.459214501510574
1175,033,758,30,121,336,728,758,1.0,0.0395778364116095,0.9604221635883905,301,0.15963060686015831,0.44327176781002636,0.3970976253298153
1176,033,289,2,17,261,287,289,1.0,0.006920415224913495,0.9930795847750865,11,0.058823529411764705,0.903114186851211,0.03806228373702422
1177,033,799,15,113,395,784,799,1.0,0.01877346683354193,0.981226533166458,291,0.1414267834793492,0.49436795994993743,0.3642052565707134
1178,019,2164,23,470,1168,2141,2164,1.0,0.010628465804066543,0.9893715341959335,526,0.21719038817005545,0.5397412199630314,0.24306839186691312
1179,019,1641,30,250,830,1611,1641,1.0,0.018281535648994516,0.9817184643510055,561,0.15234613040828762,0.505789152955515,0.34186471663619744
1180,019,1192,16,207,626,1176,1192,1.0,0.013422818791946308,0.9865771812080537,359,0.17365771812080538,0.5251677852348994,0.3011744966442953
1181,019,554,8,114,270,546,554,1.0,0.01444043321299639,0.9855595667870036,170,0.20577617328519857,0.48736462093862815,0.30685920577617326
1182,019,182,3,81,44,179,182,1.0,0.016483516483516484,0.9835164835164835,57,0.44505494505494503,0.24175824175824176,0.3131868131868132
1183,019,952,10,219,463,942,952,1.0,0.01050420168067227,0.9894957983193278,270,0.23004201680672268,0.48634453781512604,0.28361344537815125
1184,019,381,4,69,153,377,381,1.0,0.010498687664041995,0.989501312335958,159,0.18110236220472442,0.4015748031496063,0.41732283464566927
1185,019,1525,17,341,763,1508,1525,1.0,0.011147540983606558,0.9888524590163934,421,0.22360655737704918,0.5003278688524591,0.2760655737704918
1186,019,1803,31,375,758,1772,1803,1.0,0.017193566278424846,0.9828064337215752,670,0.2079866888519135,0.4204104270660011,0.3716028840820854
1187,019,465,14,82,258,451,465,1.0,0.030107526881720432,0.9698924731182795,125,0.17634408602150536,0.5548387096774193,0.26881720430107525
1188,019,772,12,175,260,760,772,1.0,0.015544041450777202,0.9844559585492227,337,0.2266839378238342,0.33678756476683935,0.4365284974093264
1189,019,2019,34,406,1087,1985,2019,1.0,0.016840019811788013,0.9831599801882119,526,0.20108964834076276,0.5383853392768697,0.2605250123823675
1190,019,1280,10,318,777,1270,1280,1.0,0.0078125,0.9921875,185,0.2484375,0.60703125,0.14453125
1191,019,301,1,68,202,300,301,1.0,0.0033222591362126247,0.9966777408637874,31,0.22591362126245848,0.6710963455149501,0.10299003322259136
1192,019,1469,28,233,523,1441,1469,1.0,0.01906058543226685,0.9809394145677331,713,0.15861130020422057,0.35602450646698436,0.4853641933287951
1193,019,1758,29,320,802,1729,1758,1.0,0.016496018202502846,0.9835039817974972,636,0.1820250284414107,0.45620022753128553,0.36177474402730375
1194,019,2369,68,392,701,2301,2369,1.0,0.028704094554664415,0.9712959054453356,1276,0.16547066272688898,0.29590544533558466,0.5386238919375264
1195,019,919,9,189,483,910,919,1.0,0.009793253536452665,0.9902067464635473,247,0.20565832426550598,0.5255712731229597,0.2687704026115343
1196,019,1865,32,336,893,1833,1865,1.0,0.017158176943699734,0.9828418230563003,636,0.18016085790884717,0.4788203753351206,0.34101876675603215
1197,019,1483,37,272,470,1446,1483,1.0,0.024949426837491573,0.9750505731625084,741,0.18341200269723534,0.31692515171948754,0.4996628455832771
1198,019,1388,29,260,610,1359,1388,1.0,0.02089337175792507,0.979106628242075,518,0.1873198847262248,0.43948126801152737,0.37319884726224783
1199,019,482,7,78,185,475,482,1.0,0.014522821576763486,0.9854771784232366,219,0.16182572614107885,0.38381742738589214,0.45435684647302904
1200,019,665,12,116,321,653,665,1.0,0.01804511278195489,0.9819548872180451,228,0.17443609022556392,0.48270676691729325,0.34285714285714286
1201,019,1463,35,318,556,1428,1463,1.0,0.023923444976076555,0.9760765550239234,589,0.21736158578263842,0.380041011619959,0.4025974025974026
1202,019,515,6,109,247,509,515,1.0,0.011650485436893204,0.9883495145631068,159,0.21165048543689322,0.4796116504854369,0.3087378640776699
1203,019,1732,20,274,714,1712,1732,1.0,0.011547344110854504,0.9884526558891455,744,0.1581986143187067,0.4122401847575058,0.4295612009237875
1204,019,1297,28,230,554,1269,1297,1.0,0.02158828064764842,0.9784117193523516,513,0.17733230531996916,0.4271395528141866,0.39552814186584423
1205,019,1048,19,196,488,1029,1048,1.0,0.01812977099236641,0.9818702290076335,364,0.18702290076335878,0.46564885496183206,0.3473282442748092
1206,019,1163,26,243,449,1137,1163,1.0,0.02235597592433362,0.9776440240756664,471,0.20894239036973344,0.3860705073086844,0.40498710232158214
1207,019,941,6,136,410,935,941,1.0,0.006376195536663124,0.9936238044633369,395,0.14452709883103082,0.4357066950053135,0.4197662061636557
1208,019,1117,21,139,389,1096,1117,1.0,0.018800358102059087,0.981199641897941,589,0.12444046553267682,0.34825425246195163,0.5273052820053715
1209,019,1019,21,158,530,998,1019,1.0,0.020608439646712464,0.9793915603532876,331,0.155053974484789,0.5201177625122669,0.32482826300294404
1210,019,1172,14,211,541,1158,1172,1.0,0.011945392491467578,0.9880546075085325,420,0.18003412969283278,0.4616040955631399,0.3583617747440273
1211,019,676,13,90,346,663,676,1.0,0.019230769230769232,0.9807692307692307,240,0.13313609467455623,0.5118343195266272,0.35502958579881655
1212,019,1107,28,169,480,1079,1107,1.0,0.025293586269196026,0.974706413730804,458,0.15266485998193316,0.43360433604336046,0.4137308039747064
1213,019,99,12,15,28,87,99,1.0,0.12121212121212122,0.8787878787878788,56,0.15151515151515152,0.2828282828282828,0.5656565656565656
1214,019,1180,152,242,501,1028,1180,1.0,0.1288135593220339,0.8711864406779661,437,0.20508474576271185,0.4245762711864407,0.37033898305084745
1215,019,416,7,68,269,409,416,1.0,0.016826923076923076,0.9831730769230769,79,0.16346153846153846,0.6466346153846154,0.18990384615384615
1216,019,2410,152,319,967,2258,2410,1.0,0.06307053941908713,0.9369294605809129,1124,0.13236514522821577,0.4012448132780083,0.46639004149377594
1217,019,1134,10,184,790,1124,1134,1.0,0.008818342151675485,0.9911816578483245,160,0.16225749559082892,0.6966490299823633,0.14109347442680775
1218,003,2342,37,646,354,2305,2342,1.0,0.015798462852263023,0.984201537147737,1342,0.27583262169086253,0.1511528608027327,0.5730145175064048
1219,003,1702,23,559,368,1679,1702,1.0,0.013513513513513514,0.9864864864864865,775,0.3284371327849589,0.21621621621621623,0.45534665099882493
1220,003,2121,25,651,242,2096,2121,1.0,0.011786892975011787,0.9882131070249882,1228,0.3069306930693069,0.1140971239981141,0.578972182932579
1221,003,1846,8,657,646,1838,1846,1.0,0.004333694474539545,0.9956663055254604,543,0.35590465872156013,0.34994582881906827,0.2941495124593716
1222,003,2221,21,685,848,2200,2221,1.0,0.00945520036019811,0.9905447996398019,688,0.3084196307969383,0.38180999549752365,0.30977037370553806
1223,003,1818,17,537,627,1801,1818,1.0,0.00935093509350935,0.9906490649064906,654,0.2953795379537954,0.3448844884488449,0.35973597359735976
1224,003,2197,20,681,516,2177,2197,1.0,0.009103322712790168,0.9908966772872099,1000,0.30996813837050524,0.23486572598998634,0.4551661356395084
1225,003,2378,11,988,292,2367,2378,1.0,0.004625735912531539,0.9953742640874684,1098,0.415475189234651,0.12279226240538267,0.46173254835996635
1226,003,2119,11,578,496,2108,2119,1.0,0.005191127890514393,0.9948088721094857,1045,0.2727701746106654,0.2340726757904672,0.4931571495988674
1227,003,2786,77,627,631,2709,2786,1.0,0.02763819095477387,0.9723618090452262,1528,0.2250538406317301,0.22648959081119885,0.548456568557071
1228,003,1742,28,572,594,1714,1742,1.0,0.016073478760045924,0.983926521239954,576,0.3283582089552239,0.3409873708381171,0.330654420206659
1229,003,1341,1,490,299,1340,1341,1.0,0.0007457121551081282,0.9992542878448919,552,0.36539895600298283,0.22296793437733034,0.4116331096196868
1230,003,1494,11,548,442,1483,1494,1.0,0.007362784471218206,0.9926372155287818,504,0.3668005354752343,0.2958500669344043,0.3373493975903614
1231,003,524,2,97,42,522,524,1.0,0.003816793893129771,0.9961832061068703,385,0.1851145038167939,0.08015267175572519,0.7347328244274809
1232,003,1375,17,614,53,1358,1375,1.0,0.012363636363636363,0.9876363636363636,708,0.4465454545454545,0.03854545454545454,0.5149090909090909
1233,003,50,4,0,0,46,50,1.0,0.08,0.92,50,0.0,0.0,1.0
1234,003,1173,16,351,179,1157,1173,1.0,0.013640238704177323,0.9863597612958227,643,0.29923273657289,0.1526001705029838,0.5481670929241261
1236,003,2720,21,363,262,2699,2720,1.0,0.007720588235294118,0.9922794117647059,2095,0.13345588235294117,0.09632352941176471,0.7702205882352942
1237,003,1510,8,503,491,1502,1510,1.0,0.005298013245033113,0.9947019867549669,516,0.33311258278145695,0.3251655629139073,0.34172185430463575
1238,003,2262,31,684,882,2231,2262,1.0,0.013704686118479222,0.9862953138815208,696,0.30238726790450926,0.38992042440318303,0.3076923076923077
1239,003,1706,4,649,573,1702,1706,1.0,0.0023446658851113715,0.9976553341148886,484,0.38042203985932005,0.335873388042204,0.283704572098476
1240,003,1722,21,422,454,1701,1722,1.0,0.012195121951219513,0.9878048780487805,846,0.2450638792102207,0.26364692218350755,0.4912891986062718
1241,003,1091,18,403,30,1073,1091,1.0,0.016498625114573784,0.9835013748854262,658,0.3693858845096242,0.027497708524289642,0.6031164069660861
1242,003,3298,24,1051,618,3274,3298,1.0,0.0072771376591873865,0.9927228623408126,1629,0.31867798665858094,0.1873862947240752,0.49393571861734387
1243,003,2718,16,845,480,2702,2718,1.0,0.005886681383370125,0.9941133186166299,1393,0.31089036055923475,0.17660044150110377,0.5125091979396615
1244,003,2751,11,955,712,2740,2751,1.0,0.003998545983278807,0.9960014540167212,1084,0.34714649218466015,0.2588149763722283,0.3940385314431116
1245,003,914,2,393,460,912,914,1.0,0.002188183807439825,0.9978118161925602,61,0.4299781181619256,0.5032822757111597,0.06673960612691467
1249,003,775,4,266,113,771,775,1.0,0.005161290322580645,0.9948387096774194,396,0.3432258064516129,0.14580645161290323,0.5109677419354839
1252,003,4,0,0,0,4,4,1.0,0.0,1.0,4,0.0,0.0,1.0
1254,003,3,0,0,0,3,3,1.0,0.0,1.0,3,0.0,0.0,1.0
1256,003,3127,35,514,176,3092,3127,1.0,0.011192836584585865,0.9888071634154141,2437,0.16437480012791814,0.05628397825391749,0.7793412216181643
1257,003,12,0,0,0,12,12,1.0,0.0,1.0,12,0.0,0.0,1.0
1259,003,1656,41,574,445,1615,1656,1.0,0.024758454106280192,0.9752415458937198,637,0.3466183574879227,0.26871980676328505,0.38466183574879226
1260,003,545,4,166,178,541,545,1.0,0.007339449541284404,0.9926605504587156,201,0.30458715596330277,0.326605504587156,0.3688073394495413
1261,003,1527,32,322,64,1495,1527,1.0,0.020956123117223315,0.9790438768827767,1141,0.2108709888670596,0.04191224623444663,0.7472167648984938
1266,003,3,0,0,0,3,3,1.0,0.0,1.0,3,0.0,0.0,1.0
1267,003,10,0,0,0,10,10,1.0,0.0,1.0,10,0.0,0.0,1.0
1268,003,6,0,0,0,6,6,1.0,0.0,1.0,6,0.0,0.0,1.0
1269,003,3003,20,879,489,2983,3003,1.0,0.00666000666000666,0.9933399933399933,1635,0.29270729270729273,0.16283716283716285,0.5444555444555444
1270,003,1933,6,497,408,1927,1933,1.0,0.0031039834454216243,0.9968960165545784,1028,0.2571132953957579,0.21107087428867047,0.5318158303155717
1271,003,1753,10,530,271,1743,1753,1.0,0.005704506560182544,0.9942954934398175,952,0.30233884768967484,0.15459212778094694,0.5430690245293782
1272,003,895,4,308,283,891,895,1.0,0.004469273743016759,0.9955307262569832,304,0.34413407821229053,0.31620111731843575,0.3396648044692737
1273,003,1262,5,430,484,1257,1262,1.0,0.003961965134706815,0.9960380348652932,348,0.34072900158478603,0.38351822503961963,0.2757527733755943
1274,003,2755,18,839,676,2737,2755,1.0,0.006533575317604356,0.9934664246823957,1240,0.3045372050816697,0.2453720508166969,0.4500907441016334
1275,003,1113,14,280,142,1099,1113,1.0,0.012578616352201259,0.9874213836477987,691,0.25157232704402516,0.1275831087151842,0.6208445642407907
1276,003,2081,28,587,715,2053,2081,1.0,0.013455069678039404,0.9865449303219606,779,0.28207592503604034,0.3435848149927919,0.3743392599711677
1277,003,1150,4,323,519,1146,1150,1.0,0.0034782608695652175,0.9965217391304347,308,0.2808695652173913,0.45130434782608697,0.2678260869565217
1278,003,2361,44,538,587,2317,2361,1.0,0.018636171113934775,0.9813638288860652,1236,0.22786954680220245,0.24862346463362983,0.5235069885641678
1279,003,2048,37,579,265,2011,2048,1.0,0.01806640625,0.98193359375,1204,0.28271484375,0.12939453125,0.587890625
1280,003,2066,18,629,478,2048,2066,1.0,0.008712487899322363,0.9912875121006777,959,0.3044530493707648,0.2313649564375605,0.4641819941916747
1281,003,996,5,352,351,991,996,1.0,0.0050200803212851405,0.9949799196787149,293,0.3534136546184739,0.35240963855421686,0.29417670682730923
1283,003,1699,12,543,667,1687,1699,1.0,0.007062978222483814,0.9929370217775162,489,0.3195997645673926,0.392583872866392,0.2878163625662154
1284,003,1256,25,403,464,1231,1256,1.0,0.019904458598726114,0.9800955414012739,389,0.320859872611465,0.36942675159235666,0.30971337579617836
1285,003,2000,19,729,622,1981,2000,1.0,0.0095,0.9905,649,0.3645,0.311,0.3245
1286,003,360,1,87,226,359,360,1.0,0.002777777777777778,0.9972222222222222,47,0.24166666666666667,0.6277777777777778,0.13055555555555556
1287,003,970,1,372,479,969,970,1.0,0.0010309278350515464,0.9989690721649485,119,0.3835051546391753,0.49381443298969074,0.12268041237113401
1288,003,2508,13,950,272,2495,2508,1.0,0.00518341307814992,0.99481658692185,1286,0.3787878787878788,0.10845295055821372,0.5127591706539075
1289,003,1897,8,681,762,1889,1897,1.0,0.004217185028993147,0.9957828149710068,454,0.3589878755930416,0.40168687401159725,0.2393252503953611
1290,003,2017,12,687,587,2005,2017,1.0,0.005949429846306396,0.9940505701536936,743,0.3406048587010411,0.29102627664848785,0.368368864650471
1291,003,2875,10,880,775,2865,2875,1.0,0.0034782608695652175,0.9965217391304347,1220,0.3060869565217391,0.26956521739130435,0.42434782608695654
1292,003,2087,5,672,862,2082,2087,1.0,0.0023957834211787254,0.9976042165788213,553,0.3219932918064207,0.41303306181121224,0.26497364638236703
1293,003,1690,4,609,600,1686,1690,1.0,0.002366863905325444,0.9976331360946745,481,0.3603550295857988,0.35502958579881655,0.2846153846153846
1294,003,2219,30,667,398,2189,2219,1.0,0.013519603424966201,0.9864803965750338,1154,0.30058584948174855,0.1793600721045516,0.5200540784136999
1295,003,1088,7,391,370,1081,1088,1.0,0.006433823529411764,0.9935661764705882,327,0.359375,0.3400735294117647,0.3005514705882353
1296,003,2538,10,743,624,2528,2538,1.0,0.003940110323089046,0.996059889676911,1171,0.29275019700551613,0.2458628841607565,0.46138691883372734
1297,003,2277,6,626,975,2271,2277,1.0,0.002635046113306983,0.997364953886693,676,0.27492314448836186,0.4281949934123847,0.2968818620992534
1299,003,1051,4,412,377,1047,1051,1.0,0.003805899143672693,0.9961941008563273,262,0.39200761179828736,0.3587059942911513,0.24928639391056137
1300,003,1493,11,490,305,1482,1493,1.0,0.007367716008037508,0.9926322839919625,698,0.3281982585398526,0.2042866711319491,0.4675150703281983
1301,003,2135,0,631,942,2135,2135,1.0,0.0,1.0,562,0.2955503512880562,0.4412177985948478,0.26323185011709604
1302,003,2420,5,775,477,2415,2420,1.0,0.002066115702479339,0.9979338842975206,1168,0.3202479338842975,0.1971074380165289,0.4826446280991736
1303,003,701,3,263,328,698,701,1.0,0.0042796005706134095,0.9957203994293866,110,0.3751783166904422,0.46790299572039945,0.15691868758915833
1304,003,864,0,305,418,864,864,1.0,0.0,1.0,141,0.35300925925925924,0.4837962962962963,0.16319444444444445
1305,003,1440,8,407,406,1432,1440,1.0,0.005555555555555556,0.9944444444444445,627,0.2826388888888889,0.28194444444444444,0.4354166666666667
1306,003,3822,35,1095,684,3787,3822,1.0,0.009157509157509158,0.9908424908424909,2043,0.28649921507064363,0.17896389324960754,0.5345368916797488
1307,003,2295,9,817,725,2286,2295,1.0,0.00392156862745098,0.996078431372549,753,0.3559912854030501,0.3159041394335512,0.3281045751633987
1308,003,1156,2,395,636,1154,1156,1.0,0.0017301038062283738,0.9982698961937716,125,0.3416955017301038,0.5501730103806228,0.10813148788927336
1309,003,1333,21,459,444,1312,1333,1.0,0.015753938484621154,0.9842460615153789,430,0.34433608402100524,0.33308327081770445,0.3225806451612903
1310,003,3164,24,1120,829,3140,3164,1.0,0.007585335018963337,0.9924146649810367,1215,0.35398230088495575,0.2620101137800253,0.38400758533501894
1311,003,2130,25,758,606,2105,2130,1.0,0.011737089201877934,0.9882629107981221,766,0.355868544600939,0.28450704225352114,0.3596244131455399
1312,003,346,2,64,223,344,346,1.0,0.005780346820809248,0.9942196531791907,59,0.18497109826589594,0.6445086705202312,0.17052023121387283
1313,003,2005,34,629,249,1971,2005,1.0,0.016957605985037406,0.9830423940149626,1127,0.31371571072319204,0.12418952618453866,0.5620947630922694
1314,003,3099,42,699,346,3057,3099,1.0,0.013552758954501452,0.9864472410454985,2054,0.22555663117134558,0.11164891900613101,0.6627944498225234
1315,003,952,5,244,454,947,952,1.0,0.005252100840336135,0.9947478991596639,254,0.25630252100840334,0.47689075630252103,0.2668067226890756
1316,003,559,1,189,231,558,559,1.0,0.0017889087656529517,0.998211091234347,139,0.33810375670840787,0.41323792486583183,0.24865831842576028
1317,003,1202,7,382,548,1195,1202,1.0,0.005823627287853577,0.9941763727121464,272,0.3178036605657238,0.4559068219633943,0.22628951747088186
1318,003,1712,12,583,563,1700,1712,1.0,0.007009345794392523,0.9929906542056075,566,0.3405373831775701,0.32885514018691586,0.33060747663551404
1319,003,3946,15,1179,842,3931,3946,1.0,0.003801317790167258,0.9961986822098328,1925,0.29878357830714647,0.21338063862138876,0.4878357830714648
1320,003,1087,5,379,497,1082,1087,1.0,0.004599816007359705,0.9954001839926403,211,0.3486660533578657,0.45722171113155474,0.19411223551057957
1321,003,1418,12,483,605,1406,1418,1.0,0.00846262341325811,0.9915373765867419,330,0.34062059238363895,0.42665726375176305,0.23272214386459802
1322,003,1578,5,581,567,1573,1578,1.0,0.0031685678073510772,0.9968314321926489,430,0.3681875792141952,0.3593155893536122,0.27249683143219267
1323,003,1254,12,407,504,1242,1254,1.0,0.009569377990430622,0.9904306220095693,343,0.32456140350877194,0.4019138755980861,0.27352472089314195
1324,003,1795,24,515,469,1771,1795,1.0,0.013370473537604457,0.9866295264623955,811,0.28690807799442897,0.26128133704735373,0.45181058495821724
1325,003,4003,39,1241,514,3964,4003,1.0,0.0097426929802648,0.9902573070197352,2248,0.3100174868848364,0.1284036972270797,0.5615788158880839
1326,003,3092,16,966,670,3076,3092,1.0,0.00517464424320828,0.9948253557567918,1456,0.31241914618369987,0.2166882276843467,0.47089262613195343
1327,003,1584,11,448,197,1573,1584,1.0,0.006944444444444444,0.9930555555555556,939,0.2828282828282828,0.12436868686868686,0.5928030303030303
1328,003,1497,2,605,643,1495,1497,1.0,0.0013360053440213762,0.9986639946559787,249,0.40414161656646624,0.42952571810287243,0.16633266533066132
1329,003,3633,31,1423,579,3602,3633,1.0,0.00853289292595651,0.9914671070740435,1631,0.3916873107624553,0.1593724194880264,0.4489402697495183
1330,003,3651,31,1316,778,3620,3651,1.0,0.008490824431662557,0.9915091755683374,1557,0.36044919200219117,0.21309230347849903,0.4264585045193098
1331,003,3156,30,1239,923,3126,3156,1.0,0.009505703422053232,0.9904942965779467,994,0.3925855513307985,0.29245880861850443,0.3149556400506971
1333,003,941,5,376,456,936,941,1.0,0.005313496280552604,0.9946865037194474,109,0.3995749202975558,0.48459086078639746,0.11583421891604676
1335,003,2437,20,745,554,2417,2437,1.0,0.008206811653672548,0.9917931883463275,1138,0.3057037340993024,0.22732868280672958,0.466967583093968
1337,003,2027,15,814,525,2012,2027,1.0,0.00740009866798224,0.9925999013320178,688,0.4015786877158362,0.2590034533793784,0.3394178589047854
1338,003,158,0,18,57,158,158,1.0,0.0,1.0,83,0.11392405063291139,0.36075949367088606,0.5253164556962026
1339,003,3388,30,729,677,3358,3388,1.0,0.00885478158205431,0.9911452184179457,1982,0.21517119244391972,0.19982290436835892,0.5850059031877214
1340,003,1457,20,334,268,1437,1457,1.0,0.013726835964310227,0.9862731640356898,855,0.22923816060398078,0.18393960192175704,0.5868222374742622
1341,003,4258,25,1516,1395,4233,4258,1.0,0.0058713010803193985,0.9941286989196806,1347,0.35603569751056835,0.32761860028182244,0.3163457022076092
1342,003,1057,13,289,121,1044,1057,1.0,0.01229895931882687,0.9877010406811731,647,0.27341532639545885,0.11447492904446546,0.6121097445600757
1343,003,2131,54,630,275,2077,2131,1.0,0.025340215861098078,0.974659784138902,1226,0.29563585171281087,0.1290473955889254,0.5753167526982638
1344,003,2265,47,738,388,2218,2265,1.0,0.02075055187637969,0.9792494481236204,1139,0.3258278145695364,0.17130242825607064,0.502869757174393
1345,003,1128,4,397,535,1124,1128,1.0,0.0035460992907801418,0.9964539007092199,196,0.3519503546099291,0.47429078014184395,0.17375886524822695
1346,003,1961,16,801,801,1945,1961,1.0,0.00815910249872514,0.9918408975012749,359,0.40846506884242734,0.40846506884242734,0.18306986231514533
1347,003,1267,5,362,473,1262,1267,1.0,0.003946329913180742,0.9960536700868192,432,0.2857142857142857,0.3733228097868982,0.3409629044988161
1348,003,989,2,279,214,987,989,1.0,0.0020222446916076846,0.9979777553083923,496,0.282103134479272,0.21638018200202225,0.5015166835187057
1349,003,2213,20,782,655,2193,2213,1.0,0.00903750564844103,0.9909624943515589,776,0.35336647085404427,0.29597830998644375,0.350655219159512
1350,003,2053,25,612,430,2028,2053,1.0,0.012177301509985387,0.9878226984900146,1011,0.29810034096444227,0.20944958597174865,0.49245007306380906
1351,003,1044,0,372,379,1044,1044,1.0,0.0,1.0,293,0.3563218390804598,0.36302681992337166,0.28065134099616856
1352,003,1003,0,412,275,1003,1003,1.0,0.0,1.0,316,0.4107676969092722,0.2741774675972084,0.3150548354935194
1353,003,2260,20,860,385,2240,2260,1.0,0.008849557522123894,0.9911504424778761,1015,0.3805309734513274,0.17035398230088494,0.4491150442477876
1354,003,2084,21,725,515,2063,2084,1.0,0.010076775431861805,0.9899232245681382,844,0.3478886756238004,0.24712092130518235,0.4049904030710173
1355,003,2043,34,337,147,2009,2043,1.0,0.016642192853646598,0.9833578071463533,1559,0.16495349975526186,0.07195301027900147,0.7630934899657367
1356,003,2231,31,673,375,2200,2231,1.0,0.013895114298520844,0.9861048857014791,1183,0.30165844912595247,0.16808606006275212,0.5302554908112954
1357,003,1298,16,394,240,1282,1298,1.0,0.012326656394453005,0.987673343605547,664,0.3035439137134052,0.18489984591679506,0.5115562403697997
1358,003,4668,34,1570,1258,4634,4668,1.0,0.00728363324764353,0.9927163667523564,1840,0.3363324764353042,0.2694944301628106,0.39417309340188517
1359,003,1022,5,328,375,1017,1022,1.0,0.004892367906066536,0.9951076320939335,319,0.32093933463796476,0.3669275929549902,0.312133072407045
1360,003,1549,23,568,377,1526,1549,1.0,0.014848289218850872,0.9851517107811492,604,0.3666881859264041,0.2433828276307295,0.3899289864428664
1361,003,2400,20,732,570,2380,2400,1.0,0.008333333333333333,0.9916666666666667,1098,0.305,0.2375,0.4575
1362,003,1772,3,676,699,1769,1772,1.0,0.001693002257336343,0.9983069977426636,397,0.38148984198645597,0.39446952595936796,0.22404063205417607
1363,003,1223,0,445,468,1223,1223,1.0,0.0,1.0,310,0.36385936222403925,0.38266557645134913,0.2534750613246116
1364,003,1539,15,538,561,1524,1539,1.0,0.009746588693957114,0.9902534113060428,440,0.34957764782326184,0.3645224171539961,0.285899935022742
1365,003,1588,19,521,526,1569,1588,1.0,0.011964735516372796,0.9880352644836272,541,0.32808564231738035,0.33123425692695213,0.3406801007556675
1366,003,1484,6,557,510,1478,1484,1.0,0.004043126684636119,0.9959568733153639,417,0.3753369272237197,0.3436657681940701,0.28099730458221023
1367,003,1345,3,490,433,1342,1345,1.0,0.0022304832713754648,0.9977695167286246,422,0.3643122676579926,0.32193308550185873,0.3137546468401487
1368,003,2190,13,622,439,2177,2190,1.0,0.005936073059360731,0.9940639269406393,1129,0.28401826484018267,0.2004566210045662,0.5155251141552512
1369,003,3890,35,1483,620,3855,3890,1.0,0.008997429305912597,0.9910025706940874,1787,0.38123393316195375,0.15938303341902313,0.45938303341902315
1370,003,1199,13,424,362,1186,1199,1.0,0.010842368640533779,0.9891576313594662,413,0.353628023352794,0.3019182652210175,0.34445371142618847
1371,003,2681,20,922,551,2661,2681,1.0,0.007459903021260724,0.9925400969787392,1208,0.34390152928011936,0.20552032823573294,0.4505781424841477
1372,003,1929,20,681,419,1909,1929,1.0,0.010368066355624676,0.9896319336443753,829,0.35303265940902023,0.21721099015033696,0.4297563504406428
1373,003,1625,3,527,721,1622,1625,1.0,0.0018461538461538461,0.9981538461538462,377,0.3243076923076923,0.4436923076923077,0.232
1374,003,1909,4,629,552,1905,1909,1.0,0.0020953378732320588,0.997904662126768,728,0.32949188056574125,0.2891566265060241,0.38135149292823467
1375,003,1747,20,537,444,1727,1747,1.0,0.011448196908986834,0.9885518030910132,766,0.3073840870062965,0.25414997137950773,0.4384659416141958
1376,003,44,0,15,14,44,44,1.0,0.0,1.0,15,0.3409090909090909,0.3181818181818182,0.3409090909090909
1379,003,5,0,0,0,5,5,1.0,0.0,1.0,5,0.0,0.0,1.0
1384,003,1837,27,381,341,1810,1837,1.0,0.014697876973326075,0.985302123026674,1115,0.20740337506804574,0.18562874251497005,0.6069678824169842
1385,003,472,3,136,112,469,472,1.0,0.006355932203389831,0.9936440677966102,224,0.288135593220339,0.23728813559322035,0.4745762711864407
1386,003,220,1,38,137,219,220,1.0,0.004545454545454545,0.9954545454545455,45,0.17272727272727273,0.6227272727272727,0.20454545454545456
1387,003,3850,53,152,309,3797,3850,1.0,0.013766233766233767,0.9862337662337662,3389,0.039480519480519484,0.08025974025974025,0.8802597402597403
1388,003,13,0,0,0,13,13,1.0,0.0,1.0,13,0.0,0.0,1.0
1389,003,1333,13,257,531,1320,1333,1.0,0.009752438109527382,0.9902475618904726,545,0.19279819954988747,0.3983495873968492,0.4088522130532633
1390,003,412,6,61,192,406,412,1.0,0.014563106796116505,0.9854368932038835,159,0.14805825242718446,0.46601941747572817,0.3859223300970874
1391,003,2229,43,360,797,2186,2229,1.0,0.019291161956034097,0.9807088380439659,1072,0.16150740242261102,0.357559443696725,0.480933153880664
1392,003,1169,5,393,532,1164,1169,1.0,0.00427715996578272,0.9957228400342173,244,0.3361847733105218,0.4550898203592814,0.20872540633019676
1393,003,190,0,35,56,190,190,1.0,0.0,1.0,99,0.18421052631578946,0.29473684210526313,0.5210526315789473
1394,003,8,0,0,0,8,8,1.0,0.0,1.0,8,0.0,0.0,1.0
1395,003,1,0,0,0,1,1,1.0,0.0,1.0,1,0.0,0.0,1.0
1396,003,3543,50,660,996,3493,3543,1.0,0.014112334180073384,0.9858876658199266,1887,0.18628281117696868,0.28111769686706184,0.5325994919559696
1397,003,3414,29,1273,989,3385,3414,1.0,0.00849443468072642,0.9915055653192736,1152,0.37287639132981837,0.28968951376684243,0.3374340949033392
1398,003,1833,27,122,71,1806,1833,1.0,0.014729950900163666,0.9852700490998363,1640,0.06655755591925805,0.03873431533006001,0.894708128750682
1399,003,594,1,74,445,593,594,1.0,0.0016835016835016834,0.9983164983164983,75,0.12457912457912458,0.7491582491582491,0.12626262626262627
1400,003,1055,3,354,515,1052,1055,1.0,0.002843601895734597,0.9971563981042654,186,0.3355450236966825,0.4881516587677725,0.176303317535545
1402,003,121,0,20,45,121,121,1.0,0.0,1.0,56,0.1652892561983471,0.371900826446281,0.4628099173553719
1403,003,11,0,0,0,11,11,1.0,0.0,1.0,11,0.0,0.0,1.0
1404,003,1919,8,677,763,1911,1919,1.0,0.004168837936425221,0.9958311620635748,479,0.35278791036998436,0.3976029181865555,0.24960917144346015
1406,003,1959,12,671,553,1947,1959,1.0,0.006125574272588055,0.9938744257274119,735,0.34252169474221544,0.2822868810617662,0.37519142419601836
1407,003,2029,13,705,574,2016,2029,1.0,0.006407097092163627,0.9935929029078364,750,0.34746180384425823,0.2828979793001479,0.3696402168555939
1408,003,2,0,0,0,2,2,1.0,0.0,1.0,2,0.0,0.0,1.0
1409,003,1299,8,517,601,1291,1299,1.0,0.006158583525789068,0.993841416474211,181,0.39799846035411857,0.46266358737490376,0.13933795227097767
1410,003,1739,8,663,863,1731,1739,1.0,0.004600345025876941,0.9953996549741231,213,0.38125359401955145,0.496262219666475,0.12248418631397355
1411,003,1177,8,435,428,1169,1177,1.0,0.006796941376380629,0.9932030586236194,314,0.3695836873406967,0.36363636363636365,0.26677994902293967
1412,003,1512,8,526,515,1504,1512,1.0,0.005291005291005291,0.9947089947089947,471,0.3478835978835979,0.3406084656084656,0.3115079365079365
1413,003,1710,9,616,577,1701,1710,1.0,0.005263157894736842,0.9947368421052631,517,0.36023391812865496,0.3374269005847953,0.3023391812865497
1414,003,1147,2,375,627,1145,1147,1.0,0.0017436791630340018,0.998256320836966,145,0.3269398430688753,0.5466434176111595,0.12641673931996514
1415,003,1187,7,278,619,1180,1187,1.0,0.005897219882055603,0.9941027801179444,290,0.2342038753159225,0.5214827295703454,0.2443133951137321
1416,003,820,0,329,369,820,820,1.0,0.0,1.0,122,0.401219512195122,0.45,0.14878048780487804
1417,003,1640,8,598,705,1632,1640,1.0,0.004878048780487805,0.9951219512195122,337,0.3646341463414634,0.4298780487804878,0.20548780487804877
1418,003,1539,8,513,674,1531,1539,1.0,0.005198180636777128,0.9948018193632229,352,0.3333333333333333,0.437946718648473,0.22871994801819362
1419,003,2479,11,900,870,2468,2479,1.0,0.004437273093989512,0.9955627269060104,709,0.36304961678096004,0.3509479628882614,0.28600242033077855
1420,003,1088,7,378,443,1081,1088,1.0,0.006433823529411764,0.9935661764705882,267,0.3474264705882353,0.4071691176470588,0.24540441176470587
1421,003,2719,4,823,694,2715,2719,1.0,0.001471129091577786,0.9985288709084222,1202,0.3026848105921295,0.25524089738874584,0.4420742920191247
1422,003,600,3,164,386,597,600,1.0,0.005,0.995,50,0.2733333333333333,0.6433333333333333,0.08333333333333333
1424,003,2362,10,834,1034,2352,2362,1.0,0.004233700254022015,0.995766299745978,494,0.35309060118543606,0.4377646062658764,0.20914479254868756
1425,003,3094,10,1182,1180,3084,3094,1.0,0.003232062055591467,0.9967679379444085,732,0.3820297349709114,0.3813833225597931,0.2365869424692954
1428,003,1917,13,624,579,1904,1917,1.0,0.006781429316640584,0.9932185706833594,714,0.325508607198748,0.30203442879499215,0.37245696400625977
1429,003,6,0,0,0,6,6,1.0,0.0,1.0,6,0.0,0.0,1.0
1430,003,2403,2,835,811,2401,2403,1.0,0.0008322929671244278,0.9991677070328756,757,0.3474823137744486,0.33749479816895545,0.3150228880565959
1431,003,2966,16,1132,468,2950,2966,1.0,0.005394470667565745,0.9946055293324343,1366,0.38165879973027644,0.15778826702629806,0.4605529332434255
1432,003,2334,9,776,644,2325,2334,1.0,0.0038560411311053984,0.9961439588688946,914,0.3324764353041988,0.2759211653813196,0.3916023993144816
1433,003,7,0,0,0,7,7,1.0,0.0,1.0,7,0.0,0.0,1.0
1434,003,2632,22,765,598,2610,2632,1.0,0.008358662613981762,0.9916413373860182,1269,0.2906534954407295,0.22720364741641338,0.48214285714285715
1435,003,1483,18,432,299,1465,1483,1.0,0.012137559002022926,0.987862440997977,752,0.29130141604855025,0.20161834120026972,0.50708024275118
1436,003,2449,31,739,572,2418,2449,1.0,0.012658227848101266,0.9873417721518988,1138,0.3017558187015108,0.23356472029399755,0.46467946100449165
1437,003,1578,3,500,231,1575,1578,1.0,0.0019011406844106464,0.9980988593155894,847,0.31685678073510776,0.14638783269961977,0.5367553865652726
1438,003,4185,47,1192,767,4138,4185,1.0,0.011230585424133811,0.9887694145758662,2226,0.2848267622461171,0.18327359617682198,0.5318996415770609
1439,003,1071,4,421,383,1067,1071,1.0,0.003734827264239029,0.996265172735761,267,0.3930905695611578,0.357609710550887,0.24929971988795518
1440,003,960,2,346,488,958,960,1.0,0.0020833333333333333,0.9979166666666667,126,0.36041666666666666,0.5083333333333333,0.13125
1441,003,13,0,1,10,13,13,1.0,0.0,1.0,2,0.07692307692307693,0.7692307692307693,0.15384615384615385
1442,003,92,2,26,47,90,92,1.0,0.021739130434782608,0.9782608695652174,19,0.2826086956521739,0.5108695652173914,0.20652173913043478
1444,003,343,0,44,25,343,343,1.0,0.0,1.0,274,0.1282798833819242,0.0728862973760933,0.7988338192419825
1445,003,1036,6,323,273,1030,1036,1.0,0.005791505791505791,0.9942084942084942,440,0.31177606177606176,0.2635135135135135,0.4247104247104247
1446,003,2049,10,656,834,2039,2049,1.0,0.004880429477794046,0.995119570522206,559,0.3201561737432894,0.40702781844802344,0.27281600780868714
1447,003,1684,17,563,340,1667,1684,1.0,0.010095011876484561,0.9899049881235155,781,0.3343230403800475,0.20190023752969122,0.4637767220902613
1448,003,16,0,0,0,16,16,1.0,0.0,1.0,16,0.0,0.0,1.0
1452,003,3,0,0,0,3,3,1.0,0.0,1.0,3,0.0,0.0,1.0
1453,003,3,0,0,0,3,3,1.0,0.0,1.0,3,0.0,0.0,1.0
1454,003,2264,18,565,280,2246,2264,1.0,0.007950530035335688,0.9920494699646644,1419,0.2495583038869258,0.12367491166077739,0.6267667844522968
1455,003,2588,27,875,480,2561,2588,1.0,0.010432766615146832,0.9895672333848532,1233,0.33809891808346215,0.18547140649149924,0.4764296754250386
1456,003,1543,10,438,563,1533,1543,1.0,0.0064808813998703824,0.9935191186001296,542,0.2838626053143227,0.3648736228127025,0.35126377187297475
1457,003,849,6,200,398,843,849,1.0,0.007067137809187279,0.9929328621908127,251,0.23557126030624265,0.46878680800942285,0.2956419316843345
1458,003,2330,42,658,661,2288,2330,1.0,0.018025751072961373,0.9819742489270387,1011,0.28240343347639485,0.2836909871244635,0.43390557939914165
1459,003,1739,23,520,365,1716,1739,1.0,0.013225991949396205,0.9867740080506038,854,0.29902242668200113,0.2098907418056354,0.49108683151236343
1460,003,1448,10,395,313,1438,1448,1.0,0.006906077348066298,0.9930939226519337,740,0.27279005524861877,0.21616022099447513,0.511049723756906
1461,003,1196,8,357,271,1188,1196,1.0,0.006688963210702341,0.9933110367892977,568,0.298494983277592,0.2265886287625418,0.47491638795986624
1462,003,3663,60,837,254,3603,3663,1.0,0.01638001638001638,0.9836199836199836,2572,0.2285012285012285,0.06934206934206934,0.7021567021567021
1463,003,1959,19,490,156,1940,1959,1.0,0.009698825931597753,0.9903011740684022,1313,0.2501276161306789,0.07963246554364471,0.6702399183256764
1464,003,2443,22,572,351,2421,2443,1.0,0.009005321326238231,0.9909946786737618,1520,0.23413835448219403,0.14367580843225541,0.6221858370855505
1465,003,2079,22,788,267,2057,2079,1.0,0.010582010582010581,0.9894179894179894,1024,0.37902837902837905,0.12842712842712842,0.49254449254449256
1466,003,3148,30,756,383,3118,3148,1.0,0.009529860228716646,0.9904701397712834,2009,0.24015247776365947,0.12166454891994917,0.6381829733163914
1467,003,1606,12,574,454,1594,1606,1.0,0.007471980074719801,0.9925280199252802,578,0.3574097135740971,0.28268991282689915,0.35990037359900373
1468,003,2327,15,706,627,2312,2327,1.0,0.006446067898581865,0.9935539321014182,994,0.3033949290932531,0.269445638160722,0.4271594327460249
1469,003,1601,14,601,451,1587,1601,1.0,0.008744534665833853,0.9912554653341662,549,0.37539038101186756,0.2816989381636477,0.34291068082448467
1470,003,1650,19,575,523,1631,1650,1.0,0.011515151515151515,0.9884848484848485,552,0.3484848484848485,0.31696969696969696,0.33454545454545453
1471,003,2450,13,795,618,2437,2450,1.0,0.005306122448979592,0.9946938775510205,1037,0.32448979591836735,0.2522448979591837,0.423265306122449
1472,003,2569,34,868,564,2535,2569,1.0,0.013234721681588166,0.9867652783184119,1137,0.33787465940054495,0.21954067730634488,0.44258466329311014
1473,003,2722,35,920,753,2687,2722,1.0,0.012858192505510653,0.9871418074944893,1049,0.33798677443056574,0.2766348273328435,0.38537839823659076
1474,003,1932,6,656,620,1926,1932,1.0,0.003105590062111801,0.9968944099378882,656,0.33954451345755693,0.32091097308488614,0.33954451345755693
1475,003,2689,15,856,454,2674,2689,1.0,0.005578281889178133,0.9944217181108219,1379,0.3183339531424321,0.16883599851245817,0.5128300483451097
1476,003,2000,19,643,449,1981,2000,1.0,0.0095,0.9905,908,0.3215,0.2245,0.454
1477,003,2071,13,587,419,2058,2071,1.0,0.006277160791887977,0.993722839208112,1065,0.2834379526798648,0.20231772090777403,0.5142443264123612
1478,003,859,4,314,359,855,859,1.0,0.004656577415599534,0.9953434225844005,186,0.36554132712456344,0.4179278230500582,0.21653084982537835
1479,003,3233,16,823,484,3217,3233,1.0,0.0049489638107021346,0.9950510361892979,1926,0.254562326012991,0.14970615527373957,0.5957315187132695
1480,003,1808,15,552,357,1793,1808,1.0,0.008296460176991151,0.9917035398230089,899,0.3053097345132743,0.19745575221238937,0.49723451327433627
1481,003,2085,23,910,107,2062,2085,1.0,0.011031175059952039,0.988968824940048,1068,0.4364508393285372,0.0513189448441247,0.5122302158273381
1482,003,2400,24,852,580,2376,2400,1.0,0.01,0.99,968,0.355,0.24166666666666667,0.4033333333333333
1483,003,1497,18,781,93,1479,1497,1.0,0.012024048096192385,0.9879759519038076,623,0.5217100868403474,0.06212424849699399,0.41616566466265864
1484,003,4125,46,1264,1242,4079,4125,1.0,0.011151515151515152,0.9888484848484849,1619,0.30642424242424243,0.3010909090909091,0.3924848484848485
1485,003,2793,14,838,726,2779,2793,1.0,0.005012531328320802,0.9949874686716792,1229,0.3000358037952023,0.25993555316863587,0.44002864303616185
1486,003,845,13,316,260,832,845,1.0,0.015384615384615385,0.9846153846153847,269,0.3739644970414201,0.3076923076923077,0.3183431952662722
1487,003,3333,45,1143,475,3288,3333,1.0,0.013501350135013501,0.9864986498649865,1715,0.34293429342934295,0.1425142514251425,0.5145514551455146
1488,003,1788,3,670,798,1785,1788,1.0,0.0016778523489932886,0.9983221476510067,320,0.37472035794183445,0.4463087248322148,0.1789709172259508
1489,003,2383,15,910,682,2368,2383,1.0,0.00629458665547629,0.9937054133445237,791,0.3818715904322283,0.28619387326898865,0.33193453629878306
1490,003,3255,33,1062,679,3222,3255,1.0,0.010138248847926268,0.9898617511520738,1514,0.3262672811059908,0.2086021505376344,0.4651305683563748
1491,003,2584,51,731,308,2533,2584,1.0,0.019736842105263157,0.9802631578947368,1545,0.28289473684210525,0.11919504643962849,0.5979102167182663
1492,003,2636,16,860,617,2620,2636,1.0,0.006069802731411229,0.9939301972685888,1159,0.3262518968133536,0.2340667678300455,0.4396813353566009
1493,003,2420,14,939,687,2406,2420,1.0,0.005785123966942148,0.9942148760330578,794,0.38801652892561983,0.28388429752066113,0.328099173553719
1494,003,2814,34,1062,740,2780,2814,1.0,0.012082444918265814,0.9879175550817342,1012,0.3773987206823028,0.26297085998578534,0.35963041933191187
1495,003,3048,56,1034,603,2992,3048,1.0,0.01837270341207349,0.9816272965879265,1411,0.339238845144357,0.19783464566929135,0.4629265091863517
1496,003,2604,14,799,1011,2590,2604,1.0,0.005376344086021506,0.9946236559139785,794,0.3068356374807988,0.3882488479262673,0.3049155145929339
1497,003,3151,47,912,597,3104,3151,1.0,0.014915899714376388,0.9850841002856237,1642,0.28943192637258014,0.18946366232941922,0.5211044112980007
1499,003,1564,5,529,495,1559,1564,1.0,0.00319693094629156,0.9968030690537084,540,0.3382352941176471,0.31649616368286443,0.3452685421994885
1500,003,70,0,0,0,70,70,1.0,0.0,1.0,70,0.0,0.0,1.0
1501,003,3076,15,1045,828,3061,3076,1.0,0.004876462938881665,0.9951235370611183,1203,0.3397269180754226,0.26918075422626786,0.3910923276983095
1503,003,2910,47,791,540,2863,2910,1.0,0.016151202749140895,0.983848797250859,1579,0.2718213058419244,0.18556701030927836,0.5426116838487972
1504,003,4,0,0,0,4,4,1.0,0.0,1.0,4,0.0,0.0,1.0
1505,003,5,0,0,0,5,5,1.0,0.0,1.0,5,0.0,0.0,1.0
1506,003,2,1,0,0,1,2,1.0,0.5,0.5,2,0.0,0.0,1.0
1508,003,4,0,0,0,4,4,1.0,0.0,1.0,4,0.0,0.0,1.0
1510,003,6,0,0,0,6,6,1.0,0.0,1.0,6,0.0,0.0,1.0
1511,003,3,0,0,0,3,3,1.0,0.0,1.0,3,0.0,0.0,1.0
1512,003,680,22,97,349,658,680,1.0,0.03235294117647059,0.9676470588235294,234,0.1426470588235294,0.513235294117647,0.34411764705882353
1513,003,1,0,0,0,1,1,1.0,0.0,1.0,1,0.0,0.0,1.0
1514,003,1560,14,136,1273,1546,1560,1.0,0.008974358974358974,0.9910256410256411,151,0.08717948717948718,0.816025641025641,0.0967948717948718
1516,003,1925,11,675,493,1914,1925,1.0,0.005714285714285714,0.9942857142857143,757,0.35064935064935066,0.2561038961038961,0.39324675324675323
1517,003,1064,8,359,245,1056,1064,1.0,0.007518796992481203,0.9924812030075187,460,0.337406015037594,0.23026315789473684,0.4323308270676692
1519,003,3545,19,1158,804,3526,3545,1.0,0.005359661495063469,0.9946403385049365,1583,0.32665726375176307,0.22679830747531735,0.4465444287729196
1520,003,2581,18,920,926,2563,2581,1.0,0.006974041069352964,0.993025958930647,735,0.3564509879891515,0.3587756683456025,0.28477334366524604
1521,003,4,0,0,0,4,4,1.0,0.0,1.0,4,0.0,0.0,1.0
1522,003,921,2,356,409,919,921,1.0,0.002171552660152009,0.997828447339848,156,0.38653637350705755,0.44408251900108575,0.16938110749185667
1523,003,2917,27,643,273,2890,2917,1.0,0.009256085018854988,0.990743914981145,2001,0.22043195063421323,0.09358930407953377,0.685978745286253
1524,003,1441,22,355,113,1419,1441,1.0,0.015267175572519083,0.9847328244274809,973,0.24635669673837612,0.0784177654406662,0.6752255378209576
1525,003,2164,24,724,627,2140,2164,1.0,0.011090573012939002,0.988909426987061,813,0.3345656192236599,0.2897412199630314,0.37569316081330867
1526,003,2538,29,638,292,2509,2538,1.0,0.011426319936958234,0.9885736800630418,1608,0.25137903861308114,0.11505122143420016,0.6335697399527187
1527,003,214,0,54,14,214,214,1.0,0.0,1.0,146,0.2523364485981308,0.06542056074766354,0.6822429906542056
1528,003,2409,13,504,930,2396,2409,1.0,0.005396430053964301,0.9946035699460357,975,0.20921544209215442,0.386052303860523,0.40473225404732255
1529,003,4441,17,1613,1706,4424,4441,1.0,0.003827966674172484,0.9961720333258275,1122,0.3632064850258951,0.38414771447872104,0.25264580049538393
1530,003,1122,1,332,617,1121,1122,1.0,0.00089126559714795,0.9991087344028521,173,0.29590017825311943,0.5499108734402852,0.15418894830659535
1531,003,1675,9,562,585,1666,1675,1.0,0.005373134328358209,0.9946268656716418,528,0.33552238805970147,0.3492537313432836,0.31522388059701495
1532,003,2530,13,849,891,2517,2530,1.0,0.005138339920948616,0.9948616600790514,790,0.3355731225296443,0.3521739130434783,0.31225296442687744
1533,003,11,0,0,0,11,11,1.0,0.0,1.0,11,0.0,0.0,1.0
1534,003,1681,3,600,844,1678,1681,1.0,0.001784651992861392,0.9982153480071386,237,0.35693039857227843,0.5020820939916716,0.14098750743604996
1535,003,683,0,203,335,683,683,1.0,0.0,1.0,145,0.2972181551976574,0.4904831625183016,0.212298682284041
1537,003,787,1,294,351,786,787,1.0,0.0012706480304955528,0.9987293519695044,142,0.3735705209656925,0.44599745870393903,0.18043202033036848
1538,003,1423,12,529,532,1411,1423,1.0,0.008432888264230498,0.9915671117357695,362,0.37174982431482784,0.37385804638088543,0.25439212930428673
1539,003,2483,34,710,595,2449,2483,1.0,0.01369311316955296,0.9863068868304471,1178,0.28594442207007653,0.2396294804671768,0.47442609746274667
1540,003,1729,15,590,619,1714,1729,1.0,0.008675534991324466,0.9913244650086755,520,0.34123770965876227,0.3580104106419896,0.3007518796992481
1541,003,882,1,310,418,881,882,1.0,0.0011337868480725624,0.9988662131519275,154,0.35147392290249435,0.47392290249433106,0.1746031746031746
1542,003,1023,3,391,444,1020,1023,1.0,0.002932551319648094,0.9970674486803519,188,0.38220918866080156,0.4340175953079179,0.18377321603128055
1543,003,2668,14,967,990,2654,2668,1.0,0.005247376311844078,0.9947526236881559,711,0.3624437781109445,0.37106446776611696,0.2664917541229385
1544,003,8,0,0,0,8,8,1.0,0.0,1.0,8,0.0,0.0,1.0
1545,003,4,0,0,0,4,4,1.0,0.0,1.0,4,0.0,0.0,1.0
1546,003,1666,17,381,248,1649,1666,1.0,0.01020408163265306,0.9897959183673469,1037,0.22869147659063627,0.148859543817527,0.6224489795918368
1547,003,2185,19,549,345,2166,2185,1.0,0.008695652173913044,0.991304347826087,1291,0.25125858123569794,0.15789473684210525,0.5908466819221968
1548,003,3012,33,1153,616,2979,3012,1.0,0.010956175298804782,0.9890438247011952,1243,0.38280212483399734,0.20451527224435592,0.41268260292164677
1552,003,3349,38,655,271,3311,3349,1.0,0.011346670647954613,0.9886533293520454,2423,0.19558077037921767,0.08091967751567632,0.723499552105106
1553,003,91,0,39,11,91,91,1.0,0.0,1.0,41,0.42857142857142855,0.12087912087912088,0.45054945054945056
1555,003,1398,6,420,359,1392,1398,1.0,0.004291845493562232,0.9957081545064378,619,0.30042918454935624,0.25679542203147354,0.4427753934191702
1556,003,1617,4,547,716,1613,1617,1.0,0.0024737167594310453,0.9975262832405689,354,0.33828076685219544,0.4427952999381571,0.2189239332096475
1557,003,1981,17,639,664,1964,1981,1.0,0.008581524482584554,0.9914184755174155,678,0.3225643614336194,0.33518425037859667,0.34225138818778394
1559,003,4536,19,1444,1177,4517,4536,1.0,0.004188712522045855,0.9958112874779541,1915,0.318342151675485,0.2594797178130511,0.42217813051146386
1560,003,3043,34,932,749,3009,3043,1.0,0.0111731843575419,0.9888268156424581,1362,0.30627670062438384,0.24613867893526126,0.4475846204403549
1561,003,2743,17,1010,775,2726,2743,1.0,0.006197593875318994,0.993802406124681,958,0.3682099890630696,0.2825373678454247,0.34925264309150567
1562,003,1433,31,514,370,1402,1433,1.0,0.021632937892533146,0.9783670621074668,549,0.3586880669923238,0.25819958129797627,0.3831123517096999
1563,003,3007,19,991,1109,2988,3007,1.0,0.006318589956767542,0.9936814100432324,907,0.32956434985034916,0.36880611905553706,0.3016295310941137
1564,003,1459,4,449,772,1455,1459,1.0,0.0027416038382453737,0.9972583961617546,238,0.30774503084304317,0.5291295407813571,0.16312542837559973
1566,003,3,0,0,0,3,3,1.0,0.0,1.0,3,0.0,0.0,1.0
1567,003,47,1,18,22,46,47,1.0,0.02127659574468085,0.9787234042553191,7,0.3829787234042553,0.46808510638297873,0.14893617021276595
1568,003,1460,24,371,840,1436,1460,1.0,0.01643835616438356,0.9835616438356164,249,0.2541095890410959,0.5753424657534246,0.17054794520547945
1569,003,2380,24,670,330,2356,2380,1.0,0.010084033613445379,0.9899159663865547,1380,0.2815126050420168,0.13865546218487396,0.5798319327731093
1570,003,1894,35,390,178,1859,1894,1.0,0.018479408658922915,0.981520591341077,1326,0.20591341077085534,0.09398099260823653,0.7001055966209081
1571,003,1262,18,228,198,1244,1262,1.0,0.014263074484944533,0.9857369255150554,836,0.18066561014263074,0.15689381933438987,0.6624405705229794
1572,003,1485,16,494,378,1469,1485,1.0,0.010774410774410775,0.9892255892255892,613,0.33265993265993266,0.2545454545454545,0.41279461279461277
1573,003,1806,38,498,211,1768,1806,1.0,0.021040974529346623,0.9789590254706534,1097,0.2757475083056478,0.1168327796234773,0.6074197120708749
1574,003,1574,22,514,284,1552,1574,1.0,0.01397712833545108,0.9860228716645489,776,0.32655654383735705,0.18043202033036848,0.49301143583227447
1575,003,3307,54,754,326,3253,3307,1.0,0.016328999092833384,0.9836710009071666,2227,0.22800120955548836,0.09857877230117931,0.6734200181433323
1576,003,1382,23,428,303,1359,1382,1.0,0.016642547033285094,0.983357452966715,651,0.3096960926193922,0.21924746743849494,0.4710564399421129
1577,003,1484,28,534,390,1456,1484,1.0,0.018867924528301886,0.9811320754716981,560,0.35983827493261455,0.2628032345013477,0.37735849056603776
1578,003,1121,14,299,531,1107,1121,1.0,0.012488849241748439,0.9875111507582516,291,0.26672613737734163,0.47368421052631576,0.25958965209634255
1579,003,844,15,242,267,829,844,1.0,0.017772511848341232,0.9822274881516587,335,0.28672985781990523,0.31635071090047395,0.39691943127962087
1580,003,2360,47,825,607,2313,2360,1.0,0.019915254237288134,0.9800847457627119,928,0.3495762711864407,0.2572033898305085,0.39322033898305087
1581,003,2394,23,825,259,2371,2394,1.0,0.00960735171261487,0.9903926482873852,1310,0.34461152882205515,0.10818713450292397,0.5472013366750209
1582,003,1350,21,625,48,1329,1350,1.0,0.015555555555555555,0.9844444444444445,677,0.46296296296296297,0.035555555555555556,0.5014814814814815
1583,003,1280,7,384,396,1273,1280,1.0,0.00546875,0.99453125,500,0.3,0.309375,0.390625
1584,003,1775,23,534,401,1752,1775,1.0,0.012957746478873239,0.9870422535211267,840,0.3008450704225352,0.2259154929577465,0.4732394366197183
1585,003,28,3,13,14,25,28,2.076923076923077,0.10714285714285714,0.8928571428571429,1,0.4642857142857143,0.5,0.03571428571428571
1586,003,1413,1,454,509,1412,1413,1.0,0.0007077140835102619,0.9992922859164898,450,0.3213021939136589,0.3602264685067233,0.3184713375796178
1588,003,687,1,160,215,686,687,1.0,0.001455604075691412,0.9985443959243085,312,0.2328966521106259,0.3129548762736536,0.45414847161572053
1589,003,1940,25,699,499,1915,1940,1.0,0.01288659793814433,0.9871134020618557,742,0.36030927835051546,0.2572164948453608,0.3824742268041237
1595,029,40,0,2,20,40,40,1.0,0.0,1.0,18,0.05,0.5,0.45
1596,029,7,0,0,0,7,7,1.0,0.0,1.0,7,0.0,0.0,1.0
1599,029,51,1,3,8,50,51,1.0,0.0196078431372549,0.9803921568627451,40,0.058823529411764705,0.1568627450980392,0.7843137254901961
1600,029,624,10,128,312,614,624,1.0,0.016025641025641024,0.9839743589743589,184,0.20512820512820512,0.5,0.2948717948717949
1601,029,1103,9,299,700,1094,1103,1.0,0.008159564823209429,0.9918404351767905,104,0.27107887579329104,0.6346328195829556,0.0942883046237534
1605,029,868,8,243,377,860,868,1.0,0.009216589861751152,0.9907834101382489,248,0.2799539170506912,0.434331797235023,0.2857142857142857
1606,029,384,9,127,240,375,384,1.0,0.0234375,0.9765625,17,0.3307291666666667,0.625,0.044270833333333336
1607,029,399,6,98,244,393,399,1.0,0.015037593984962405,0.9849624060150376,57,0.24561403508771928,0.6115288220551378,0.14285714285714285
1609,029,9,0,0,0,9,9,1.0,0.0,1.0,9,0.0,0.0,1.0
1611,003,1815,8,507,563,1807,1815,1.0,0.004407713498622589,0.9955922865013774,745,0.2793388429752066,0.31019283746556475,0.41046831955922863
1612,003,1952,9,620,891,1943,1952,1.0,0.004610655737704918,0.9953893442622951,441,0.3176229508196721,0.45645491803278687,0.22592213114754098
1613,003,943,10,245,401,933,943,1.0,0.010604453870625663,0.9893955461293743,297,0.2598091198303287,0.4252386002120891,0.3149522799575822
1614,003,2565,22,761,567,2543,2565,1.0,0.008576998050682261,0.9914230019493178,1237,0.29668615984405455,0.22105263157894736,0.48226120857699806
1615,003,1338,13,462,536,1325,1338,1.0,0.009715994020926755,0.9902840059790733,340,0.3452914798206278,0.40059790732436473,0.25411061285500747
1616,023,855,14,133,256,841,855,1.0,0.016374269005847954,0.9836257309941521,466,0.15555555555555556,0.2994152046783626,0.5450292397660819
1617,023,729,14,100,278,715,729,1.0,0.019204389574759947,0.9807956104252401,351,0.13717421124828533,0.3813443072702332,0.48148148148148145
1619,023,117,88,53,24,29,117,1.0,0.7521367521367521,0.24786324786324787,40,0.452991452991453,0.20512820512820512,0.3418803418803419
1620,023,22,0,5,17,22,22,1.5714285714285714,0.0,1.0,0,0.22727272727272727,0.7727272727272727,0.0
1621,023,75,2,5,50,73,75,1.0,0.02666666666666667,0.9733333333333334,20,0.06666666666666667,0.6666666666666666,0.26666666666666666
1622,023,40,18,13,6,22,40,1.0,0.45,0.55,21,0.325,0.15,0.525
1623,023,157,6,17,56,151,157,1.0,0.03821656050955414,0.9617834394904459,84,0.10828025477707007,0.35668789808917195,0.535031847133758
1624,023,644,11,95,316,633,644,1.0,0.017080745341614908,0.9829192546583851,233,0.14751552795031056,0.4906832298136646,0.36180124223602483
1625,023,1994,26,336,813,1968,1994,1.0,0.013039117352056168,0.9869608826479438,845,0.16850551654964896,0.40772316950852555,0.4237713139418255
1626,023,2854,35,394,996,2819,2854,1.0,0.012263489838822705,0.9877365101611773,1464,0.13805185704274703,0.34898388227049754,0.5129642606867554
1627,023,2002,17,339,1009,1985,2002,1.0,0.008491508491508492,0.9915084915084915,654,0.16933066933066934,0.503996003996004,0.32667332667332666
1628,023,92,4,14,29,88,92,1.0,0.043478260869565216,0.9565217391304348,49,0.15217391304347827,0.31521739130434784,0.532608695652174
1629,023,1813,23,320,720,1790,1813,1.0,0.0126861555432984,0.9873138444567016,773,0.1765030336458908,0.3971318257032543,0.42636514065085496
1630,023,1328,12,201,433,1316,1328,1.0,0.009036144578313253,0.9909638554216867,694,0.15135542168674698,0.3260542168674699,0.5225903614457831
1631,023,2657,29,445,967,2628,2657,1.0,0.010914565299209636,0.9890854347007904,1245,0.16748212269476853,0.36394429808054196,0.4685735792246895
1632,023,2131,12,420,833,2119,2131,1.0,0.005631159080244017,0.994368840919756,878,0.1970905678085406,0.39089629282027216,0.4120131393711872
1633,023,2592,35,481,1119,2557,2592,1.0,0.013503086419753086,0.9864969135802469,992,0.18557098765432098,0.43171296296296297,0.38271604938271603
1634,023,2200,36,412,954,2164,2200,1.0,0.016363636363636365,0.9836363636363636,834,0.18727272727272729,0.43363636363636365,0.3790909090909091
1635,023,1354,35,121,262,1319,1354,1.0,0.0258493353028065,0.9741506646971935,971,0.08936484490398819,0.1935007385524372,0.7171344165435746
1636,023,3547,34,783,1754,3513,3547,1.0,0.00958556526642233,0.9904144347335777,1010,0.22074992951790245,0.4945023963913166,0.28474767409078094
1637,023,2685,29,539,1182,2656,2685,1.0,0.01080074487895717,0.9891992551210428,964,0.20074487895716947,0.4402234636871508,0.3590316573556797
1638,023,2167,24,291,638,2143,2167,1.0,0.011075219197046609,0.9889247808029534,1238,0.13428703276419013,0.29441624365482233,0.5712967235809875
1639,023,1286,13,361,812,1273,1286,1.0,0.01010886469673406,0.9898911353032659,113,0.2807153965785381,0.6314152410575428,0.08786936236391912
1640,023,605,11,19,349,594,605,1.0,0.01818181818181818,0.9818181818181818,237,0.03140495867768595,0.5768595041322314,0.39173553719008264
1641,023,103,2,15,27,101,103,1.0,0.019417475728155338,0.9805825242718447,61,0.14563106796116504,0.2621359223300971,0.5922330097087378
1642,023,618,17,56,336,601,618,1.0,0.02750809061488673,0.9724919093851133,226,0.09061488673139159,0.5436893203883495,0.3656957928802589
1643,023,165,5,13,49,160,165,1.0,0.030303030303030304,0.9696969696969697,103,0.07878787878787878,0.296969696969697,0.6242424242424243
1644,023,1184,18,201,476,1166,1184,1.0,0.015202702702702704,0.9847972972972973,507,0.16976351351351351,0.40202702702702703,0.4282094594594595
1645,023,2385,22,405,740,2363,2385,1.0,0.009224318658280923,0.9907756813417191,1240,0.16981132075471697,0.31027253668763105,0.519916142557652
1646,023,1402,23,238,629,1379,1402,1.0,0.016405135520684736,0.9835948644793152,535,0.16975748930099857,0.4486447931526391,0.38159771754636235
1647,023,1590,27,261,624,1563,1590,1.0,0.016981132075471698,0.9830188679245283,705,0.1641509433962264,0.39245283018867927,0.44339622641509435
1648,023,1719,24,188,753,1695,1719,1.0,0.013961605584642234,0.9860383944153578,778,0.10936591041303083,0.43804537521815007,0.4525887143688191
1649,021,135,3,17,69,132,135,1.0,0.022222222222222223,0.9777777777777777,49,0.1259259259259259,0.5111111111111111,0.362962962962963
1650,021,505,10,108,227,495,505,1.0,0.019801980198019802,0.9801980198019802,170,0.21386138613861386,0.4495049504950495,0.33663366336633666
1651,021,344,13,71,115,331,344,1.0,0.0377906976744186,0.9622093023255814,158,0.2063953488372093,0.33430232558139533,0.45930232558139533
1652,021,324,10,72,112,314,324,1.0,0.030864197530864196,0.9691358024691358,140,0.2222222222222222,0.345679012345679,0.43209876543209874
1653,021,500,11,92,239,489,500,1.0,0.022,0.978,169,0.184,0.478,0.338
1654,021,231,2,36,124,229,231,1.0,0.008658008658008658,0.9913419913419913,71,0.15584415584415584,0.5367965367965368,0.30735930735930733
1655,021,468,17,96,163,451,468,1.0,0.03632478632478633,0.9636752136752137,209,0.20512820512820512,0.3482905982905983,0.4465811965811966
1656,021,367,11,67,165,356,367,1.0,0.02997275204359673,0.9700272479564033,135,0.18256130790190736,0.44959128065395093,0.3678474114441417
1657,021,3,0,0,0,3,3,1.0,0.0,1.0,3,0.0,0.0,1.0
1658,021,43,6,4,24,37,43,1.0,0.13953488372093023,0.8604651162790697,15,0.09302325581395349,0.5581395348837209,0.3488372093023256
1659,021,145,6,22,73,139,145,1.0,0.041379310344827586,0.9586206896551724,50,0.15172413793103448,0.503448275862069,0.3448275862068966
1660,021,566,475,239,109,91,566,1.0,0.8392226148409894,0.1607773851590106,218,0.42226148409893993,0.19257950530035337,0.38515901060070673
1661,031,616,4,319,282,612,616,1.0,0.006493506493506494,0.9935064935064936,15,0.5178571428571429,0.4577922077922078,0.024350649350649352
1662,031,1082,0,438,577,1082,1082,1.0,0.0,1.0,67,0.4048059149722736,0.533271719038817,0.06192236598890943
1663,031,500,3,200,270,497,500,1.0,0.006,0.994,30,0.4,0.54,0.06
1664,031,1352,11,722,565,1341,1352,1.0,0.008136094674556213,0.9918639053254438,65,0.5340236686390533,0.41789940828402367,0.04807692307692308
1665,031,743,9,386,343,734,743,1.0,0.012113055181695828,0.9878869448183042,14,0.5195154777927322,0.4616419919246299,0.018842530282637954
1666,031,581,4,326,243,577,581,1.0,0.0068846815834767644,0.9931153184165232,12,0.5611015490533563,0.41824440619621345,0.020654044750430294
1667,031,1018,9,310,278,1009,1018,1.0,0.008840864440078585,0.9911591355599214,430,0.3045186640471513,0.2730844793713163,0.4223968565815324
1668,031,391,3,174,172,388,391,1.0,0.0076726342710997444,0.9923273657289002,45,0.44501278772378516,0.4398976982097187,0.11508951406649616
1669,031,33,0,3,9,33,33,1.0,0.0,1.0,21,0.09090909090909091,0.2727272727272727,0.6363636363636364
1670,031,652,2,217,112,650,652,1.0,0.003067484662576687,0.9969325153374233,323,0.3328220858895706,0.17177914110429449,0.495398773006135
1671,031,635,0,227,387,635,635,1.0,0.0,1.0,21,0.35748031496062993,0.6094488188976378,0.03307086614173228
1672,031,738,9,359,278,729,738,1.0,0.012195121951219513,0.9878048780487805,101,0.48644986449864497,0.37669376693766937,0.13685636856368563
1673,031,606,4,331,219,602,606,1.0,0.006600660066006601,0.9933993399339934,56,0.5462046204620462,0.3613861386138614,0.0924092409240924
1674,031,450,4,172,245,446,450,1.0,0.008888888888888889,0.9911111111111112,33,0.38222222222222224,0.5444444444444444,0.07333333333333333
1676,031,2278,50,435,190,2228,2278,1.0,0.021949078138718173,0.9780509218612818,1653,0.19095697980684812,0.08340649692712906,0.7256365232660228
1677,031,1670,57,242,201,1613,1670,1.0,0.03413173652694611,0.9658682634730539,1227,0.14491017964071856,0.12035928143712575,0.7347305389221557
1678,031,3,0,0,0,3,3,1.0,0.0,1.0,3,0.0,0.0,1.0
1679,031,684,5,247,175,679,684,1.0,0.007309941520467836,0.9926900584795322,262,0.3611111111111111,0.25584795321637427,0.3830409356725146
1680,031,438,4,248,106,434,438,1.0,0.0091324200913242,0.9908675799086758,84,0.5662100456621004,0.2420091324200913,0.1917808219178082
1681,031,1826,14,880,396,1812,1826,1.0,0.007667031763417305,0.9923329682365827,550,0.4819277108433735,0.21686746987951808,0.30120481927710846
1682,031,1252,14,403,251,1238,1252,1.0,0.011182108626198083,0.9888178913738019,598,0.3218849840255591,0.20047923322683706,0.4776357827476038
1683,031,886,6,282,323,880,886,1.0,0.006772009029345372,0.9932279909706546,281,0.3182844243792325,0.36455981941309257,0.31715575620767494
1684,031,1031,12,401,483,1019,1031,1.0,0.011639185257032008,0.988360814742968,147,0.3889427740058196,0.4684772065955383,0.1425800193986421
1685,031,1556,8,724,606,1548,1556,1.0,0.005141388174807198,0.9948586118251928,226,0.4652956298200514,0.38946015424164526,0.14524421593830333
1686,031,932,501,319,190,431,932,1.0,0.5375536480686696,0.4624463519313305,423,0.34227467811158796,0.20386266094420602,0.453862660944206
1687,031,40,0,8,12,40,40,1.0,0.0,1.0,20,0.2,0.3,0.5
1689,031,463,6,169,136,457,463,1.0,0.012958963282937365,0.9870410367170627,158,0.3650107991360691,0.2937365010799136,0.3412526997840173
1693,031,12,0,4,8,12,12,1.0909090909090908,0.0,1.0,0,0.3333333333333333,0.6666666666666666,0.0
1696,031,272,3,58,160,269,272,1.0,0.011029411764705883,0.9889705882352942,54,0.21323529411764705,0.5882352941176471,0.19852941176470587
1697,031,2823,69,895,794,2754,2823,1.0,0.024442082890541977,0.975557917109458,1134,0.31703861140630535,0.2812610697839178,0.40170031880977686
1698,031,2344,42,568,522,2302,2344,1.0,0.017918088737201365,0.9820819112627986,1254,0.24232081911262798,0.2226962457337884,0.5349829351535836
1699,031,2504,30,745,544,2474,2504,1.0,0.011980830670926517,0.9880191693290735,1215,0.2975239616613419,0.21725239616613418,0.48522364217252395
1700,031,1153,23,353,311,1130,1153,1.0,0.0199479618386817,0.9800520381613183,489,0.3061578490893322,0.2697311361665221,0.4241110147441457
1701,031,330,6,59,75,324,330,1.0,0.01818181818181818,0.9818181818181818,196,0.1787878787878788,0.22727272727272727,0.593939393939394
1702,031,2236,37,633,862,2199,2236,1.0,0.016547406082289804,0.9834525939177102,741,0.2830948121645796,0.3855098389982111,0.3313953488372093
1703,031,740,4,170,486,736,740,1.0,0.005405405405405406,0.9945945945945946,84,0.22972972972972974,0.6567567567567567,0.11351351351351352
1704,031,2,0,0,0,2,2,1.0,0.0,1.0,2,0.0,0.0,1.0
1705,031,2236,28,591,1085,2208,2236,1.0,0.012522361359570662,0.9874776386404294,560,0.2643112701252236,0.48524150268336314,0.2504472271914132
1706,031,1728,43,513,420,1685,1728,1.0,0.02488425925925926,0.9751157407407407,795,0.296875,0.24305555555555555,0.4600694444444444
1707,031,1655,21,437,730,1634,1655,1.0,0.012688821752265862,0.9873111782477342,488,0.26404833836858005,0.44108761329305135,0.2948640483383686
1708,031,916,19,229,367,897,916,1.0,0.02074235807860262,0.9792576419213974,320,0.25,0.40065502183406115,0.34934497816593885
1709,031,851,18,225,467,833,851,1.0,0.021151586368977675,0.9788484136310224,159,0.26439482961222094,0.5487661574618097,0.18683901292596944
1710,031,570,5,139,201,565,570,1.0,0.008771929824561403,0.9912280701754386,230,0.24385964912280703,0.3526315789473684,0.40350877192982454
1711,031,1776,22,452,833,1754,1776,1.0,0.012387387387387387,0.9876126126126126,491,0.2545045045045045,0.46903153153153154,0.27646396396396394
1712,031,1023,25,344,242,998,1023,1.0,0.024437927663734114,0.9755620723362659,437,0.3362658846529814,0.23655913978494625,0.42717497556207235
1713,031,403,0,118,214,403,403,1.0,0.0,1.0,71,0.29280397022332505,0.5310173697270472,0.1761786600496278
1714,031,7,0,0,0,7,7,1.0,0.0,1.0,7,0.0,0.0,1.0
1718,031,124,2,46,19,122,124,1.0,0.016129032258064516,0.9838709677419355,59,0.3709677419354839,0.1532258064516129,0.47580645161290325
1720,031,1884,7,600,590,1877,1884,1.0,0.0037154989384288748,0.9962845010615711,694,0.3184713375796178,0.31316348195329086,0.36836518046709127
1721,031,531,0,277,168,531,531,1.0,0.0,1.0,86,0.5216572504708098,0.3163841807909605,0.16195856873822975
1723,031,296,0,140,154,296,296,1.0,0.0,1.0,2,0.47297297297297297,0.5202702702702703,0.006756756756756757
1724,031,180,0,52,111,180,180,1.0,0.0,1.0,17,0.28888888888888886,0.6166666666666667,0.09444444444444444
1725,031,174,3,66,101,171,174,1.0,0.017241379310344827,0.9827586206896551,7,0.3793103448275862,0.5804597701149425,0.040229885057471264
1726,031,656,7,249,173,649,656,1.0,0.010670731707317074,0.989329268292683,234,0.3795731707317073,0.26371951219512196,0.3567073170731707
1727,031,72,3,0,0,69,72,1.0,0.041666666666666664,0.9583333333333334,72,0.0,0.0,1.0
1728,031,1320,17,367,193,1303,1320,1.0,0.012878787878787878,0.9871212121212121,760,0.278030303030303,0.1462121212121212,0.5757575757575758
1729,031,1507,40,254,161,1467,1507,1.0,0.026542800265428004,0.973457199734572,1092,0.16854678168546783,0.10683477106834771,0.7246184472461845
1731,031,2513,51,910,286,2462,2513,1.0,0.020294468762435337,0.9797055312375647,1317,0.362116991643454,0.11380819737365698,0.524074810982889
1732,031,1022,11,277,246,1011,1022,1.0,0.010763209393346379,0.9892367906066536,499,0.2710371819960861,0.24070450097847357,0.4882583170254403
1733,031,1890,76,589,206,1814,1890,1.0,0.04021164021164021,0.9597883597883597,1095,0.31164021164021166,0.10899470899470899,0.5793650793650794
1734,031,1620,18,682,477,1602,1620,1.0,0.011111111111111112,0.9888888888888889,461,0.42098765432098767,0.29444444444444445,0.2845679012345679
1735,031,1124,15,507,436,1109,1124,1.0,0.013345195729537367,0.9866548042704626,181,0.451067615658363,0.3879003558718861,0.1610320284697509
1736,031,1205,21,617,294,1184,1205,1.0,0.017427385892116183,0.9825726141078838,294,0.5120331950207468,0.24398340248962655,0.24398340248962655
1737,031,1618,27,637,432,1591,1618,1.0,0.01668726823238566,0.9833127317676144,549,0.3936959208899876,0.2669962917181706,0.33930778739184175
1738,031,881,17,143,48,864,881,1.0,0.019296254256526674,0.9807037457434733,690,0.1623155505107832,0.05448354143019296,0.7832009080590239
1739,031,1480,22,617,456,1458,1480,1.0,0.014864864864864866,0.9851351351351352,407,0.4168918918918919,0.3081081081081081,0.275
1740,031,1788,26,649,496,1762,1788,1.0,0.0145413870246085,0.9854586129753915,643,0.3629753914988814,0.27740492170022374,0.35961968680089484
1741,031,1340,16,551,320,1324,1340,1.0,0.011940298507462687,0.9880597014925373,469,0.41119402985074627,0.23880597014925373,0.35
1742,031,619,14,171,88,605,619,1.0,0.022617124394184167,0.9773828756058158,360,0.2762520193861066,0.1421647819063005,0.5815831987075929
1743,031,1047,12,312,236,1035,1047,1.0,0.011461318051575931,0.9885386819484241,499,0.2979942693409742,0.22540592168099333,0.47659980897803245
1744,031,2336,20,874,890,2316,2336,1.0,0.008561643835616438,0.9914383561643836,572,0.3741438356164384,0.3809931506849315,0.24486301369863014
1745,031,909,15,348,291,894,909,1.0,0.0165016501650165,0.9834983498349835,270,0.38283828382838286,0.3201320132013201,0.297029702970297
1747,031,43,0,12,21,43,43,1.0,0.0,1.0,10,0.27906976744186046,0.4883720930232558,0.23255813953488372
1748,031,539,3,140,61,536,539,1.0,0.0055658627087198514,0.9944341372912802,338,0.2597402597402597,0.11317254174397032,0.62708719851577
1749,031,1222,27,561,366,1195,1222,1.0,0.0220949263502455,0.9779050736497545,295,0.4590834697217676,0.2995090016366612,0.2414075286415712
1750,031,1367,7,522,704,1360,1367,1.0,0.005120702267739576,0.9948792977322605,141,0.38185808339429406,0.514996342355523,0.10314557425018288
1751,031,1595,21,595,370,1574,1595,1.0,0.013166144200626959,0.986833855799373,630,0.3730407523510972,0.23197492163009403,0.3949843260188088
1752,031,1662,48,599,367,1614,1662,1.0,0.02888086642599278,0.9711191335740073,696,0.36040914560770154,0.22081829121540314,0.4187725631768953
1753,031,861,3,334,212,858,861,1.0,0.003484320557491289,0.9965156794425087,315,0.3879210220673635,0.2462253193960511,0.36585365853658536
1754,031,1764,25,515,349,1739,1764,1.0,0.01417233560090703,0.985827664399093,900,0.2919501133786848,0.19784580498866214,0.5102040816326531
1755,031,1771,23,596,393,1748,1771,1.0,0.012987012987012988,0.987012987012987,782,0.3365330321852061,0.22190852625635235,0.44155844155844154
1756,031,1135,1,436,402,1134,1135,1.0,0.000881057268722467,0.9991189427312775,297,0.3841409691629956,0.3541850220264317,0.2616740088105727
1758,031,963,9,413,139,954,963,1.0,0.009345794392523364,0.9906542056074766,411,0.4288681204569055,0.14434060228452752,0.42679127725856697
1759,031,1864,22,715,339,1842,1864,1.0,0.011802575107296138,0.9881974248927039,810,0.38358369098712447,0.18186695278969958,0.434549356223176
1760,031,690,7,233,348,683,690,1.0,0.010144927536231883,0.9898550724637681,109,0.33768115942028987,0.5043478260869565,0.15797101449275364
1761,031,426,3,101,269,423,426,1.0,0.007042253521126761,0.9929577464788732,56,0.23708920187793428,0.6314553990610329,0.13145539906103287
1762,031,837,0,286,449,837,837,1.0,0.0,1.0,102,0.34169653524492233,0.5364396654719236,0.12186379928315412
1763,031,573,5,195,247,568,573,1.0,0.008726003490401396,0.9912739965095986,131,0.3403141361256545,0.43106457242582896,0.2286212914485166
1764,031,1403,42,332,475,1361,1403,1.0,0.02993585174625802,0.970064148253742,596,0.23663578047042053,0.33856022808268,0.4248039914468995
1766,031,5,0,0,0,5,5,1.0,0.0,1.0,5,0.0,0.0,1.0
1767,031,904,0,355,479,904,904,1.0,0.0,1.0,70,0.3926991150442478,0.5298672566371682,0.07743362831858407
1768,031,58,0,11,21,58,58,1.0,0.0,1.0,26,0.1896551724137931,0.3620689655172414,0.4482758620689655
1769,031,101,2,35,36,99,101,1.0,0.019801980198019802,0.9801980198019802,30,0.3465346534653465,0.3564356435643564,0.297029702970297
1770,031,985,3,404,480,982,985,1.0,0.003045685279187817,0.9969543147208122,101,0.4101522842639594,0.4873096446700508,0.10253807106598985
1771,031,129,0,42,87,129,129,1.0078125,0.0,1.0,0,0.32558139534883723,0.6744186046511628,0.0
1772,031,940,15,330,317,925,940,1.0,0.015957446808510637,0.9840425531914894,293,0.35106382978723405,0.3372340425531915,0.31170212765957445
1773,031,691,10,254,295,681,691,1.0,0.01447178002894356,0.9855282199710564,142,0.3675832127351664,0.426917510853835,0.20549927641099855
1775,031,430,4,152,225,426,430,1.0,0.009302325581395349,0.9906976744186047,53,0.35348837209302325,0.5232558139534884,0.12325581395348838
1776,031,12,1,0,0,11,12,1.0,0.08333333333333333,0.9166666666666666,12,0.0,0.0,1.0
1777,031,1299,5,688,522,1294,1299,1.0,0.003849114703618168,0.9961508852963818,89,0.5296381832178599,0.4018475750577367,0.06851424172440339
1778,031,606,5,209,275,601,606,1.0,0.00825082508250825,0.9917491749174917,122,0.3448844884488449,0.4537953795379538,0.20132013201320131
1779,031,760,4,370,312,756,760,1.0,0.005263157894736842,0.9947368421052631,78,0.4868421052631579,0.4105263157894737,0.10263157894736842
1780,031,692,0,338,293,692,692,1.0,0.0,1.0,61,0.4884393063583815,0.4234104046242775,0.08815028901734104
1781,031,396,1,238,142,395,396,1.0,0.0025252525252525255,0.9974747474747475,16,0.601010101010101,0.35858585858585856,0.04040404040404041
1782,031,859,7,369,434,852,859,1.0,0.008149010477299184,0.9918509895227008,56,0.42956926658905703,0.5052386495925495,0.06519208381839348
1783,031,1347,4,723,458,1343,1347,1.0,0.002969561989606533,0.9970304380103935,166,0.5367483296213809,0.340014847809948,0.12323682256867112
1784,031,726,12,301,252,714,726,1.0,0.01652892561983471,0.9834710743801653,173,0.41460055096418735,0.34710743801652894,0.23829201101928374
1785,031,352,2,118,205,350,352,1.0,0.005681818181818182,0.9943181818181818,29,0.3352272727272727,0.5823863636363636,0.08238636363636363
1786,031,225,0,78,147,225,225,1.076555023923445,0.0,1.0,0,0.3466666666666667,0.6533333333333333,0.0
1787,031,1484,15,709,246,1469,1484,1.0,0.010107816711590296,0.9898921832884097,529,0.4777628032345013,0.16576819407008087,0.3564690026954178
1788,031,1058,0,609,338,1058,1058,1.0,0.0,1.0,111,0.5756143667296786,0.31947069943289225,0.10491493383742911
1789,031,1370,12,725,452,1358,1370,1.0,0.008759124087591242,0.9912408759124087,193,0.5291970802919708,0.32992700729927005,0.14087591240875913
1790,031,555,6,204,297,549,555,1.0,0.010810810810810811,0.9891891891891892,54,0.3675675675675676,0.5351351351351351,0.0972972972972973
1795,031,885,11,462,170,874,885,1.0,0.012429378531073447,0.9875706214689266,253,0.5220338983050847,0.192090395480226,0.2858757062146893
1796,031,1104,3,612,434,1101,1104,1.0,0.002717391304347826,0.9972826086956522,58,0.5543478260869565,0.39311594202898553,0.05253623188405797
1797,031,707,2,396,160,705,707,1.0,0.002828854314002829,0.9971711456859972,151,0.5601131541725601,0.2263083451202263,0.21357850070721357
1798,031,663,2,352,122,661,663,1.0,0.0030165912518853697,0.9969834087481146,189,0.530920060331825,0.18401206636500755,0.2850678733031674
1799,031,627,3,270,231,624,627,1.0,0.004784688995215311,0.9952153110047847,126,0.430622009569378,0.3684210526315789,0.20095693779904306
1800,031,1206,5,304,269,1201,1206,1.0,0.0041459369817578775,0.9958540630182421,633,0.25207296849087896,0.2230514096185738,0.5248756218905473
1802,031,828,5,426,317,823,828,1.0,0.006038647342995169,0.9939613526570048,85,0.5144927536231884,0.3828502415458937,0.10265700483091787
1803,031,990,5,523,362,985,990,1.0,0.005050505050505051,0.9949494949494949,105,0.5282828282828282,0.3656565656565657,0.10606060606060606
1804,031,1931,52,464,436,1879,1931,1.0,0.026929052304505437,0.9730709476954945,1031,0.24029000517866392,0.22578974624546866,0.5339202485758674
1805,031,988,15,318,226,973,988,1.0,0.015182186234817813,0.9848178137651822,444,0.32186234817813764,0.22874493927125505,0.4493927125506073
1807,031,12,0,0,0,12,12,1.0,0.0,1.0,12,0.0,0.0,1.0
1808,031,658,0,217,333,658,658,1.0,0.0,1.0,108,0.32978723404255317,0.506079027355623,0.1641337386018237
1809,031,221,10,33,17,211,221,1.0,0.04524886877828054,0.9547511312217195,171,0.1493212669683258,0.07692307692307693,0.7737556561085973
1810,031,281,8,54,21,273,281,1.0,0.028469750889679714,0.9715302491103203,206,0.19217081850533807,0.07473309608540925,0.7330960854092526
1811,031,1575,21,598,435,1554,1575,1.0,0.013333333333333334,0.9866666666666667,542,0.3796825396825397,0.2761904761904762,0.3441269841269841
1812,031,4,0,0,0,4,4,1.0,0.0,1.0,4,0.0,0.0,1.0
1813,031,1982,32,475,215,1950,1982,1.0,0.016145307769929364,0.9838546922300706,1292,0.239656912209889,0.10847628657921292,0.6518668012108981
1814,031,22,0,9,2,22,22,1.0,0.0,1.0,11,0.4090909090909091,0.09090909090909091,0.5
1815,031,176,1,41,103,175,176,1.0,0.005681818181818182,0.9943181818181818,32,0.23295454545454544,0.5852272727272727,0.18181818181818182
1816,031,967,1,540,397,966,967,1.0,0.001034126163391934,0.9989658738366081,30,0.5584281282316442,0.4105480868665977,0.031023784901758014
1817,031,1049,5,424,434,1044,1049,1.0,0.004766444232602479,0.9952335557673975,191,0.4041944709246902,0.41372735938989513,0.18207816968541468
1818,031,1665,14,763,572,1651,1665,1.0,0.008408408408408409,0.9915915915915916,330,0.4582582582582583,0.34354354354354355,0.1981981981981982
1819,031,546,16,176,124,530,546,1.0,0.029304029304029304,0.9706959706959707,246,0.32234432234432236,0.2271062271062271,0.45054945054945056
1820,031,2127,32,789,522,2095,2127,1.0,0.015044663845792195,0.9849553361542078,816,0.3709449929478138,0.2454160789844852,0.383638928067701
1821,031,772,8,327,289,764,772,1.0,0.010362694300518135,0.9896373056994818,156,0.42357512953367876,0.3743523316062176,0.20207253886010362
1822,031,1432,14,493,145,1418,1432,1.0,0.009776536312849162,0.9902234636871509,794,0.3442737430167598,0.10125698324022346,0.5544692737430168
1823,031,516,34,164,127,482,516,1.0,0.06589147286821706,0.9341085271317829,225,0.3178294573643411,0.24612403100775193,0.436046511627907
1824,031,1465,7,592,512,1458,1465,1.0,0.00477815699658703,0.995221843003413,361,0.4040955631399317,0.34948805460750854,0.24641638225255974
1825,031,539,2,182,100,537,539,1.0,0.0037105751391465678,0.9962894248608535,257,0.33766233766233766,0.18552875695732837,0.47680890538033394
1826,031,636,9,177,119,627,636,1.0,0.014150943396226415,0.9858490566037735,340,0.2783018867924528,0.1871069182389937,0.5345911949685535
1827,031,517,25,125,92,492,517,1.0,0.048355899419729204,0.9516441005802708,300,0.24177949709864605,0.17794970986460348,0.5802707930367504
1828,031,118,6,20,20,112,118,1.0,0.05084745762711865,0.9491525423728814,78,0.1694915254237288,0.1694915254237288,0.6610169491525424
1829,031,1507,30,334,215,1477,1507,1.0,0.019907100199071003,0.980092899800929,958,0.2216323822163238,0.1426675514266755,0.6357000663570007
1830,031,1892,65,581,465,1827,1892,1.0,0.034355179704016914,0.9656448202959831,846,0.3070824524312896,0.24577167019027485,0.44714587737843553
1831,031,49,0,11,6,49,49,1.0,0.0,1.0,32,0.22448979591836735,0.12244897959183673,0.6530612244897959
1832,031,1362,37,432,293,1325,1362,1.0,0.027165932452276064,0.972834067547724,637,0.31718061674008813,0.21512481644640236,0.46769456681350957
1833,031,3103,60,741,419,3043,3103,1.0,0.019336126329358685,0.9806638736706413,1943,0.23880116016757977,0.13503061553335483,0.6261682242990654
1834,031,269,6,89,40,263,269,1.0,0.022304832713754646,0.9776951672862454,140,0.3308550185873606,0.14869888475836432,0.5204460966542751
1835,031,1219,6,400,322,1213,1219,1.0,0.004922067268252666,0.9950779327317474,497,0.3281378178835111,0.2641509433962264,0.4077112387202625
1836,031,885,22,280,276,863,885,1.0,0.024858757062146894,0.9751412429378531,329,0.3163841807909605,0.31186440677966104,0.37175141242937854
1837,031,684,20,252,222,664,684,1.0,0.029239766081871343,0.9707602339181286,210,0.3684210526315789,0.32456140350877194,0.30701754385964913
1838,031,2078,43,725,334,2035,2078,1.0,0.020692974013474495,0.9793070259865255,1019,0.348893166506256,0.16073147256977863,0.49037536092396533
1839,031,514,13,177,139,501,514,1.0,0.02529182879377432,0.9747081712062257,198,0.3443579766536965,0.2704280155642023,0.3852140077821012
1840,031,2036,40,633,255,1996,2036,1.0,0.019646365422396856,0.9803536345776032,1148,0.31090373280943023,0.12524557956777996,0.5638506876227898
1841,031,1998,29,728,829,1969,1998,1.0,0.014514514514514515,0.9854854854854855,441,0.36436436436436437,0.4149149149149149,0.22072072072072071
1842,031,1044,12,342,170,1032,1044,1.0,0.011494252873563218,0.9885057471264368,532,0.3275862068965517,0.16283524904214558,0.5095785440613027
1843,031,1134,13,288,275,1121,1134,1.0,0.01146384479717813,0.9885361552028219,571,0.25396825396825395,0.24250440917107582,0.5035273368606702
1844,031,180,4,52,45,176,180,1.0,0.022222222222222223,0.9777777777777777,83,0.28888888888888886,0.25,0.46111111111111114
1845,031,29,4,7,8,25,29,1.0,0.13793103448275862,0.8620689655172413,14,0.2413793103448276,0.27586206896551724,0.4827586206896552
1846,031,1244,11,486,536,1233,1244,1.0,0.008842443729903537,0.9911575562700965,222,0.39067524115755625,0.43086816720257237,0.17845659163987138
1847,031,980,6,332,445,974,980,1.0,0.006122448979591836,0.9938775510204082,203,0.33877551020408164,0.45408163265306123,0.20714285714285716
1848,031,1239,27,383,313,1212,1239,1.0,0.021791767554479417,0.9782082324455206,543,0.30912025827280065,0.25262308313155774,0.43825665859564167
1849,031,1571,23,414,287,1548,1571,1.0,0.01464035646085296,0.9853596435391471,870,0.2635264162953533,0.18268618714194781,0.5537873965626989
1850,031,299,273,148,13,26,299,1.0,0.9130434782608695,0.08695652173913043,138,0.49498327759197325,0.043478260869565216,0.46153846153846156
1851,031,58,1,8,33,57,58,1.0,0.017241379310344827,0.9827586206896551,17,0.13793103448275862,0.5689655172413793,0.29310344827586204
1852,031,1658,46,409,287,1612,1658,1.0,0.027744270205066344,0.9722557297949337,962,0.24668275030156817,0.17310012062726177,0.5802171290711701
1853,031,2355,48,557,307,2307,2355,1.0,0.02038216560509554,0.9796178343949045,1491,0.23651804670912951,0.13036093418259023,0.6331210191082802
1854,031,148,3,15,14,145,148,1.0,0.02027027027027027,0.9797297297297297,119,0.10135135135135136,0.0945945945945946,0.8040540540540541
1855,031,2109,60,621,243,2049,2109,1.0,0.02844950213371266,0.9715504978662873,1245,0.29445234708392604,0.11522048364153627,0.5903271692745377
1856,031,1887,21,691,457,1866,1887,1.0,0.011128775834658187,0.9888712241653418,739,0.3661897191308956,0.24218335983041867,0.39162692103868574
1857,031,1022,17,462,281,1005,1022,1.0,0.016634050880626222,0.9833659491193738,279,0.4520547945205479,0.27495107632093935,0.27299412915851273
1859,031,131,3,52,35,128,131,1.0,0.022900763358778626,0.9770992366412213,44,0.3969465648854962,0.26717557251908397,0.33587786259541985
1860,031,1478,38,379,211,1440,1478,1.0,0.02571041948579161,0.9742895805142084,888,0.2564276048714479,0.14276048714479025,0.6008119079837618
1861,031,2384,14,461,134,2370,2384,1.0,0.00587248322147651,0.9941275167785235,1789,0.19337248322147652,0.05620805369127517,0.7504194630872483
1862,031,12,0,0,0,12,12,1.0,0.0,1.0,12,0.0,0.0,1.0
1863,031,471,20,148,150,451,471,1.0,0.04246284501061571,0.9575371549893843,173,0.31422505307855625,0.3184713375796178,0.3673036093418259
1864,031,2526,12,1048,1085,2514,2526,1.0,0.004750593824228029,0.995249406175772,393,0.41488519398258117,0.42953285827395093,0.15558194774346792
1865,031,1236,7,515,629,1229,1236,1.0,0.0056634304207119745,0.9943365695792881,92,0.4166666666666667,0.5088996763754046,0.0744336569579288
1866,031,1404,39,559,379,1365,1404,1.0,0.027777777777777776,0.9722222222222222,466,0.39814814814814814,0.26994301994301995,0.3319088319088319
1867,031,2169,27,675,537,2142,2169,1.0,0.012448132780082987,0.9875518672199171,957,0.3112033195020747,0.2475795297372061,0.4412171507607192
1868,031,1662,17,613,434,1645,1662,1.0,0.01022864019253911,0.9897713598074609,615,0.36883273164861613,0.2611311672683514,0.3700361010830325
1869,031,2003,16,671,512,1987,2003,1.0,0.00798801797304044,0.9920119820269596,820,0.3349975037443834,0.2556165751372941,0.4093859211183225
1870,031,1454,21,768,306,1433,1454,1.0,0.014442916093535076,0.9855570839064649,380,0.5281980742778541,0.21045392022008252,0.2613480055020633
1871,031,1108,10,216,140,1098,1108,1.0,0.009025270758122744,0.9909747292418772,752,0.19494584837545126,0.1263537906137184,0.6787003610108303
1873,031,862,9,205,88,853,862,1.0,0.010440835266821345,0.9895591647331786,569,0.23781902552204176,0.10208816705336426,0.660092807424594
1874,031,2026,14,705,307,2012,2026,1.0,0.006910167818361303,0.9930898321816387,1014,0.34797630799605134,0.15153010858835142,0.5004935834155972
1875,031,1214,21,457,514,1193,1214,1.0,0.01729818780889621,0.9827018121911038,243,0.37644151565074135,0.4233937397034596,0.200164744645799
1876,031,1526,14,664,375,1512,1526,1.0,0.009174311926605505,0.9908256880733946,487,0.4351245085190039,0.24574049803407602,0.31913499344692003
1877,031,971,7,376,182,964,971,1.0,0.007209062821833162,0.9927909371781668,413,0.38722966014418125,0.1874356333676622,0.4253347064881565
1878,031,1084,43,300,184,1041,1084,1.0,0.03966789667896679,0.9603321033210332,600,0.2767527675276753,0.16974169741697417,0.5535055350553506
1879,031,316,7,52,19,309,316,1.0,0.022151898734177215,0.9778481012658228,245,0.16455696202531644,0.060126582278481014,0.7753164556962026
1880,031,960,18,218,162,942,960,1.0,0.01875,0.98125,580,0.22708333333333333,0.16875,0.6041666666666666
1881,031,1065,38,233,192,1027,1065,1.0,0.03568075117370892,0.964319248826291,640,0.2187793427230047,0.18028169014084508,0.6009389671361502
1882,031,2626,56,761,377,2570,2626,1.0,0.021325209444021324,0.9786747905559787,1488,0.2897943640517898,0.14356435643564355,0.5666412795125666
1883,031,89,4,29,47,85,89,1.0,0.0449438202247191,0.9550561797752809,13,0.3258426966292135,0.5280898876404494,0.14606741573033707
1884,031,2745,13,1080,1107,2732,2745,1.0,0.004735883424408015,0.995264116575592,558,0.39344262295081966,0.40327868852459015,0.20327868852459016
1885,031,2311,50,526,281,2261,2311,1.0,0.021635655560363478,0.9783643444396365,1504,0.2276070964950238,0.12159238424924275,0.6508005192557335
1886,031,315,18,78,107,297,315,1.0,0.05714285714285714,0.9428571428571428,130,0.24761904761904763,0.3396825396825397,0.4126984126984127
1887,031,2547,25,529,379,2522,2547,1.0,0.009815469179426776,0.9901845308205732,1639,0.20769532783667058,0.14880251276010995,0.6435021594032194
1888,031,1728,26,678,500,1702,1728,1.0,0.015046296296296295,0.9849537037037037,550,0.3923611111111111,0.28935185185185186,0.31828703703703703
1889,031,2260,21,732,821,2239,2260,1.0,0.009292035398230088,0.9907079646017699,707,0.3238938053097345,0.36327433628318584,0.31283185840707967
1890,031,937,8,349,308,929,937,1.0,0.008537886872998933,0.991462113127001,280,0.37246531483457845,0.3287086446104589,0.29882604055496265
1891,031,741,11,264,168,730,741,1.0,0.014844804318488529,0.9851551956815114,309,0.3562753036437247,0.22672064777327935,0.41700404858299595
1892,031,1465,14,485,302,1451,1465,1.0,0.00955631399317406,0.990443686006826,678,0.3310580204778157,0.20614334470989762,0.46279863481228667
1893,031,2760,33,846,469,2727,2760,1.0,0.011956521739130435,0.9880434782608696,1445,0.3065217391304348,0.16992753623188406,0.5235507246376812
1894,031,1200,25,211,77,1175,1200,1.0,0.020833333333333332,0.9791666666666666,912,0.17583333333333334,0.06416666666666666,0.76
1895,031,106,2,27,55,104,106,1.0,0.018867924528301886,0.9811320754716981,24,0.25471698113207547,0.5188679245283019,0.22641509433962265
1896,031,1104,14,375,228,1090,1104,1.0,0.012681159420289856,0.9873188405797102,501,0.33967391304347827,0.20652173913043478,0.453804347826087
1897,031,1071,10,393,273,1061,1071,1.0,0.009337068160597572,0.9906629318394025,405,0.36694677871148457,0.2549019607843137,0.37815126050420167
1898,031,1110,3,452,392,1107,1110,1.0,0.002702702702702703,0.9972972972972973,266,0.4072072072072072,0.35315315315315315,0.23963963963963963
1900,031,1665,29,604,639,1636,1665,1.0,0.017417417417417418,0.9825825825825826,422,0.36276276276276276,0.3837837837837838,0.25345345345345344
1901,031,773,10,390,286,763,773,1.0,0.0129366106080207,0.9870633893919794,97,0.5045278137128072,0.36998706338939197,0.12548512289780078
1902,031,2101,5,808,1028,2096,2101,1.0,0.002379819133745835,0.9976201808662541,265,0.38457877201332696,0.4892908138981437,0.12613041408852926
1903,031,56,0,26,28,56,56,1.0,0.0,1.0,2,0.4642857142857143,0.5,0.03571428571428571
1904,031,43,5,0,0,38,43,1.0,0.11627906976744186,0.8837209302325582,43,0.0,0.0,1.0
1905,031,1152,7,291,731,1145,1152,1.0,0.006076388888888889,0.9939236111111112,130,0.2526041666666667,0.6345486111111112,0.11284722222222222
1906,031,1693,16,537,816,1677,1693,1.0,0.009450679267572357,0.9905493207324276,340,0.31718842291789723,0.4819846426461902,0.20082693443591257
1907,031,561,12,211,265,549,561,1.0,0.0213903743315508,0.9786096256684492,85,0.3761140819964349,0.47237076648841353,0.15151515151515152
1908,031,50,0,14,16,50,50,1.0,0.0,1.0,20,0.28,0.32,0.4
1909,031,749,4,297,297,745,749,1.0,0.0053404539385847796,0.9946595460614153,155,0.3965287049399199,0.3965287049399199,0.20694259012016022
1910,031,1254,12,357,613,1242,1254,1.0,0.009569377990430622,0.9904306220095693,284,0.284688995215311,0.48883572567783096,0.22647527910685805
1911,031,820,6,181,535,814,820,1.0,0.007317073170731708,0.9926829268292683,104,0.22073170731707317,0.6524390243902439,0.12682926829268293
1912,031,1487,27,472,698,1460,1487,1.0,0.01815736381977135,0.9818426361802286,317,0.31741761936785473,0.4694014794889038,0.21318090114324142
1913,031,214,3,80,73,211,214,1.0,0.014018691588785047,0.985981308411215,61,0.37383177570093457,0.3411214953271028,0.2850467289719626
1914,031,1922,27,698,594,1895,1922,1.0,0.01404786680541103,0.985952133194589,630,0.3631633714880333,0.3090530697190427,0.32778355879292403
1915,031,1602,22,534,531,1580,1602,1.0,0.01373283395755306,0.9862671660424469,537,0.3333333333333333,0.33146067415730335,0.3352059925093633
1916,031,1698,29,462,906,1669,1698,1.0,0.01707891637220259,0.9829210836277974,330,0.27208480565371024,0.5335689045936396,0.19434628975265017
1917,031,145,0,45,91,145,145,1.0,0.0,1.0,9,0.3103448275862069,0.6275862068965518,0.06206896551724138
1918,031,430,1,245,184,429,430,1.0,0.002325581395348837,0.9976744186046511,1,0.5697674418604651,0.42790697674418604,0.002325581395348837
1919,031,1455,19,380,843,1436,1455,1.0,0.013058419243986255,0.9869415807560138,232,0.2611683848797251,0.5793814432989691,0.15945017182130583
1920,031,1389,25,396,461,1364,1389,1.0,0.017998560115190784,0.9820014398848093,532,0.28509719222462204,0.33189344852411806,0.3830093592512599
1921,031,1179,11,338,212,1168,1179,1.0,0.009329940627650551,0.9906700593723494,629,0.2866836301950806,0.179813401187447,0.5335029686174725
1923,031,1559,28,553,393,1531,1559,1.0,0.01796023091725465,0.9820397690827454,613,0.35471456061577933,0.2520846696600385,0.39320076972418216
1924,031,1129,10,386,376,1119,1129,1.0,0.008857395925597875,0.9911426040744021,367,0.34189548272807796,0.3330380868024801,0.325066430469442
1925,031,1500,24,501,308,1476,1500,1.0,0.016,0.984,691,0.334,0.20533333333333334,0.46066666666666667
1926,031,878,6,393,431,872,878,1.0,0.00683371298405467,0.9931662870159453,54,0.44760820045558086,0.4908883826879271,0.06150341685649203
1927,031,192,0,53,139,192,192,1.0158730158730158,0.0,1.0,0,0.2760416666666667,0.7239583333333334,0.0
1928,031,1122,19,299,646,1103,1122,1.0,0.01693404634581105,0.9830659536541889,177,0.26648841354723707,0.5757575757575758,0.15775401069518716
1929,031,1806,13,578,824,1793,1806,1.0,0.007198228128460687,0.9928017718715393,404,0.32004429678848284,0.45625692137320045,0.22369878183831673
1931,031,1851,16,480,958,1835,1851,1.0,0.00864397622906537,0.9913560237709347,413,0.2593192868719611,0.5175580767152891,0.22312263641274988
1932,031,205,0,67,107,205,205,1.0,0.0,1.0,31,0.32682926829268294,0.5219512195121951,0.15121951219512195
1933,031,1510,13,632,655,1497,1510,1.0,0.008609271523178808,0.9913907284768212,223,0.4185430463576159,0.4337748344370861,0.147682119205298
1934,031,1772,29,621,766,1743,1772,1.0,0.01636568848758465,0.9836343115124153,385,0.35045146726862303,0.4322799097065463,0.2172686230248307
1935,031,900,7,418,201,893,900,1.0,0.0077777777777777776,0.9922222222222222,281,0.46444444444444444,0.22333333333333333,0.31222222222222223
1936,031,36,0,16,11,36,36,1.0,0.0,1.0,9,0.4444444444444444,0.3055555555555556,0.25
1937,031,7,0,0,0,7,7,1.0,0.0,1.0,7,0.0,0.0,1.0
1938,031,30,2,8,11,28,30,1.0,0.06666666666666667,0.9333333333333333,11,0.26666666666666666,0.36666666666666664,0.36666666666666664
1939,031,91,0,11,28,91,91,1.0,0.0,1.0,52,0.12087912087912088,0.3076923076923077,0.5714285714285714
1940,031,237,5,89,61,232,237,1.0,0.02109704641350211,0.9789029535864979,87,0.3755274261603376,0.25738396624472576,0.3670886075949367
1942,031,1089,2,420,533,1087,1089,1.0,0.0018365472910927456,0.9981634527089073,136,0.3856749311294766,0.48943985307621674,0.1248852157943067
1943,031,1101,14,454,313,1087,1101,1.0,0.012715712988192553,0.9872842870118075,334,0.4123524069028156,0.28428701180744775,0.3033605812897366
1944,031,1722,5,731,859,1717,1722,1.0,0.0029036004645760743,0.997096399535424,132,0.4245063879210221,0.4988385598141696,0.07665505226480836
1945,031,19,4,0,0,15,19,1.0,0.21052631578947367,0.7894736842105263,19,0.0,0.0,1.0
1946,031,1003,0,482,291,1003,1003,1.0,0.0,1.0,230,0.48055832502492524,0.2901296111665005,0.22931206380857427
1947,031,4,0,0,0,4,4,1.0,0.0,1.0,4,0.0,0.0,1.0
1949,031,1459,7,402,947,1452,1459,1.0,0.004797806716929404,0.9952021932830706,110,0.27553118574366003,0.6490747087045922,0.07539410555174778
1950,031,296,1,111,130,295,296,1.0,0.0033783783783783786,0.9966216216216216,55,0.375,0.4391891891891892,0.1858108108108108
1951,031,1301,14,472,631,1287,1301,1.0,0.010760953112990008,0.98923904688701,198,0.3627978478093774,0.48501152959262106,0.15219062259800153
1952,031,1354,18,289,783,1336,1354,1.0,0.013293943870014771,0.9867060561299852,282,0.21344165435745938,0.5782865583456426,0.20827178729689808
1953,031,2700,11,823,1066,2689,2700,1.0,0.004074074074074074,0.9959259259259259,811,0.3048148148148148,0.39481481481481484,0.30037037037037034
1954,031,38,0,11,15,38,38,1.0,0.0,1.0,12,0.2894736842105263,0.39473684210526316,0.3157894736842105
1955,031,477,1,198,254,476,477,1.0,0.0020964360587002098,0.9979035639412998,25,0.41509433962264153,0.5324947589098532,0.05241090146750524
1956,031,791,3,413,377,788,791,1.00253807106599,0.0037926675094816687,0.9962073324905183,1,0.5221238938053098,0.47661188369152974,0.0012642225031605564
1957,031,603,7,135,340,596,603,1.0,0.011608623548922056,0.988391376451078,128,0.22388059701492538,0.5638474295190713,0.21227197346600332
1958,031,1305,22,309,188,1283,1305,1.0,0.01685823754789272,0.9831417624521073,808,0.2367816091954023,0.14406130268199233,0.6191570881226054
1959,031,2176,32,613,322,2144,2176,1.0,0.014705882352941176,0.9852941176470589,1241,0.28170955882352944,0.1479779411764706,0.5703125
1961,031,982,5,390,527,977,982,1.0,0.0050916496945010185,0.994908350305499,65,0.3971486761710794,0.5366598778004074,0.06619144602851323
1962,031,601,6,173,104,595,601,1.0,0.009983361064891847,0.9900166389351082,324,0.2878535773710483,0.17304492512479203,0.5391014975041597
1963,031,1458,17,488,292,1441,1458,1.0,0.011659807956104253,0.9883401920438958,678,0.3347050754458162,0.20027434842249658,0.46502057613168724
1964,031,724,12,235,112,712,724,1.0,0.016574585635359115,0.9834254143646409,377,0.324585635359116,0.15469613259668508,0.5207182320441989
1965,031,5,1,0,0,4,5,1.0,0.2,0.8,5,0.0,0.0,1.0
1967,031,88,6,16,39,82,88,1.0,0.06818181818181818,0.9318181818181818,33,0.18181818181818182,0.4431818181818182,0.375
1968,031,86,2,17,47,84,86,1.0,0.023255813953488372,0.9767441860465116,22,0.19767441860465115,0.5465116279069767,0.2558139534883721
1969,031,39,0,4,22,39,39,1.0,0.0,1.0,13,0.10256410256410256,0.5641025641025641,0.3333333333333333
1970,031,116,1,43,44,115,116,1.0,0.008620689655172414,0.9913793103448276,29,0.3706896551724138,0.3793103448275862,0.25
1971,031,28,3,0,0,25,28,1.0,0.10714285714285714,0.8928571428571429,28,0.0,0.0,1.0
1973,031,15,0,5,10,15,15,1.1538461538461537,0.0,1.0,0,0.3333333333333333,0.6666666666666666,0.0
1976,031,8,0,0,0,8,8,1.0,0.0,1.0,8,0.0,0.0,1.0
1978,031,994,14,340,448,980,994,1.0,0.014084507042253521,0.9859154929577465,206,0.3420523138832998,0.4507042253521127,0.20724346076458752
1979,031,1067,7,350,406,1060,1067,1.0,0.006560449859418931,0.993439550140581,311,0.3280224929709466,0.380506091846298,0.2914714151827554
1980,031,50,0,25,23,50,50,1.0,0.0,1.0,2,0.5,0.46,0.04
1981,031,537,0,284,146,537,537,1.0,0.0,1.0,107,0.5288640595903166,0.2718808193668529,0.19925512104283055
1982,031,10,1,0,0,9,10,1.0,0.1,0.9,10,0.0,0.0,1.0
1983,031,44,0,6,20,44,44,1.0,0.0,1.0,18,0.13636363636363635,0.45454545454545453,0.4090909090909091
1986,031,1006,5,323,598,1001,1006,1.0,0.004970178926441352,0.9950298210735586,85,0.3210735586481113,0.5944333996023857,0.08449304174950298
1987,031,2295,23,755,778,2272,2295,1.0,0.010021786492374727,0.9899782135076253,762,0.3289760348583878,0.3389978213507625,0.33202614379084966
1988,031,79,9,17,13,70,79,1.0,0.11392405063291139,0.8860759493670886,49,0.21518987341772153,0.16455696202531644,0.620253164556962
1989,031,1161,14,304,717,1147,1161,1.0,0.012058570198105082,0.9879414298018949,140,0.26184323858742464,0.6175710594315246,0.12058570198105081
1991,031,721,9,246,346,712,721,1.0,0.012482662968099861,0.9875173370319001,129,0.34119278779472956,0.4798890429958391,0.17891816920943135
1992,031,228,2,81,139,226,228,1.0,0.008771929824561403,0.9912280701754386,8,0.35526315789473684,0.6096491228070176,0.03508771929824561
1993,031,15,0,0,0,15,15,1.0,0.0,1.0,15,0.0,0.0,1.0
1995,031,468,9,130,22,459,468,1.0,0.019230769230769232,0.9807692307692307,316,0.2777777777777778,0.04700854700854701,0.6752136752136753
1997,031,11,0,0,0,11,11,1.0,0.0,1.0,11,0.0,0.0,1.0
1998,031,45,0,13,24,45,45,1.0,0.0,1.0,8,0.28888888888888886,0.5333333333333333,0.17777777777777778
1999,031,9,2,0,0,7,9,1.0,0.2222222222222222,0.7777777777777778,9,0.0,0.0,1.0
2001,031,469,2,233,139,467,469,1.0,0.0042643923240938165,0.9957356076759062,97,0.4968017057569296,0.29637526652452023,0.2068230277185501
2002,031,33,0,15,11,33,33,1.0,0.0,1.0,7,0.45454545454545453,0.3333333333333333,0.21212121212121213
2003,031,1,1,0,0,0,1,1.0,1.0,0.0,1,0.0,0.0,1.0
2004,031,1585,8,567,423,1577,1585,1.0,0.005047318611987382,0.9949526813880126,595,0.35772870662460565,0.2668769716088328,0.3753943217665615
2005,031,1246,5,457,452,1241,1246,1.0,0.0040128410914927765,0.9959871589085072,337,0.3667736757624398,0.36276083467094705,0.27046548956661315
2006,031,839,0,428,376,839,839,1.0,0.0,1.0,35,0.5101311084624554,0.44815256257449343,0.041716328963051254
2007,031,651,6,307,281,645,651,1.0,0.009216589861751152,0.9907834101382489,63,0.4715821812596006,0.43164362519201227,0.0967741935483871
2008,031,866,1,446,394,865,866,1.0,0.0011547344110854503,0.9988452655889145,26,0.5150115473441108,0.45496535796766746,0.03002309468822171
2009,031,740,14,376,333,726,740,1.0,0.01891891891891892,0.981081081081081,31,0.5081081081081081,0.45,0.041891891891891894
2010,031,1173,4,499,561,1169,1173,1.0,0.0034100596760443308,0.9965899403239556,113,0.4254049445865303,0.4782608695652174,0.09633418584825235
2011,031,910,1,420,378,909,910,1.0,0.001098901098901099,0.9989010989010989,112,0.46153846153846156,0.4153846153846154,0.12307692307692308
2012,031,10,0,0,0,10,10,1.0,0.0,1.0,10,0.0,0.0,1.0
2014,031,6,0,0,0,6,6,1.0,0.0,1.0,6,0.0,0.0,1.0
2015,031,314,2,160,136,312,314,1.0,0.006369426751592357,0.9936305732484076,18,0.5095541401273885,0.43312101910828027,0.05732484076433121
2016,031,346,0,86,222,346,346,1.0,0.0,1.0,38,0.24855491329479767,0.6416184971098265,0.10982658959537572
2017,031,330,5,95,139,325,330,1.0,0.015151515151515152,0.9848484848484849,96,0.2878787878787879,0.4212121212121212,0.2909090909090909
2018,031,1558,30,502,391,1528,1558,1.0,0.019255455712451863,0.9807445442875481,665,0.32220795892169446,0.25096277278562257,0.4268292682926829
2019,031,1215,19,426,210,1196,1215,1.0,0.015637860082304528,0.9843621399176955,579,0.3506172839506173,0.1728395061728395,0.4765432098765432
2020,031,2266,30,761,535,2236,2266,1.0,0.01323918799646955,0.9867608120035305,970,0.3358340688437776,0.23609885260370697,0.42806707855251547
2021,031,2255,40,488,1017,2215,2255,1.0,0.017738359201773836,0.9822616407982262,750,0.2164079822616408,0.45099778270509977,0.3325942350332594
2022,031,589,14,125,117,575,589,1.0,0.023769100169779286,0.9762308998302207,347,0.21222410865874364,0.19864176570458403,0.5891341256366723
2023,031,2,0,0,0,2,2,1.0,0.0,1.0,2,0.0,0.0,1.0
2024,031,337,2,74,232,335,337,1.0,0.005934718100890208,0.9940652818991098,31,0.2195845697329377,0.6884272997032641,0.09198813056379822
2025,031,814,4,273,491,810,814,1.0,0.004914004914004914,0.995085995085995,50,0.3353808353808354,0.6031941031941032,0.06142506142506143
2026,031,325,0,95,175,325,325,1.0,0.0,1.0,55,0.2923076923076923,0.5384615384615384,0.16923076923076924
2027,031,1382,32,315,528,1350,1382,1.0,0.023154848046309694,0.9768451519536903,539,0.22793053545586106,0.38205499276411,0.39001447178002896
2028,031,430,0,111,217,430,430,1.0,0.0,1.0,102,0.25813953488372093,0.5046511627906977,0.2372093023255814
2030,031,8,1,0,0,7,8,1.0,0.125,0.875,8,0.0,0.0,1.0
2031,031,106,1,19,36,105,106,1.0,0.009433962264150943,0.9905660377358491,51,0.1792452830188679,0.33962264150943394,0.4811320754716981
2032,031,610,0,186,348,610,610,1.0,0.0,1.0,76,0.30491803278688523,0.5704918032786885,0.12459016393442623
2033,031,1107,9,311,582,1098,1107,1.0,0.008130081300813009,0.991869918699187,214,0.2809394760614273,0.5257452574525745,0.1933152664859982
2034,031,2118,27,597,412,2091,2118,1.0,0.012747875354107648,0.9872521246458924,1109,0.2818696883852691,0.19452313503305005,0.5236071765816809
2035,031,23,0,0,0,23,23,1.0,0.0,1.0,23,0.0,0.0,1.0
2036,031,785,3,365,390,782,785,1.0,0.003821656050955414,0.9961783439490446,30,0.46496815286624205,0.4968152866242038,0.03821656050955414
2037,031,1297,7,590,706,1290,1297,1.0109204368174727,0.005397070161912105,0.9946029298380878,1,0.4548959136468774,0.5443330763299923,0.0007710100231303007
2038,031,1175,2,408,710,1173,1175,1.0,0.001702127659574468,0.9982978723404256,57,0.3472340425531915,0.6042553191489362,0.04851063829787234
2039,031,13,0,6,7,13,13,1.4444444444444444,0.0,1.0,0,0.46153846153846156,0.5384615384615384,0.0
2040,031,2,0,0,0,2,2,1.0,0.0,1.0,2,0.0,0.0,1.0
2042,031,893,3,323,506,890,893,1.0,0.0033594624860022394,0.9966405375139977,64,0.3617021276595745,0.5666293393057111,0.07166853303471445
2043,031,526,1,173,132,525,526,1.0,0.0019011406844106464,0.9980988593155894,221,0.3288973384030418,0.2509505703422053,0.42015209125475284
2044,031,48,3,13,28,45,48,1.0,0.0625,0.9375,7,0.2708333333333333,0.5833333333333334,0.14583333333333334
2045,031,1821,22,594,357,1799,1821,1.0,0.012081274025260845,0.9879187259747392,870,0.3261943986820428,0.19604612850082373,0.47775947281713343
2046,031,1002,3,381,495,999,1002,1.0,0.0029940119760479044,0.9970059880239521,126,0.38023952095808383,0.4940119760479042,0.12574850299401197
2047,031,1793,39,559,490,1754,1793,1.0,0.021751254880089235,0.9782487451199108,744,0.31176798661461236,0.27328499721137756,0.41494701617401003
2048,031,205,2,55,24,203,205,1.0,0.00975609756097561,0.9902439024390244,126,0.2682926829268293,0.11707317073170732,0.6146341463414634
2049,031,712,11,194,123,701,712,1.0,0.01544943820224719,0.9845505617977528,395,0.27247191011235955,0.17275280898876405,0.5547752808988764
2053,031,4,0,0,0,4,4,1.0,0.0,1.0,4,0.0,0.0,1.0
2054,031,1513,12,564,749,1501,1513,1.0,0.007931262392597489,0.9920687376074026,200,0.37276933245208194,0.4950429610046266,0.13218770654329148
2057,031,407,6,178,167,401,407,1.0,0.014742014742014743,0.9852579852579852,62,0.43734643734643736,0.4103194103194103,0.15233415233415235
2058,031,103,0,39,19,103,103,1.0,0.0,1.0,45,0.3786407766990291,0.18446601941747573,0.4368932038834951
2059,031,422,1,165,213,421,422,1.0,0.002369668246445498,0.9976303317535545,44,0.3909952606635071,0.504739336492891,0.10426540284360189
2060,031,1135,34,297,125,1101,1135,1.0,0.029955947136563875,0.9700440528634361,713,0.2616740088105727,0.11013215859030837,0.628193832599119
2061,031,553,16,164,106,537,553,1.0,0.028933092224231464,0.9710669077757685,283,0.2965641952983725,0.19168173598553345,0.5117540687160941
2062,031,1107,21,338,154,1086,1107,1.0,0.018970189701897018,0.981029810298103,615,0.3053297199638663,0.13911472448057813,0.5555555555555556
2063,031,5,2,0,0,3,5,1.0,0.4,0.6,5,0.0,0.0,1.0
2064,031,124,0,36,88,124,124,1.024793388429752,0.0,1.0,0,0.2903225806451613,0.7096774193548387,0.0
2065,031,28,0,11,15,28,28,1.0,0.0,1.0,2,0.39285714285714285,0.5357142857142857,0.07142857142857142
2066,031,831,8,354,278,823,831,1.0,0.009626955475330927,0.9903730445246691,199,0.4259927797833935,0.3345367027677497,0.2394705174488568
2067,031,4,0,0,0,4,4,1.0,0.0,1.0,4,0.0,0.0,1.0
2068,031,862,31,320,219,831,862,1.0,0.03596287703016241,0.9640371229698376,323,0.37122969837587005,0.25406032482598606,0.37470997679814383
2070,031,5,0,0,0,5,5,1.0,0.0,1.0,5,0.0,0.0,1.0
2073,031,43,0,2,24,43,43,1.0,0.0,1.0,17,0.046511627906976744,0.5581395348837209,0.3953488372093023
2074,031,32,2,0,0,30,32,1.0,0.0625,0.9375,32,0.0,0.0,1.0
2075,031,154,0,42,79,154,154,1.0,0.0,1.0,33,0.2727272727272727,0.512987012987013,0.21428571428571427
2078,031,37,1,13,14,36,37,1.0,0.02702702702702703,0.972972972972973,10,0.35135135135135137,0.3783783783783784,0.2702702702702703
2079,017,700,2,49,576,698,700,1.0,0.002857142857142857,0.9971428571428571,75,0.07,0.8228571428571428,0.10714285714285714
2080,017,63,0,1,35,63,63,1.0,0.0,1.0,27,0.015873015873015872,0.5555555555555556,0.42857142857142855
2081,017,1066,9,110,505,1057,1066,1.0,0.008442776735459663,0.9915572232645403,451,0.10318949343339587,0.47373358348968103,0.4230769230769231
2082,017,672,0,45,470,672,672,1.0,0.0,1.0,157,0.06696428571428571,0.6994047619047619,0.23363095238095238
