,COUNTYFP20,VAP,APAMINVAP,PRES20D,PRES20R,OVAP,TOT_VOTES,factor,APAMINVAP_pct,OVAP_pct,PRES20None,PRES20D_pct,PRES20R_pct,PRES20None_pct
0,015,873,22,69,551,851,873,1.0,0.025200458190148912,0.9747995418098511,253,0.07903780068728522,0.6311569301260023,0.2898052691867125
1,015,131,11,8,63,120,131,1.0,0.08396946564885496,0.916030534351145,60,0.061068702290076333,0.48091603053435117,0.4580152671755725
2,015,144,7,13,84,137,144,1.0,0.04861111111111111,0.9513888888888888,47,0.09027777777777778,0.5833333333333334,0.3263888888888889
3,015,1086,89,119,564,997,1086,1.0,0.08195211786372007,0.91804788213628,403,0.10957642725598526,0.5193370165745856,0.3710865561694291
4,015,19,1,3,15,18,19,1.0,0.05263157894736842,0.9473684210526315,1,0.15789473684210525,0.7894736842105263,0.05263157894736842
5,015,176,5,24,61,171,176,1.0,0.028409090909090908,0.9715909090909091,91,0.13636363636363635,0.3465909090909091,0.5170454545454546
6,015,924,118,144,387,806,924,1.0,0.1277056277056277,0.8722943722943723,393,0.15584415584415584,0.41883116883116883,0.4253246753246753
7,015,244,18,36,132,226,244,1.0,0.07377049180327869,0.9262295081967213,76,0.14754098360655737,0.5409836065573771,0.3114754098360656
8,015,683,40,76,323,643,683,1.0,0.05856515373352855,0.9414348462664714,284,0.11127379209370425,0.47291361639824303,0.4158125915080527
10,003,7,0,0,0,7,7,1.0,0.0,1.0,7,0.0,0.0,1.0
11,003,860,19,267,185,841,860,1.0,0.022093023255813953,0.977906976744186,408,0.31046511627906975,0.21511627906976744,0.4744186046511628
12,003,1599,46,428,234,1553,1599,1.0,0.028767979987492184,0.9712320200125079,937,0.267667292057536,0.14634146341463414,0.5859912445278299
13,003,2777,90,843,459,2687,2777,1.0,0.03240907454087144,0.9675909254591285,1475,0.30356499819949584,0.16528628015844438,0.5311487216420597
14,003,660,29,203,167,631,660,1.0,0.04393939393939394,0.956060606060606,290,0.30757575757575756,0.25303030303030305,0.4393939393939394
15,003,1526,36,518,502,1490,1526,1.0,0.023591087811271297,0.9764089121887287,506,0.3394495412844037,0.3289646133682831,0.3315858453473132
16,003,1462,6,560,730,1456,1462,1.0,0.004103967168262654,0.9958960328317373,172,0.38303693570451436,0.4993160054719562,0.11764705882352941
17,003,1010,15,324,169,995,1010,1.0,0.01485148514851485,0.9851485148514851,517,0.3207920792079208,0.16732673267326734,0.5118811881188119
19,003,1834,57,535,432,1777,1834,1.0,0.031079607415485277,0.9689203925845147,867,0.29171210468920394,0.23555070883315157,0.4727371864776445
20,003,1442,38,377,738,1404,1442,1.0,0.026352288488210817,0.9736477115117892,327,0.26144244105409153,0.5117891816920943,0.22676837725381416
21,003,1555,18,474,685,1537,1555,1.0,0.01157556270096463,0.9884244372990354,396,0.3048231511254019,0.4405144694533762,0.2546623794212219
22,003,714,19,82,461,695,714,1.0,0.02661064425770308,0.9733893557422969,171,0.11484593837535013,0.6456582633053222,0.23949579831932774
23,003,2027,39,586,480,1988,2027,1.0,0.019240256536753823,0.9807597434632461,961,0.28909718796250616,0.23680315737543167,0.47409965466206216
24,003,1164,23,196,83,1141,1164,1.0,0.019759450171821305,0.9802405498281787,885,0.16838487972508592,0.07130584192439862,0.7603092783505154
25,003,1930,37,655,516,1893,1930,1.0,0.01917098445595855,0.9808290155440414,759,0.3393782383419689,0.26735751295336785,0.3932642487046632
26,003,2260,65,480,686,2195,2260,1.0,0.028761061946902654,0.9712389380530974,1094,0.21238938053097345,0.3035398230088496,0.484070796460177
27,003,1599,39,516,656,1560,1599,1.0,0.024390243902439025,0.975609756097561,427,0.3227016885553471,0.41025641025641024,0.26704190118824267
28,003,1260,25,542,238,1235,1260,1.0,0.01984126984126984,0.9801587301587301,480,0.4301587301587302,0.18888888888888888,0.38095238095238093
29,003,1286,42,418,537,1244,1286,1.0,0.03265940902021773,0.9673405909797823,331,0.3250388802488336,0.4175738724727838,0.2573872472783826
30,003,30,4,0,0,26,30,1.0,0.13333333333333333,0.8666666666666667,30,0.0,0.0,1.0
31,003,2813,105,839,566,2708,2813,1.0,0.03732669747600426,0.9626733025239957,1408,0.2982580874511198,0.2012086740135087,0.5005332385353715
32,003,380,5,72,49,375,380,1.0,0.013157894736842105,0.9868421052631579,259,0.18947368421052632,0.12894736842105264,0.6815789473684211
33,003,2447,67,784,894,2380,2447,1.0,0.027380465876583573,0.9726195341234164,769,0.32039231712300775,0.3653453208009808,0.31426236207601144
34,003,3000,45,1110,1136,2955,3000,1.0,0.015,0.985,754,0.37,0.37866666666666665,0.25133333333333335
35,003,1233,46,396,274,1187,1233,1.0,0.0373073803730738,0.9626926196269262,563,0.32116788321167883,0.2222222222222222,0.45660989456609896
36,003,1753,38,550,453,1715,1753,1.0,0.02167712492869367,0.9783228750713063,750,0.3137478608100399,0.25841414717626926,0.4278379920136908
37,003,2659,76,511,460,2583,2659,1.0,0.0285821737495299,0.9714178262504701,1688,0.19217751034223393,0.17299736743136518,0.6348251222264009
38,003,1281,26,432,546,1255,1281,1.0,0.02029664324746292,0.9797033567525371,303,0.3372365339578454,0.4262295081967213,0.23653395784543327
39,003,1473,45,447,318,1428,1473,1.0,0.03054989816700611,0.9694501018329938,708,0.3034623217922607,0.2158859470468432,0.48065173116089616
40,003,2662,82,811,509,2580,2662,1.0,0.030803906836964687,0.9691960931630353,1342,0.3046581517655898,0.19120961682945153,0.5041322314049587
41,003,455,4,194,195,451,455,1.0,0.008791208791208791,0.9912087912087912,66,0.42637362637362636,0.42857142857142855,0.14505494505494507
42,003,884,24,0,0,860,884,1.0,0.027149321266968326,0.9728506787330317,884,0.0,0.0,1.0
43,003,2412,77,910,102,2335,2412,1.0,0.031923714759535655,0.9680762852404643,1400,0.37728026533996684,0.04228855721393035,0.5804311774461028
44,003,3013,83,852,701,2930,3013,1.0,0.027547295054762694,0.9724527049452373,1460,0.28277464321274476,0.23265847992034516,0.4845668768669101
45,003,771,31,258,222,740,771,1.0,0.040207522697795074,0.959792477302205,291,0.3346303501945525,0.28793774319066145,0.377431906614786
46,003,3076,59,892,833,3017,3076,1.0,0.01918075422626788,0.9808192457737321,1351,0.28998699609882966,0.27080624187256175,0.4392067620286086
48,003,2561,68,789,653,2493,2561,1.0,0.026552128074970715,0.9734478719250292,1119,0.3080827801639984,0.254978524014057,0.43693869582194456
49,003,1469,38,355,230,1431,1469,1.0,0.025867937372362152,0.9741320626276379,884,0.24166099387338325,0.15656909462219196,0.6017699115044248
50,003,1151,37,283,125,1114,1151,1.0,0.03214596003475239,0.9678540399652477,743,0.24587315377932234,0.10860121633362294,0.6455256298870548
51,003,1332,22,534,407,1310,1332,1.0,0.016516516516516516,0.9834834834834835,391,0.4009009009009009,0.3055555555555556,0.29354354354354356
52,003,62,4,0,0,58,62,1.0,0.06451612903225806,0.9354838709677419,62,0.0,0.0,1.0
53,003,2321,84,705,606,2237,2321,1.0,0.03619129685480396,0.9638087031451961,1010,0.3037483843171047,0.26109435588108576,0.4351572598018096
54,003,742,12,69,465,730,742,1.0,0.016172506738544475,0.9838274932614556,208,0.09299191374663072,0.6266846361185984,0.2803234501347709
55,003,272,4,72,98,268,272,1.0,0.014705882352941176,0.9852941176470589,102,0.2647058823529412,0.3602941176470588,0.375
56,003,2995,106,1039,651,2889,2995,1.0,0.035392320534223705,0.9646076794657763,1305,0.3469115191986644,0.21736227045075127,0.4357262103505843
57,003,1933,60,617,343,1873,1933,1.0,0.031039834454216243,0.9689601655457838,973,0.31919296430419036,0.17744438696326953,0.5033626487325401
58,003,2606,72,751,1018,2534,2606,1.0,0.02762854950115119,0.9723714504988488,837,0.2881811204911742,0.3906369915579432,0.3211818879508826
59,003,1490,39,505,492,1451,1490,1.0,0.026174496644295303,0.9738255033557047,493,0.3389261744966443,0.3302013422818792,0.3308724832214765
60,003,1598,48,506,675,1550,1598,1.0,0.030037546933667083,0.9699624530663329,417,0.3166458072590738,0.42240300375469336,0.2609511889862328
61,003,4374,166,890,411,4208,4374,1.0,0.037951531778692274,0.9620484682213077,3073,0.2034750800182899,0.09396433470507544,0.7025605852766347
62,003,2083,49,732,708,2034,2083,1.0,0.023523763802208355,0.9764762361977917,643,0.3514162265962554,0.3398943831012962,0.3086893903024484
63,003,2544,146,603,170,2398,2544,1.0,0.05738993710691824,0.9426100628930818,1771,0.23702830188679244,0.06682389937106918,0.6961477987421384
64,003,2704,66,743,473,2638,2704,1.0,0.02440828402366864,0.9755917159763313,1488,0.27477810650887574,0.17492603550295857,0.5502958579881657
65,003,3295,110,697,161,3185,3295,1.0,0.03338391502276176,0.9666160849772383,2437,0.21153262518968133,0.04886191198786039,0.7396054628224583
66,003,2186,41,734,569,2145,2186,1.0,0.018755718206770355,0.9812442817932296,883,0.3357731015553522,0.26029277218664226,0.4039341262580055
67,003,1336,21,380,419,1315,1336,1.0,0.015718562874251496,0.9842814371257484,537,0.2844311377245509,0.31362275449101795,0.40194610778443113
68,003,2338,72,717,1217,2266,2338,1.0,0.030795551753635585,0.9692044482463644,404,0.306672369546621,0.520530367835757,0.1727972626176219
69,003,1853,51,509,833,1802,1853,1.0,0.027522935779816515,0.9724770642201835,511,0.2746896923907178,0.44954128440366975,0.27576902320561253
70,003,1153,38,475,227,1115,1153,1.0,0.03295750216825672,0.9670424978317432,451,0.411968777103209,0.19687771032090198,0.391153512575889
71,003,756,14,171,400,742,756,1.0,0.018518518518518517,0.9814814814814815,185,0.2261904761904762,0.5291005291005291,0.2447089947089947
72,003,1211,42,313,504,1169,1211,1.0,0.03468208092485549,0.9653179190751445,394,0.2584640792733278,0.4161849710982659,0.32535094962840627
73,003,1176,27,450,323,1149,1176,1.0,0.02295918367346939,0.9770408163265306,403,0.3826530612244898,0.27465986394557823,0.342687074829932
74,003,1504,39,611,587,1465,1504,1.0,0.025930851063829786,0.9740691489361702,306,0.40625,0.39029255319148937,0.20345744680851063
75,003,2392,48,756,485,2344,2392,1.0,0.020066889632107024,0.979933110367893,1151,0.31605351170568563,0.20275919732441472,0.48118729096989965
76,003,1233,25,426,171,1208,1233,1.0,0.0202757502027575,0.9797242497972425,636,0.34549878345498786,0.1386861313868613,0.5158150851581509
77,003,285,5,51,128,280,285,1.0,0.017543859649122806,0.9824561403508771,106,0.17894736842105263,0.44912280701754387,0.3719298245614035
78,003,2109,88,620,367,2021,2109,1.0,0.04172593646277857,0.9582740635372214,1122,0.29397818871503084,0.17401612138454245,0.5320056899004267
79,003,2310,74,514,384,2236,2310,1.0,0.032034632034632034,0.9679653679653679,1412,0.22251082251082252,0.16623376623376623,0.6112554112554113
80,003,520,25,161,179,495,520,1.0,0.04807692307692308,0.9519230769230769,180,0.3096153846153846,0.34423076923076923,0.34615384615384615
81,003,2220,93,460,279,2127,2220,1.0,0.041891891891891894,0.9581081081081081,1481,0.2072072072072072,0.12567567567567567,0.6671171171171171
82,003,1716,40,745,218,1676,1716,1.0,0.023310023310023312,0.9766899766899767,753,0.43414918414918413,0.12703962703962704,0.4388111888111888
83,003,1159,48,419,374,1111,1159,1.0,0.04141501294219154,0.9585849870578085,366,0.361518550474547,0.32269197584124243,0.3157894736842105
85,003,2742,40,948,769,2702,2742,1.0,0.014587892049598834,0.9854121079504011,1025,0.34573304157549234,0.2804522246535376,0.3738147337709701
86,003,1706,38,525,459,1668,1706,1.0,0.022274325908558032,0.977725674091442,722,0.30773739742086753,0.2690504103165299,0.4232121922626026
87,003,1045,23,341,558,1022,1045,1.0,0.02200956937799043,0.9779904306220095,146,0.3263157894736842,0.5339712918660288,0.1397129186602871
88,003,2215,55,734,590,2160,2215,1.0,0.024830699774266364,0.9751693002257337,891,0.3313769751693002,0.26636568848758463,0.4022573363431151
89,003,1553,33,452,659,1520,1553,1.0,0.021249195106245976,0.978750804893754,442,0.2910495814552479,0.42433998712169996,0.28461043142305215
90,003,35,2,9,22,33,35,1.0,0.05714285714285714,0.9428571428571428,4,0.2571428571428571,0.6285714285714286,0.11428571428571428
92,003,3146,72,1009,741,3074,3146,1.0,0.02288620470438652,0.9771137952956135,1396,0.32072472981563893,0.23553719008264462,0.44373808010171645
93,003,1238,41,310,648,1197,1238,1.0,0.033117932148626815,0.9668820678513732,280,0.25040387722132473,0.5234248788368336,0.22617124394184168
94,003,101,4,15,23,97,101,1.0,0.039603960396039604,0.9603960396039604,63,0.1485148514851485,0.22772277227722773,0.6237623762376238
95,003,1247,41,412,320,1206,1247,1.0,0.03287890938251804,0.967121090617482,515,0.33039294306335204,0.2566158781074579,0.41299117882919006
96,003,2219,75,479,745,2144,2219,1.0,0.0337990085624155,0.9662009914375845,995,0.21586300135196035,0.33573681838666064,0.448400180261379
97,003,1429,35,460,633,1394,1429,1.0,0.0244926522043387,0.9755073477956613,336,0.3219034289713086,0.4429671098670399,0.2351294611616515
99,003,2291,109,670,577,2182,2291,1.0,0.04757747708424269,0.9524225229157574,1044,0.29244871235268444,0.25185508511567,0.45569620253164556
100,003,291,3,111,70,288,291,1.0,0.010309278350515464,0.9896907216494846,110,0.38144329896907214,0.24054982817869416,0.37800687285223367
101,003,1320,24,487,391,1296,1320,1.0,0.01818181818181818,0.9818181818181818,442,0.36893939393939396,0.2962121212121212,0.33484848484848484
102,003,18,5,0,0,13,18,1.0,0.2777777777777778,0.7222222222222222,18,0.0,0.0,1.0
103,003,1467,40,476,340,1427,1467,1.0,0.027266530334014997,0.972733469665985,651,0.32447171097477845,0.23176550783912747,0.4437627811860941
104,003,312,12,81,84,300,312,1.0,0.038461538461538464,0.9615384615384616,147,0.25961538461538464,0.2692307692307692,0.47115384615384615
105,003,23,5,0,0,18,23,1.0,0.21739130434782608,0.782608695652174,23,0.0,0.0,1.0
106,003,1059,27,351,462,1032,1059,1.0,0.025495750708215296,0.9745042492917847,246,0.3314447592067989,0.43626062322946174,0.23229461756373937
107,003,3289,130,471,184,3159,3289,1.0,0.039525691699604744,0.9604743083003953,2634,0.14320462146549104,0.055944055944055944,0.800851322590453
108,003,1079,26,334,330,1053,1079,1.0,0.024096385542168676,0.9759036144578314,415,0.30954587581093607,0.30583873957367935,0.38461538461538464
110,003,1653,48,381,155,1605,1653,1.0,0.029038112522686024,0.9709618874773139,1117,0.23049001814882034,0.09376890502117362,0.6757410768300061
111,003,2384,80,657,360,2304,2384,1.0,0.03355704697986577,0.9664429530201343,1367,0.27558724832214765,0.15100671140939598,0.5734060402684564
112,003,1330,40,483,453,1290,1330,1.0,0.03007518796992481,0.9699248120300752,394,0.3631578947368421,0.3406015037593985,0.2962406015037594
113,003,1869,43,624,548,1826,1869,1.0,0.023006955591225255,0.9769930444087748,697,0.33386837881219905,0.29320492241840557,0.3729266987693954
114,003,1644,78,417,170,1566,1644,1.0,0.04744525547445255,0.9525547445255474,1057,0.25364963503649635,0.10340632603406326,0.6429440389294404
115,003,1818,58,652,570,1760,1818,1.0,0.0319031903190319,0.9680968096809681,596,0.3586358635863586,0.31353135313531355,0.3278327832783278
116,003,1393,34,487,390,1359,1393,1.0,0.024407753050969132,0.9755922469490309,516,0.34960516870064606,0.2799712849964106,0.3704235463029433
117,003,3055,33,802,490,3022,3055,1.0,0.010801963993453356,0.9891980360065467,1763,0.2625204582651391,0.16039279869067102,0.5770867430441898
118,003,1675,49,596,409,1626,1675,1.0,0.029253731343283584,0.9707462686567164,670,0.35582089552238805,0.24417910447761193,0.4
119,003,26,0,12,12,26,26,1.0,0.0,1.0,2,0.46153846153846156,0.46153846153846156,0.07692307692307693
120,003,46,0,14,26,46,46,1.0,0.0,1.0,6,0.30434782608695654,0.5652173913043478,0.13043478260869565
121,003,19,0,14,3,19,19,1.0,0.0,1.0,2,0.7368421052631579,0.15789473684210525,0.10526315789473684
122,003,57,0,16,38,57,57,1.0,0.0,1.0,3,0.2807017543859649,0.6666666666666666,0.05263157894736842
126,003,1239,43,399,388,1196,1239,1.0,0.03470540758676352,0.9652945924132365,452,0.3220338983050847,0.3131557707828894,0.3648103309120258
127,003,2410,64,731,524,2346,2410,1.0,0.026556016597510373,0.9734439834024896,1155,0.3033195020746888,0.2174273858921162,0.47925311203319504
128,003,197,1,56,96,196,197,1.0,0.005076142131979695,0.9949238578680203,45,0.28426395939086296,0.4873096446700508,0.22842639593908629
129,003,1062,13,440,227,1049,1062,1.0,0.01224105461393597,0.987758945386064,395,0.4143126177024482,0.2137476459510358,0.371939736346516
130,003,726,23,280,174,703,726,1.0,0.03168044077134986,0.9683195592286501,272,0.3856749311294766,0.2396694214876033,0.3746556473829201
131,003,906,8,345,377,898,906,1.0,0.008830022075055188,0.9911699779249448,184,0.38079470198675497,0.41611479028697573,0.20309050772626933
132,003,6,0,0,0,6,6,1.0,0.0,1.0,6,0.0,0.0,1.0
133,003,2,0,0,0,2,2,1.0,0.0,1.0,2,0.0,0.0,1.0
134,003,1603,56,361,136,1547,1603,1.0,0.034934497816593885,0.9650655021834061,1106,0.2252027448533999,0.08484092326887087,0.6899563318777293
135,003,1699,47,438,108,1652,1699,1.0,0.02766333137139494,0.972336668628605,1153,0.2577987051206592,0.06356680400235433,0.6786344908769865
136,003,1212,27,364,267,1185,1212,1.0,0.022277227722772276,0.9777227722772277,581,0.30033003300330036,0.2202970297029703,0.4793729372937294
137,003,3264,106,1056,901,3158,3264,1.0,0.032475490196078434,0.9675245098039216,1307,0.3235294117647059,0.2760416666666667,0.40042892156862747
138,003,1569,26,613,636,1543,1569,1.0,0.0165710643722116,0.9834289356277884,320,0.3906947100063735,0.40535372848948376,0.20395156150414276
139,003,815,6,324,401,809,815,1.0,0.007361963190184049,0.992638036809816,90,0.39754601226993863,0.4920245398773006,0.11042944785276074
140,003,818,30,262,237,788,818,1.0,0.03667481662591687,0.9633251833740831,319,0.3202933985330073,0.28973105134474325,0.3899755501222494
141,003,2553,70,897,586,2483,2553,1.0,0.027418723070896985,0.972581276929103,1070,0.35135135135135137,0.22953388170779476,0.4191147669408539
142,003,1558,22,411,261,1536,1558,1.0,0.014120667522464698,0.9858793324775353,886,0.2637997432605905,0.16752246469833118,0.5686777920410783
144,003,156,3,48,41,153,156,1.0,0.019230769230769232,0.9807692307692307,67,0.3076923076923077,0.26282051282051283,0.42948717948717946
145,003,1112,45,363,315,1067,1112,1.0,0.040467625899280574,0.9595323741007195,434,0.32643884892086333,0.28327338129496404,0.3902877697841727
146,003,2893,111,632,260,2782,2893,1.0,0.038368475630833045,0.961631524369167,2001,0.21845834773591427,0.08987210508123056,0.6916695471828551
147,003,2090,54,732,655,2036,2090,1.0,0.02583732057416268,0.9741626794258373,703,0.35023923444976074,0.3133971291866029,0.33636363636363636
148,003,1115,47,204,128,1068,1115,1.0,0.042152466367713005,0.957847533632287,783,0.18295964125560538,0.1147982062780269,0.7022421524663677
149,003,2872,30,864,1559,2842,2872,1.0,0.010445682451253482,0.9895543175487466,449,0.3008356545961003,0.5428272980501393,0.15633704735376044
150,003,1208,28,352,436,1180,1208,1.0,0.023178807947019868,0.9768211920529801,420,0.2913907284768212,0.3609271523178808,0.347682119205298
151,003,1894,53,662,666,1841,1894,1.0,0.0279831045406547,0.9720168954593453,566,0.3495248152059134,0.35163674762407604,0.2988384371700106
152,003,1642,57,482,325,1585,1642,1.0,0.034713763702801465,0.9652862362971986,835,0.2935444579780755,0.19792935444579782,0.5085261875761267
153,003,2594,103,654,367,2491,2594,1.0,0.03970701619121048,0.9602929838087895,1573,0.25212027756360833,0.14148033924441017,0.6063993831919815
155,003,2000,67,669,515,1933,2000,1.0,0.0335,0.9665,816,0.3345,0.2575,0.408
156,003,1594,39,542,300,1555,1594,1.0,0.024466750313676285,0.9755332496863237,752,0.34002509410288584,0.18820577164366373,0.47176913425345046
157,003,673,27,213,263,646,673,1.0,0.04011887072808321,0.9598811292719168,197,0.3164933135215453,0.39078751857355126,0.29271916790490343
158,003,74,6,14,38,68,74,1.0,0.08108108108108109,0.918918918918919,22,0.1891891891891892,0.5135135135135135,0.2972972972972973
159,003,1830,49,654,577,1781,1830,1.0,0.026775956284153007,0.973224043715847,599,0.35737704918032787,0.3153005464480874,0.3273224043715847
160,003,578,32,185,247,546,578,1.0,0.05536332179930796,0.9446366782006921,146,0.32006920415224915,0.4273356401384083,0.25259515570934254
161,003,1274,44,291,706,1230,1274,1.0,0.03453689167974882,0.9654631083202512,277,0.22841444270015698,0.554160125588697,0.217425431711146
162,003,1048,15,342,439,1033,1048,1.0,0.01431297709923664,0.9856870229007634,267,0.32633587786259544,0.41889312977099236,0.2547709923664122
163,003,2747,80,701,305,2667,2747,1.0,0.029122679286494358,0.9708773207135056,1741,0.2551874772479068,0.11103021477975973,0.6337823079723335
164,003,410,10,141,71,400,410,1.0,0.024390243902439025,0.975609756097561,198,0.3439024390243902,0.17317073170731706,0.48292682926829267
165,003,1630,67,404,179,1563,1630,1.0,0.041104294478527606,0.9588957055214724,1047,0.24785276073619633,0.1098159509202454,0.6423312883435582
166,003,1563,48,459,414,1515,1563,1.0,0.030710172744721688,0.9692898272552783,690,0.29366602687140114,0.2648752399232246,0.44145873320537427
167,003,44,2,11,30,42,44,1.0,0.045454545454545456,0.9545454545454546,3,0.25,0.6818181818181818,0.06818181818181818
168,003,1866,50,520,252,1816,1866,1.0,0.02679528403001072,0.9732047159699893,1094,0.27867095391211144,0.13504823151125403,0.5862808145766345
169,003,414,10,119,153,404,414,1.0,0.024154589371980676,0.9758454106280193,142,0.28743961352657005,0.3695652173913043,0.34299516908212563
171,003,2293,27,850,561,2266,2293,1.0,0.011774967291757523,0.9882250327082425,882,0.3706934147405146,0.24465765372873965,0.38464893153074575
172,003,958,32,287,194,926,958,1.0,0.033402922755741124,0.9665970772442589,477,0.29958246346555323,0.20250521920668058,0.4979123173277662
173,003,3405,62,841,360,3343,3405,1.0,0.018208516886930984,0.981791483113069,2204,0.24698972099853156,0.10572687224669604,0.6472834067547724
174,003,941,27,300,245,914,941,1.0,0.028692879914984058,0.971307120085016,396,0.3188097768331562,0.2603613177470776,0.4208289054197662
175,003,1847,32,538,201,1815,1847,1.0,0.017325392528424473,0.9826746074715755,1108,0.29128316188413644,0.10882512181916622,0.5998917162966974
176,003,1805,84,288,103,1721,1805,1.0,0.04653739612188366,0.9534626038781163,1414,0.1595567867036011,0.05706371191135734,0.7833795013850415
177,003,7,1,0,0,6,7,1.0,0.14285714285714285,0.8571428571428571,7,0.0,0.0,1.0
184,003,11,1,0,0,10,11,1.0,0.09090909090909091,0.9090909090909091,11,0.0,0.0,1.0
185,003,2,0,0,0,2,2,1.0,0.0,1.0,2,0.0,0.0,1.0
186,003,2,0,0,0,2,2,1.0,0.0,1.0,2,0.0,0.0,1.0
187,003,385,14,53,18,371,385,1.0,0.03636363636363636,0.9636363636363636,314,0.13766233766233765,0.046753246753246755,0.8155844155844156
188,003,31,1,0,0,30,31,1.0,0.03225806451612903,0.967741935483871,31,0.0,0.0,1.0
189,003,5,0,0,0,5,5,1.0,0.0,1.0,5,0.0,0.0,1.0
190,003,13,2,0,0,11,13,1.0,0.15384615384615385,0.8461538461538461,13,0.0,0.0,1.0
192,003,43,0,20,23,43,43,3.3076923076923075,0.0,1.0,0,0.46511627906976744,0.5348837209302325,0.0
194,003,8,0,0,0,8,8,1.0,0.0,1.0,8,0.0,0.0,1.0
200,003,292,4,98,59,288,292,1.0,0.0136986301369863,0.9863013698630136,135,0.3356164383561644,0.20205479452054795,0.4623287671232877
201,003,11,2,0,0,9,11,1.0,0.18181818181818182,0.8181818181818182,11,0.0,0.0,1.0
204,003,1930,61,739,469,1869,1930,1.0,0.031606217616580314,0.9683937823834197,722,0.3829015544041451,0.24300518134715027,0.37409326424870465
206,003,1895,79,489,240,1816,1895,1.0,0.041688654353562005,0.9583113456464379,1166,0.25804749340369393,0.1266490765171504,0.6153034300791557
207,003,1517,64,469,368,1453,1517,1.0,0.04218852999340804,0.957811470006592,680,0.3091628213579433,0.24258404746209625,0.44825313117996046
208,003,1775,62,543,713,1713,1775,1.0,0.03492957746478873,0.9650704225352112,519,0.3059154929577465,0.40169014084507043,0.2923943661971831
210,003,3554,147,650,367,3407,3554,1.0,0.0413618458075408,0.9586381541924592,2537,0.18289251547552055,0.10326392796848621,0.7138435565559933
211,003,1959,59,647,309,1900,1959,1.0,0.030117406840224605,0.9698825931597754,1003,0.3302705461970393,0.15773353751914243,0.5119959162838182
212,003,3827,98,1278,999,3729,3827,1.0,0.025607525476874837,0.9743924745231252,1550,0.33394303632087796,0.26103997909589755,0.40501698458322444
213,003,3605,74,1027,1200,3531,3605,1.0,0.020527045769764215,0.9794729542302358,1378,0.2848821081830791,0.332871012482663,0.382246879334258
214,003,4,0,0,0,4,4,1.0,0.0,1.0,4,0.0,0.0,1.0
215,003,1330,53,481,249,1277,1330,1.0,0.03984962406015038,0.9601503759398496,600,0.36165413533834584,0.18721804511278195,0.45112781954887216
217,003,1775,36,613,550,1739,1775,1.0,0.02028169014084507,0.979718309859155,612,0.3453521126760563,0.30985915492957744,0.3447887323943662
218,003,3494,121,858,553,3373,3494,1.0,0.03463079564968517,0.9653692043503148,2083,0.2455638236977676,0.15827132226674298,0.5961648540354894
219,003,2368,80,817,612,2288,2368,1.0,0.033783783783783786,0.9662162162162162,939,0.3450168918918919,0.25844594594594594,0.39653716216216217
220,003,1571,58,366,314,1513,1571,1.0,0.036919159770846595,0.9630808402291534,891,0.23297262889879058,0.19987269255251433,0.5671546785486951
222,003,892,34,239,444,858,892,1.0,0.03811659192825112,0.9618834080717489,209,0.2679372197309417,0.4977578475336323,0.23430493273542602
223,003,2723,34,915,1336,2689,2723,1.0,0.012486228424531766,0.9875137715754683,472,0.336026441424899,0.4906353286816012,0.1733382298934998
224,003,46,4,7,32,42,46,1.0,0.08695652173913043,0.9130434782608695,7,0.15217391304347827,0.6956521739130435,0.15217391304347827
225,003,612,18,187,22,594,612,1.0,0.029411764705882353,0.9705882352941176,403,0.3055555555555556,0.03594771241830065,0.6584967320261438
226,003,1261,27,353,624,1234,1261,1.0,0.02141157811260904,0.9785884218873909,284,0.27993655828707376,0.4948453608247423,0.22521808088818399
227,003,1221,11,487,548,1210,1221,1.0,0.009009009009009009,0.990990990990991,186,0.3988533988533989,0.4488124488124488,0.15233415233415235
229,003,2827,70,915,986,2757,2827,1.0,0.024761230986911922,0.975238769013088,926,0.323664662186063,0.3487796250442165,0.32755571276972056
230,003,1734,16,487,608,1718,1734,1.0,0.00922722029988466,0.9907727797001153,639,0.2808535178777393,0.3506343713956171,0.3685121107266436
231,003,2039,74,540,247,1965,2039,1.0,0.036292300147130946,0.9637076998528691,1252,0.26483570377636095,0.1211378126532614,0.6140264835703776
232,003,1419,44,476,431,1375,1419,1.0,0.031007751937984496,0.9689922480620154,512,0.3354474982381959,0.3037350246652572,0.3608174770965469
233,003,2366,76,499,146,2290,2366,1.0,0.032121724429416736,0.9678782755705833,1721,0.21090448013524937,0.06170752324598478,0.7273879966187659
234,003,3268,75,750,291,3193,3268,1.0,0.022949816401468787,0.9770501835985312,2227,0.2294981640146879,0.0890452876376989,0.6814565483476133
235,003,2289,68,627,228,2221,2289,1.0,0.029707295762341632,0.9702927042376583,1434,0.27391874180865006,0.09960681520314547,0.6264744429882044
236,003,2167,64,782,263,2103,2167,1.0,0.029533917858790955,0.970466082141209,1122,0.360867558837102,0.12136594370096908,0.5177664974619289
238,003,1892,53,634,957,1839,1892,1.0,0.028012684989429177,0.9719873150105708,301,0.33509513742071884,0.5058139534883721,0.1590909090909091
239,003,1174,32,355,494,1142,1174,1.0,0.027257240204429302,0.9727427597955707,325,0.3023850085178876,0.42078364565587734,0.2768313458262351
240,003,1423,45,353,396,1378,1423,1.0,0.03162333099086437,0.9683766690091357,674,0.24806746310611386,0.2782853127196065,0.4736472241742797
241,003,1528,45,381,356,1483,1528,1.0,0.029450261780104712,0.9705497382198953,791,0.2493455497382199,0.23298429319371727,0.5176701570680629
242,003,2278,43,417,161,2235,2278,1.0,0.01887620719929763,0.9811237928007024,1700,0.18305531167690958,0.07067603160667252,0.746268656716418
243,003,2804,68,927,354,2736,2804,1.0,0.024251069900142655,0.9757489300998573,1523,0.3305991440798859,0.1262482168330956,0.5431526390870185
244,003,872,23,271,94,849,872,1.0,0.026376146788990827,0.9736238532110092,507,0.31077981651376146,0.10779816513761468,0.5814220183486238
245,003,1820,34,570,471,1786,1820,1.0,0.01868131868131868,0.9813186813186813,779,0.3131868131868132,0.2587912087912088,0.428021978021978
246,003,1716,83,437,241,1633,1716,1.0,0.04836829836829837,0.9516317016317016,1038,0.25466200466200467,0.14044289044289043,0.6048951048951049
247,003,1377,32,468,461,1345,1377,1.0,0.023238925199709513,0.9767610748002905,448,0.33986928104575165,0.3347857661583152,0.3253449527959332
248,003,1822,40,527,338,1782,1822,1.0,0.021953896816684963,0.9780461031833151,957,0.2892425905598244,0.18551042810098792,0.5252469813391877
249,003,746,27,173,117,719,746,1.0,0.036193029490616625,0.9638069705093834,456,0.23190348525469168,0.15683646112600536,0.6112600536193029
250,003,2319,122,578,592,2197,2319,1.0,0.05260888313928418,0.9473911168607159,1149,0.2492453643811988,0.25528244933160843,0.49547218628719275
251,003,1080,26,404,272,1054,1080,1.0,0.024074074074074074,0.975925925925926,404,0.37407407407407406,0.2518518518518518,0.37407407407407406
253,003,942,22,310,380,920,942,1.0,0.02335456475583864,0.9766454352441614,252,0.32908704883227174,0.4033970276008493,0.267515923566879
254,003,1089,12,412,417,1077,1089,1.0,0.011019283746556474,0.9889807162534435,260,0.3783287419651056,0.38292011019283745,0.23875114784205692
255,003,20,3,0,0,17,20,1.0,0.15,0.85,20,0.0,0.0,1.0
257,003,910,24,288,467,886,910,1.0,0.026373626373626374,0.9736263736263736,155,0.31648351648351647,0.5131868131868131,0.17032967032967034
258,003,1855,40,485,276,1815,1855,1.0,0.0215633423180593,0.9784366576819407,1094,0.261455525606469,0.14878706199460917,0.5897574123989219
259,003,1086,22,421,401,1064,1086,1.0,0.020257826887661142,0.9797421731123389,264,0.3876611418047882,0.3692449355432781,0.2430939226519337
261,003,942,37,316,217,905,942,1.0,0.03927813163481953,0.9607218683651805,409,0.3354564755838641,0.23036093418259024,0.43418259023354566
262,003,3045,69,891,775,2976,3045,1.0,0.022660098522167486,0.9773399014778326,1379,0.29261083743842364,0.2545155993431856,0.4528735632183908
263,003,1670,79,681,284,1591,1670,1.0,0.04730538922155689,0.9526946107784431,705,0.40778443113772456,0.17005988023952096,0.4221556886227545
265,003,2285,92,675,230,2193,2285,1.0,0.04026258205689278,0.9597374179431072,1380,0.29540481400437635,0.10065645514223195,0.6039387308533917
266,003,1657,65,475,689,1592,1657,1.0,0.03922751961375981,0.9607724803862402,493,0.2866626433313217,0.415811707905854,0.2975256487628244
267,003,905,4,278,355,901,905,1.0,0.004419889502762431,0.9955801104972376,272,0.30718232044198895,0.39226519337016574,0.3005524861878453
268,003,41,1,6,20,40,41,1.0,0.024390243902439025,0.975609756097561,15,0.14634146341463414,0.4878048780487805,0.36585365853658536
269,003,1828,92,453,294,1736,1828,1.0,0.05032822757111598,0.949671772428884,1081,0.24781181619256018,0.16083150984682712,0.5913566739606126
270,003,1309,58,306,154,1251,1309,1.0,0.04430863254392666,0.9556913674560733,849,0.23376623376623376,0.11764705882352941,0.6485867074102368
271,003,1625,31,594,349,1594,1625,1.0,0.019076923076923078,0.9809230769230769,682,0.36553846153846153,0.21476923076923077,0.4196923076923077
272,003,3,2,0,0,1,3,1.0,0.6666666666666666,0.3333333333333333,3,0.0,0.0,1.0
273,003,399,15,109,116,384,399,1.0,0.03759398496240601,0.9624060150375939,174,0.2731829573934837,0.2907268170426065,0.43609022556390975
274,003,1951,60,556,515,1891,1951,1.0,0.030753459764223477,0.9692465402357765,880,0.2849820604818042,0.2639671963095848,0.451050743208611
275,003,1121,35,283,202,1086,1121,1.0,0.031222123104371096,0.9687778768956289,636,0.25245316681534347,0.1801962533452275,0.567350579839429
276,003,1806,70,480,282,1736,1806,1.0,0.03875968992248062,0.9612403100775194,1044,0.26578073089701,0.15614617940199335,0.5780730897009967
277,003,1098,26,517,261,1072,1098,1.0,0.023679417122040074,0.97632058287796,320,0.470856102003643,0.23770491803278687,0.29143897996357016
278,003,1512,40,556,237,1472,1512,1.0,0.026455026455026454,0.9735449735449735,719,0.36772486772486773,0.15674603174603174,0.4755291005291005
279,003,1620,51,425,204,1569,1620,1.0,0.03148148148148148,0.9685185185185186,991,0.2623456790123457,0.1259259259259259,0.6117283950617284
280,003,1287,62,337,193,1225,1287,1.0,0.048174048174048176,0.9518259518259519,757,0.2618492618492618,0.14996114996114995,0.5881895881895882
281,003,1578,52,477,343,1526,1578,1.0,0.032953105196451206,0.9670468948035488,758,0.30228136882129275,0.2173637515842839,0.4803548795944233
282,003,353,21,53,69,332,353,1.0,0.059490084985835696,0.9405099150141643,231,0.1501416430594901,0.1954674220963173,0.6543909348441926
283,003,1800,65,472,161,1735,1800,1.0,0.03611111111111111,0.9638888888888889,1167,0.26222222222222225,0.08944444444444444,0.6483333333333333
284,003,1197,30,406,384,1167,1197,1.0,0.02506265664160401,0.974937343358396,407,0.3391812865497076,0.3208020050125313,0.34001670843776105
286,003,4,0,0,0,4,4,1.0,0.0,1.0,4,0.0,0.0,1.0
288,003,1677,35,527,354,1642,1677,1.0,0.020870602265951103,0.979129397734049,796,0.31425163983303517,0.2110912343470483,0.47465712581991654
289,003,1802,17,546,526,1785,1802,1.0,0.009433962264150943,0.9905660377358491,730,0.3029966703662597,0.29189789123196447,0.4051054384017758
290,003,10,0,0,0,10,10,1.0,0.0,1.0,10,0.0,0.0,1.0
291,003,2050,54,606,432,1996,2050,1.0,0.026341463414634145,0.9736585365853658,1012,0.29560975609756096,0.21073170731707316,0.49365853658536585
292,003,1911,28,616,736,1883,1911,1.0,0.014652014652014652,0.9853479853479854,559,0.32234432234432236,0.38513867085295656,0.2925170068027211
293,003,2162,41,435,134,2121,2162,1.0,0.018963922294172063,0.9810360777058279,1593,0.20120259019426456,0.061979648473635525,0.7368177613320999
294,003,1753,71,502,880,1682,1753,1.0,0.040501996577296064,0.959498003422704,371,0.28636622932116373,0.5019965772960638,0.2116371933827724
295,003,1669,59,502,274,1610,1669,1.0,0.035350509286998205,0.9646494907130018,893,0.3007789095266627,0.16417016177351706,0.5350509286998203
296,003,1247,22,478,442,1225,1247,1.0,0.01764234161988773,0.9823576583801122,327,0.38331996792301526,0.35445068163592625,0.26222935044105855
297,003,2046,32,726,854,2014,2046,1.0,0.015640273704789834,0.9843597262952102,466,0.3548387096774194,0.4173998044965787,0.22776148582600195
298,003,1546,58,350,197,1488,1546,1.0,0.037516170763260026,0.96248382923674,999,0.22639068564036222,0.12742561448900389,0.6461836998706338
299,003,793,10,236,363,783,793,1.0,0.012610340479192938,0.987389659520807,194,0.29760403530895335,0.45775535939470363,0.244640605296343
300,003,2640,73,775,431,2567,2640,1.0,0.027651515151515153,0.9723484848484848,1434,0.2935606060606061,0.16325757575757577,0.5431818181818182
302,003,2108,88,551,126,2020,2108,1.0,0.04174573055028463,0.9582542694497154,1431,0.26138519924098674,0.05977229601518026,0.678842504743833
303,003,1323,40,385,471,1283,1323,1.0,0.030234315948601664,0.9697656840513983,467,0.291005291005291,0.35600907029478457,0.3529856386999244
304,003,1210,16,406,426,1194,1210,1.0,0.013223140495867768,0.9867768595041322,378,0.33553719008264465,0.35206611570247937,0.31239669421487604
305,003,1246,36,484,398,1210,1246,1.0,0.028892455858747994,0.971107544141252,364,0.3884430176565008,0.31942215088282505,0.29213483146067415
307,003,3072,95,1005,388,2977,3072,1.0,0.030924479166666668,0.9690755208333334,1679,0.3271484375,0.12630208333333334,0.5465494791666666
308,003,2325,68,670,1197,2257,2325,1.0,0.02924731182795699,0.970752688172043,458,0.28817204301075267,0.5148387096774194,0.19698924731182796
310,003,1809,44,550,412,1765,1809,1.0,0.024322830292979547,0.9756771697070205,847,0.30403537866224434,0.22775013819789938,0.46821448313985625
311,003,2948,111,802,301,2837,2948,1.0,0.03765264586160109,0.9623473541383989,1845,0.27204884667571233,0.10210312075983717,0.6258480325644504
312,003,1109,24,423,464,1085,1109,1.0,0.02164111812443643,0.9783588818755635,222,0.3814247069431921,0.41839495040577096,0.20018034265103696
313,003,579,18,131,41,561,579,1.0,0.031088082901554404,0.9689119170984456,407,0.22625215889464595,0.07081174438687392,0.7029360967184801
314,003,2370,102,737,432,2268,2370,1.0,0.043037974683544304,0.9569620253164557,1201,0.3109704641350211,0.18227848101265823,0.5067510548523206
315,003,1687,32,496,428,1655,1687,1.0,0.01896858328393598,0.981031416716064,763,0.2940130409010077,0.25370480142264373,0.45228215767634855
316,003,2265,64,823,472,2201,2265,1.0,0.0282560706401766,0.9717439293598233,970,0.363355408388521,0.20838852097130242,0.4282560706401766
317,003,2495,54,822,689,2441,2495,1.0,0.021643286573146292,0.9783567134268537,984,0.3294589178356713,0.2761523046092184,0.3943887775551102
318,003,1431,46,524,465,1385,1431,1.0,0.03214535290006988,0.9678546470999301,442,0.36617749825296997,0.3249475890985325,0.30887491264849753
319,003,1478,20,427,668,1458,1478,1.0,0.013531799729364006,0.986468200270636,383,0.2889039242219215,0.4519621109607578,0.2591339648173207
320,003,1567,42,503,563,1525,1567,1.0,0.026802807913209957,0.97319719208679,501,0.3209955328653478,0.35928525845564774,0.31971920867900444
321,003,2696,106,632,161,2590,2696,1.0,0.039317507418397624,0.9606824925816023,1903,0.2344213649851632,0.059718100890207716,0.7058605341246291
322,003,1177,19,489,494,1158,1177,1.0,0.016142735768903994,0.983857264231096,194,0.4154630416312659,0.41971112999150384,0.16482582837723025
323,003,249,6,63,128,243,249,1.0,0.024096385542168676,0.9759036144578314,58,0.25301204819277107,0.5140562248995983,0.23293172690763053
325,003,665,33,157,279,632,665,1.0,0.04962406015037594,0.9503759398496241,229,0.23609022556390977,0.4195488721804511,0.3443609022556391
326,003,1410,38,396,291,1372,1410,1.0,0.02695035460992908,0.9730496453900709,723,0.28085106382978725,0.20638297872340425,0.5127659574468085
327,003,1821,48,426,768,1773,1821,1.0,0.026359143327841845,0.9736408566721582,627,0.23393739703459637,0.42174629324546953,0.3443163097199341
328,003,1138,52,496,65,1086,1138,1.0,0.04569420035149385,0.9543057996485061,577,0.4358523725834798,0.05711775043936731,0.5070298769771528
329,003,1021,53,377,348,968,1021,1.0,0.05190989226248776,0.9480901077375122,296,0.3692458374142997,0.34084231145935356,0.2899118511263467
330,003,2117,60,602,381,2057,2117,1.0,0.02834199338686821,0.9716580066131318,1134,0.2843646669815777,0.17997165800661313,0.5356636750118091
331,003,843,28,445,262,815,843,1.0,0.033214709371293,0.966785290628707,136,0.527876631079478,0.3107947805456702,0.16132858837485173
332,003,2023,44,598,500,1979,2023,1.0,0.021749876421156698,0.9782501235788433,925,0.29560059317844783,0.24715768660405338,0.45724172021749876
333,003,197,7,45,116,190,197,1.0,0.03553299492385787,0.9644670050761421,36,0.22842639593908629,0.5888324873096447,0.18274111675126903
336,003,1386,40,427,485,1346,1386,1.0,0.02886002886002886,0.9711399711399712,474,0.30808080808080807,0.3499278499278499,0.341991341991342
337,003,727,14,194,187,713,727,1.0,0.01925722145804677,0.9807427785419532,346,0.2668500687757909,0.25722145804676755,0.4759284731774415
338,003,17,3,0,0,14,17,1.0,0.17647058823529413,0.8235294117647058,17,0.0,0.0,1.0
339,003,1196,22,373,378,1174,1196,1.0,0.01839464882943144,0.9816053511705686,445,0.31187290969899667,0.31605351170568563,0.3720735785953177
341,003,138,2,29,85,136,138,1.0,0.014492753623188406,0.9855072463768116,24,0.21014492753623187,0.6159420289855072,0.17391304347826086
342,003,849,12,256,166,837,849,1.0,0.014134275618374558,0.9858657243816255,427,0.30153121319199055,0.1955241460541814,0.502944640753828
343,003,1197,26,355,336,1171,1197,1.0,0.02172096908939014,0.9782790309106099,506,0.29657477025898077,0.2807017543859649,0.4227234753550543
345,003,1047,23,288,185,1024,1047,1.0,0.021967526265520534,0.9780324737344794,574,0.27507163323782235,0.1766953199617956,0.5482330468003821
346,003,127,1,44,54,126,127,1.0,0.007874015748031496,0.9921259842519685,29,0.3464566929133858,0.4251968503937008,0.2283464566929134
347,003,207,9,41,48,198,207,1.0,0.043478260869565216,0.9565217391304348,118,0.19806763285024154,0.2318840579710145,0.5700483091787439
348,003,9,0,0,0,9,9,1.0,0.0,1.0,9,0.0,0.0,1.0
349,003,2560,83,961,227,2477,2560,1.0,0.032421875,0.967578125,1372,0.375390625,0.088671875,0.5359375
350,003,1210,28,466,403,1182,1210,1.0,0.023140495867768594,0.9768595041322314,341,0.3851239669421488,0.3330578512396694,0.2818181818181818
351,003,3590,48,1051,1035,3542,3590,1.0,0.013370473537604457,0.9866295264623955,1504,0.2927576601671309,0.2883008356545961,0.41894150417827297
352,003,1601,37,532,585,1564,1601,1.0,0.0231105559025609,0.976889444097439,484,0.33229231730168646,0.3653966271080575,0.3023110555902561
353,003,2175,76,575,981,2099,2175,1.0,0.03494252873563218,0.9650574712643678,619,0.26436781609195403,0.4510344827586207,0.2845977011494253
354,003,2302,141,567,230,2161,2302,1.0,0.061251086012163336,0.9387489139878367,1505,0.2463075586446568,0.0999131190269331,0.6537793223284101
356,003,1934,60,623,548,1874,1934,1.0,0.031023784901758014,0.9689762150982419,763,0.32213029989658737,0.28335056876938985,0.3945191313340228
357,003,1192,51,336,140,1141,1192,1.0,0.04278523489932886,0.9572147651006712,716,0.28187919463087246,0.1174496644295302,0.6006711409395973
358,003,1731,42,618,567,1689,1731,1.0,0.024263431542461005,0.975736568457539,546,0.35701906412478335,0.3275563258232236,0.31542461005199307
359,003,23,4,0,0,19,23,1.0,0.17391304347826086,0.8260869565217391,23,0.0,0.0,1.0
360,003,914,21,239,121,893,914,1.0,0.022975929978118162,0.9770240700218819,554,0.2614879649890591,0.1323851203501094,0.6061269146608315
361,003,1441,13,516,710,1428,1441,1.0,0.009021512838306732,0.9909784871616932,215,0.35808466342817485,0.49271339347675225,0.14920194309507287
362,003,1269,41,258,160,1228,1269,1.0,0.03230890464933018,0.9676910953506698,851,0.2033096926713948,0.12608353033884948,0.6706067769897557
363,003,50,0,8,34,50,50,1.0,0.0,1.0,8,0.16,0.68,0.16
364,003,1721,66,521,420,1655,1721,1.0,0.03834979662986636,0.9616502033701336,780,0.3027309703660662,0.24404416037187682,0.45322486926205696
365,003,764,7,212,473,757,764,1.0,0.009162303664921465,0.9908376963350786,79,0.2774869109947644,0.6191099476439791,0.10340314136125654
367,003,1024,22,341,348,1002,1024,1.0,0.021484375,0.978515625,335,0.3330078125,0.33984375,0.3271484375
369,003,1746,53,598,703,1693,1746,1.0,0.030355097365406643,0.9696449026345934,445,0.3424971363115693,0.40263459335624285,0.25486827033218784
370,003,1523,30,495,272,1493,1523,1.0,0.01969796454366382,0.9803020354563362,756,0.325016414970453,0.17859487852921865,0.4963887065003283
371,003,2705,80,943,627,2625,2705,1.0,0.029574861367837338,0.9704251386321626,1135,0.34861367837338264,0.23179297597042514,0.4195933456561922
372,003,937,27,283,177,910,937,1.0,0.0288153681963714,0.9711846318036286,477,0.30202774813233724,0.18890074706510138,0.5090715048025614
373,003,1174,44,348,236,1130,1174,1.0,0.03747870528109029,0.9625212947189097,590,0.29642248722316866,0.2010221465076661,0.5025553662691652
374,003,1224,48,344,191,1176,1224,1.0,0.0392156862745098,0.9607843137254902,689,0.28104575163398693,0.15604575163398693,0.5629084967320261
375,003,2167,35,575,324,2132,2167,1.0,0.016151361329026302,0.9838486386709737,1268,0.265343793262575,0.1495154591601292,0.5851407475772958
377,003,2353,82,790,651,2271,2353,1.0,0.03484912877178071,0.9651508712282193,912,0.3357416064598385,0.27666808329791753,0.38759031024224394
378,003,1939,42,600,467,1897,1939,1.0,0.021660649819494584,0.9783393501805054,872,0.30943785456420836,0.2408457968024755,0.44971634863331617
379,003,77,0,29,18,77,77,1.0,0.0,1.0,30,0.37662337662337664,0.23376623376623376,0.38961038961038963
380,003,1844,23,620,592,1821,1844,1.0,0.012472885032537961,0.987527114967462,632,0.3362255965292842,0.3210412147505423,0.34273318872017355
381,003,2200,38,697,607,2162,2200,1.0,0.017272727272727273,0.9827272727272728,896,0.31681818181818183,0.2759090909090909,0.4072727272727273
382,003,806,17,269,290,789,806,1.0,0.02109181141439206,0.9789081885856079,247,0.3337468982630273,0.3598014888337469,0.3064516129032258
383,003,2082,73,541,303,2009,2082,1.0,0.03506243996157541,0.9649375600384246,1238,0.2598463016330452,0.14553314121037464,0.5946205571565802
387,003,1394,47,455,338,1347,1394,1.0,0.03371592539454806,0.966284074605452,601,0.32639885222381637,0.242467718794835,0.43113342898134865
388,003,1213,30,440,435,1183,1213,1.0,0.0247320692497939,0.9752679307502061,338,0.36273701566364386,0.3586150041220115,0.2786479802143446
389,003,925,33,261,201,892,925,1.0,0.03567567567567568,0.9643243243243244,463,0.28216216216216217,0.2172972972972973,0.5005405405405405
390,003,92,1,11,32,91,92,1.0,0.010869565217391304,0.9891304347826086,49,0.11956521739130435,0.34782608695652173,0.532608695652174
392,003,237,4,60,44,233,237,1.0,0.016877637130801686,0.9831223628691983,133,0.25316455696202533,0.18565400843881857,0.5611814345991561
393,003,398,19,65,37,379,398,1.0,0.04773869346733668,0.9522613065326633,296,0.16331658291457288,0.09296482412060302,0.7437185929648241
394,003,58,0,20,34,58,58,1.0,0.0,1.0,4,0.3448275862068966,0.5862068965517241,0.06896551724137931
395,003,3,0,0,0,3,3,1.0,0.0,1.0,3,0.0,0.0,1.0
397,003,7,0,0,0,7,7,1.0,0.0,1.0,7,0.0,0.0,1.0
398,003,668,12,147,44,656,668,1.0,0.017964071856287425,0.9820359281437125,477,0.22005988023952097,0.0658682634730539,0.7140718562874252
399,003,1,0,0,0,1,1,1.0,0.0,1.0,1,0.0,0.0,1.0
400,003,1177,23,464,386,1154,1177,1.0,0.01954120645709431,0.9804587935429057,327,0.39422259983007646,0.32795242141036535,0.2778249787595582
401,003,16,2,7,8,14,16,1.6666666666666667,0.125,0.875,1,0.4375,0.5,0.0625
402,003,196,4,51,138,192,196,1.0,0.02040816326530612,0.9795918367346939,7,0.2602040816326531,0.7040816326530612,0.03571428571428571
403,003,1,0,0,0,1,1,1.0,0.0,1.0,1,0.0,0.0,1.0
410,003,2614,64,801,681,2550,2614,1.0,0.02448355011476664,0.9755164498852333,1132,0.30642693190512627,0.2605202754399388,0.43305279265493496
411,003,1271,45,379,348,1226,1271,1.0,0.03540519276160504,0.964594807238395,544,0.2981904012588513,0.2738001573564123,0.42800944138473646
412,003,245,9,39,94,236,245,1.0,0.036734693877551024,0.963265306122449,112,0.15918367346938775,0.3836734693877551,0.45714285714285713
414,003,739,7,52,50,732,739,1.0,0.009472259810554804,0.9905277401894452,637,0.07036535859269283,0.06765899864682003,0.8619756427604871
415,003,1747,63,448,861,1684,1747,1.0,0.03606182026330853,0.9639381797366915,438,0.2564396107613051,0.4928448769318832,0.25071551230681166
416,003,1512,18,616,651,1494,1512,1.0,0.011904761904761904,0.9880952380952381,245,0.4074074074074074,0.4305555555555556,0.16203703703703703
417,003,4366,43,1757,1856,4323,4366,1.0,0.009848831882730188,0.9901511681172698,753,0.40242785158039396,0.42510306917086577,0.17246907924874028
418,003,700,41,72,24,659,700,1.0,0.05857142857142857,0.9414285714285714,604,0.10285714285714286,0.03428571428571429,0.8628571428571429
419,003,202,2,20,31,200,202,1.0,0.009900990099009901,0.9900990099009901,151,0.09900990099009901,0.15346534653465346,0.7475247524752475
420,003,2609,79,866,523,2530,2609,1.0,0.03027980068991951,0.9697201993100805,1220,0.3319279417401303,0.20045994633959371,0.46761211192027596
421,003,3451,129,907,444,3322,3451,1.0,0.03738046942915097,0.962619530570849,2100,0.2628223703274413,0.12865835989568242,0.6085192697768763
422,003,1988,82,718,326,1906,1988,1.0,0.04124748490945674,0.9587525150905433,944,0.3611670020120724,0.16398390342052313,0.47484909456740443
423,003,750,28,101,322,722,750,1.0,0.037333333333333336,0.9626666666666667,327,0.13466666666666666,0.42933333333333334,0.436
424,003,3227,76,812,411,3151,3227,1.0,0.023551286024171055,0.976448713975829,2004,0.25162689804772237,0.12736287573597768,0.6210102262163
425,003,714,14,240,281,700,714,1.0,0.0196078431372549,0.9803921568627451,193,0.33613445378151263,0.39355742296918766,0.2703081232492997
426,003,1649,27,188,938,1622,1649,1.0,0.01637355973317162,0.9836264402668283,523,0.11400848999393572,0.5688295936931473,0.3171619163129169
428,003,3157,50,735,1510,3107,3157,1.0,0.015837820715869498,0.9841621792841305,912,0.2328159645232816,0.4783021856192588,0.2888818498574596
429,003,3017,61,901,693,2956,3017,1.0,0.020218760357971495,0.9797812396420285,1423,0.29864103413987403,0.2296983758700696,0.47166058999005633
430,003,1197,25,245,666,1172,1197,1.0,0.020885547201336674,0.9791144527986633,286,0.2046783625730994,0.556390977443609,0.23893065998329155
431,003,1931,50,620,509,1881,1931,1.0,0.02589331952356292,0.9741066804764371,802,0.32107716209218023,0.26359399274987055,0.41532884515794927
432,003,2569,38,700,498,2531,2569,1.0,0.01479174776177501,0.985208252238225,1371,0.2724795640326976,0.19384974698326196,0.5336706889840405
433,003,1841,81,447,225,1760,1841,1.0,0.043997827267789245,0.9560021727322108,1169,0.242802824551874,0.12221618685497013,0.6349809885931559
434,003,1655,56,453,316,1599,1655,1.0,0.033836858006042296,0.9661631419939577,886,0.2737160120845921,0.19093655589123867,0.5353474320241692
435,003,1509,43,383,826,1466,1509,1.0,0.028495692511597084,0.9715043074884029,300,0.2538104705102717,0.5473823724320742,0.1988071570576541
436,003,1233,27,405,513,1206,1233,1.0,0.021897810218978103,0.9781021897810219,315,0.3284671532846715,0.41605839416058393,0.25547445255474455
437,003,1575,23,530,690,1552,1575,1.0,0.014603174603174604,0.9853968253968254,355,0.33650793650793653,0.4380952380952381,0.2253968253968254
438,003,2193,80,480,349,2113,2193,1.0,0.0364797081623347,0.9635202918376653,1364,0.2188782489740082,0.15914272685818515,0.6219790241678067
440,003,1876,49,695,495,1827,1876,1.0,0.026119402985074626,0.9738805970149254,686,0.3704690831556503,0.2638592750533049,0.3656716417910448
441,003,6,0,0,0,6,6,1.0,0.0,1.0,6,0.0,0.0,1.0
442,003,1138,5,364,318,1133,1138,1.0,0.004393673110720563,0.9956063268892794,456,0.31985940246045697,0.27943760984182775,0.4007029876977153
443,003,123,14,6,10,109,123,1.0,0.11382113821138211,0.8861788617886179,107,0.04878048780487805,0.08130081300813008,0.8699186991869918
444,003,1492,59,550,272,1433,1492,1.0,0.039544235924932974,0.960455764075067,670,0.36863270777479895,0.18230563002680966,0.44906166219839144
445,003,2191,65,612,293,2126,2191,1.0,0.029666818804198997,0.970333181195801,1286,0.27932450935645825,0.13372889091738932,0.5869465997261525
446,003,31,1,7,17,30,31,1.0,0.03225806451612903,0.967741935483871,7,0.22580645161290322,0.5483870967741935,0.22580645161290322
447,003,3150,61,826,405,3089,3150,1.0,0.019365079365079366,0.9806349206349206,1919,0.26222222222222225,0.12857142857142856,0.6092063492063492
448,003,1832,41,483,989,1791,1832,1.0,0.02237991266375546,0.9776200873362445,360,0.263646288209607,0.5398471615720524,0.1965065502183406
449,003,1471,21,461,507,1450,1471,1.0,0.014276002719238613,0.9857239972807614,503,0.3133922501699524,0.34466349422161796,0.3419442556084296
450,003,4619,59,1320,989,4560,4619,1.0,0.012773327560077938,0.987226672439922,2310,0.2857761420220827,0.21411560943927258,0.5001082485386448
451,003,1249,38,213,26,1211,1249,1.0,0.03042433947157726,0.9695756605284227,1010,0.17053642914331466,0.020816653322658127,0.8086469175340272
452,003,964,39,274,458,925,964,1.0,0.04045643153526971,0.9595435684647303,232,0.2842323651452282,0.475103734439834,0.24066390041493776
453,003,2645,50,849,782,2595,2645,1.0,0.01890359168241966,0.9810964083175804,1014,0.3209829867674858,0.2956521739130435,0.3833648393194707
454,003,2245,53,657,576,2192,2245,1.0,0.023608017817371936,0.976391982182628,1012,0.29265033407572383,0.25657015590200444,0.45077951002227173
455,003,3203,47,787,1653,3156,3203,1.0,0.014673743365594755,0.9853262566344052,763,0.2457071495472994,0.516078676241024,0.23821417421167657
456,003,1513,45,453,336,1468,1513,1.0,0.029742233972240583,0.9702577660277594,724,0.29940515532055517,0.22207534699272968,0.47851949768671515
459,003,2210,67,286,80,2143,2210,1.0,0.030316742081447964,0.969683257918552,1844,0.12941176470588237,0.03619909502262444,0.8343891402714932
460,003,6,1,0,0,5,6,1.0,0.16666666666666666,0.8333333333333334,6,0.0,0.0,1.0
461,003,5,0,0,0,5,5,1.0,0.0,1.0,5,0.0,0.0,1.0
463,003,925,29,285,266,896,925,1.0,0.03135135135135135,0.9686486486486486,374,0.3081081081081081,0.2875675675675676,0.4043243243243243
464,003,328,10,98,136,318,328,1.0,0.03048780487804878,0.9695121951219512,94,0.29878048780487804,0.4146341463414634,0.2865853658536585
466,003,363,0,155,93,363,363,1.0,0.0,1.0,115,0.42699724517906334,0.256198347107438,0.3168044077134986
467,003,768,19,274,186,749,768,1.0,0.024739583333333332,0.9752604166666666,308,0.3567708333333333,0.2421875,0.4010416666666667
468,003,68,4,27,30,64,68,1.0,0.058823529411764705,0.9411764705882353,11,0.39705882352941174,0.4411764705882353,0.16176470588235295
469,003,2532,89,787,376,2443,2532,1.0,0.03515007898894155,0.9648499210110585,1369,0.3108214849921011,0.1484992101105845,0.5406793048973144
470,003,762,27,211,243,735,762,1.0,0.03543307086614173,0.9645669291338582,308,0.2769028871391076,0.3188976377952756,0.4041994750656168
471,003,67,0,0,0,67,67,1.0,0.0,1.0,67,0.0,0.0,1.0
473,003,1862,55,642,684,1807,1862,1.0,0.02953813104189044,0.9704618689581096,536,0.3447905477980666,0.3673469387755102,0.2878625134264232
475,003,999,23,352,350,976,999,1.0,0.023023023023023025,0.9769769769769769,297,0.35235235235235235,0.35035035035035034,0.2972972972972973
476,003,1,1,0,0,0,1,1.0,1.0,0.0,1,0.0,0.0,1.0
477,003,1309,48,435,338,1261,1309,1.0,0.03666921313980138,0.9633307868601986,536,0.33231474407944994,0.2582123758594347,0.4094728800611154
478,003,30,3,6,20,27,30,1.0,0.1,0.9,4,0.2,0.6666666666666666,0.13333333333333333
479,003,665,27,164,372,638,665,1.0,0.0406015037593985,0.9593984962406015,129,0.24661654135338346,0.5593984962406015,0.19398496240601504
480,003,1532,29,516,382,1503,1532,1.0,0.018929503916449087,0.9810704960835509,634,0.3368146214099217,0.24934725848563968,0.41383812010443866
481,003,366,17,82,20,349,366,1.0,0.04644808743169399,0.953551912568306,264,0.22404371584699453,0.0546448087431694,0.7213114754098361
483,003,1424,70,387,196,1354,1424,1.0,0.04915730337078652,0.9508426966292135,841,0.2717696629213483,0.13764044943820225,0.5905898876404494
484,003,536,13,170,215,523,536,1.0,0.024253731343283583,0.9757462686567164,151,0.31716417910447764,0.40111940298507465,0.28171641791044777
485,003,857,12,283,256,845,857,1.0,0.014002333722287048,0.9859976662777129,318,0.33022170361726955,0.29871645274212366,0.3710618436406068
486,003,451,24,111,55,427,451,1.0,0.05321507760532151,0.9467849223946785,285,0.24611973392461198,0.12195121951219512,0.6319290465631929
487,003,1362,34,449,364,1328,1362,1.0,0.024963289280469897,0.9750367107195301,549,0.32966226138032306,0.26725403817914833,0.40308370044052866
488,003,1026,23,338,161,1003,1026,1.0,0.022417153996101363,0.9775828460038987,527,0.32943469785575047,0.15692007797270954,0.51364522417154
490,003,1,1,0,0,0,1,1.0,1.0,0.0,1,0.0,0.0,1.0
492,003,81,4,32,36,77,81,1.0,0.04938271604938271,0.9506172839506173,13,0.3950617283950617,0.4444444444444444,0.16049382716049382
495,003,7,0,0,0,7,7,1.0,0.0,1.0,7,0.0,0.0,1.0
496,003,3,1,0,0,2,3,1.0,0.3333333333333333,0.6666666666666666,3,0.0,0.0,1.0
497,003,4,0,0,0,4,4,1.0,0.0,1.0,4,0.0,0.0,1.0
499,003,320,1,104,49,319,320,1.0,0.003125,0.996875,167,0.325,0.153125,0.521875
500,003,14,0,6,8,14,14,1.2727272727272727,0.0,1.0,0,0.42857142857142855,0.5714285714285714,0.0
501,003,426,4,149,112,422,426,1.0,0.009389671361502348,0.9906103286384976,165,0.34976525821596244,0.26291079812206575,0.3873239436619718
502,003,311,4,167,110,307,311,1.0,0.012861736334405145,0.9871382636655949,34,0.5369774919614148,0.3536977491961415,0.10932475884244373
504,003,1698,35,483,483,1663,1698,1.0,0.02061248527679623,0.9793875147232037,732,0.284452296819788,0.284452296819788,0.43109540636042404
505,003,1081,9,402,434,1072,1081,1.0,0.008325624421831638,0.9916743755781684,245,0.37187789084181316,0.40148011100832565,0.22664199814986125
506,003,1414,64,290,122,1350,1414,1.0,0.04526166902404526,0.9547383309759547,1002,0.2050919377652051,0.08628005657708628,0.7086280056577087
507,003,1634,13,575,774,1621,1634,1.0,0.00795593635250918,0.9920440636474909,285,0.3518971848225214,0.47368421052631576,0.1744186046511628
508,003,570,28,126,206,542,570,1.0,0.04912280701754386,0.9508771929824561,238,0.22105263157894736,0.36140350877192984,0.41754385964912283
509,003,3439,91,1047,743,3348,3439,1.0,0.026461180575748765,0.9735388194242512,1649,0.30444896772317537,0.21605117766792672,0.47949985460889794
510,003,2171,76,440,161,2095,2171,1.0,0.035006909258406264,0.9649930907415938,1570,0.2026715799170889,0.07415937356057116,0.7231690465223399
512,003,2943,103,694,453,2840,2943,1.0,0.03499830105334693,0.9650016989466531,1796,0.23581379544682296,0.15392456676860347,0.6102616377845735
513,003,3193,92,916,657,3101,3193,1.0,0.028813028499843407,0.9711869715001565,1620,0.28687754462887566,0.20576260569996868,0.5073598496711557
514,003,2713,51,877,778,2662,2713,1.0,0.018798378179137487,0.9812016218208626,1058,0.3232583855510505,0.2867674161444895,0.38997419830446
515,003,979,58,350,112,921,979,1.0,0.059244126659857,0.940755873340143,517,0.3575076608784474,0.11440245148110317,0.5280898876404494
516,003,1790,59,506,298,1731,1790,1.0,0.0329608938547486,0.9670391061452513,986,0.28268156424581004,0.1664804469273743,0.5508379888268157
517,003,1593,58,468,228,1535,1593,1.0,0.03640929064657878,0.9635907093534212,897,0.2937853107344633,0.1431261770244821,0.5630885122410546
518,003,1417,47,397,648,1370,1417,1.0,0.033168666196189134,0.9668313338038109,372,0.2801693719124912,0.4573041637261821,0.26252646436132676
519,003,1769,40,569,520,1729,1769,1.0,0.022611644997173545,0.9773883550028265,680,0.32165065008479365,0.29395138496325607,0.3843979649519503
520,003,1678,55,504,511,1623,1678,1.0,0.032777115613825986,0.967222884386174,663,0.300357568533969,0.3045292014302741,0.3951132300357569
521,003,1703,87,600,411,1616,1703,1.0,0.05108631826189078,0.9489136817381092,692,0.35231943628890194,0.24133881385789782,0.40634174985320026
522,003,1233,70,277,205,1163,1233,1.0,0.05677210056772101,0.943227899432279,751,0.22465531224655313,0.16626115166261152,0.6090835360908353
523,003,2113,72,557,135,2041,2113,1.0,0.034074775201135825,0.9659252247988642,1421,0.2636062470421202,0.06389020350212968,0.6725035494557501
524,003,1609,49,490,686,1560,1609,1.0,0.030453697949036667,0.9695463020509634,433,0.3045369794903667,0.42635177128651336,0.26911124922311996
525,003,3544,119,803,300,3425,3544,1.0,0.03357787810383747,0.9664221218961625,2441,0.22658013544018057,0.08465011286681716,0.6887697516930023
526,003,1268,38,339,213,1230,1268,1.0,0.02996845425867508,0.9700315457413249,716,0.26735015772870663,0.16798107255520506,0.5646687697160884
527,003,1963,50,644,743,1913,1963,1.0,0.02547121752419766,0.9745287824758023,576,0.3280692817116658,0.37850229240957717,0.293428425878757
528,003,2105,42,654,464,2063,2105,1.0,0.019952494061757718,0.9800475059382423,987,0.3106888361045131,0.22042755344418052,0.4688836104513064
529,003,1928,42,629,544,1886,1928,1.0,0.021784232365145227,0.9782157676348547,755,0.3262448132780083,0.2821576763485477,0.391597510373444
530,003,1557,19,533,582,1538,1557,1.0,0.012202954399486191,0.9877970456005138,442,0.34232498394348104,0.3737957610789981,0.28387925497752087
531,003,1359,26,435,521,1333,1359,1.0,0.01913171449595291,0.9808682855040471,403,0.3200883002207506,0.3833701250919794,0.29654157468727005
532,003,3646,77,1669,1235,3569,3646,1.0,0.021119034558420187,0.9788809654415798,742,0.45776193088315964,0.33872737246297313,0.20351069665386726
533,003,1266,44,376,294,1222,1266,1.0,0.03475513428120063,0.9652448657187994,596,0.296998420221169,0.23222748815165878,0.4707740916271722
534,003,2303,64,743,908,2239,2303,1.0,0.027789839339991317,0.9722101606600086,652,0.3226226660877117,0.3942683456361268,0.28310898827616154
535,003,3134,137,821,180,2997,3134,1.0,0.0437141033822591,0.9562858966177409,2133,0.26196553924696875,0.0574345883854499,0.6805998723675813
537,003,2908,110,630,151,2798,2908,1.0,0.03782668500687758,0.9621733149931224,2127,0.21664374140302614,0.051925722145804674,0.7314305364511692
538,003,1555,62,295,96,1493,1555,1.0,0.03987138263665595,0.9601286173633441,1164,0.18971061093247588,0.06173633440514469,0.7485530546623794
539,003,1560,30,446,810,1530,1560,1.0,0.019230769230769232,0.9807692307692307,304,0.2858974358974359,0.5192307692307693,0.19487179487179487
541,003,1438,54,400,349,1384,1438,1.0,0.037552155771905425,0.9624478442280946,689,0.27816411682892905,0.2426981919332406,0.47913769123783034
542,003,3664,103,829,441,3561,3664,1.0,0.028111353711790393,0.9718886462882096,2394,0.22625545851528384,0.12036026200873362,0.6533842794759825
543,003,1382,58,406,284,1324,1382,1.0,0.041968162083936326,0.9580318379160637,692,0.2937771345875543,0.20549927641099855,0.5007235890014472
545,003,609,25,163,310,584,609,1.0,0.041050903119868636,0.9589490968801314,136,0.2676518883415435,0.5090311986863711,0.2233169129720854
546,003,1379,37,383,240,1342,1379,1.0,0.026831036983321246,0.9731689630166788,756,0.27773749093546046,0.17403915881073242,0.5482233502538071
549,003,2887,77,847,335,2810,2887,1.0,0.026671285071007966,0.973328714928992,1705,0.29338413578108763,0.11603740907516454,0.5905784551437478
550,003,1312,48,437,378,1264,1312,1.0,0.036585365853658534,0.9634146341463414,497,0.3330792682926829,0.28810975609756095,0.3788109756097561
551,003,1986,83,572,284,1903,1986,1.0,0.04179254783484391,0.9582074521651561,1130,0.2880161127895267,0.14300100704934543,0.5689828801611279
552,003,1293,18,516,402,1275,1293,1.0,0.013921113689095127,0.9860788863109049,375,0.3990719257540603,0.3109048723897912,0.2900232018561485
553,003,2904,110,801,624,2794,2904,1.0,0.03787878787878788,0.9621212121212122,1479,0.27582644628099173,0.21487603305785125,0.5092975206611571
554,003,1427,38,441,356,1389,1427,1.0,0.026629292221443588,0.9733707077785564,630,0.3090399439383322,0.24947442186405044,0.4414856341976174
555,003,1872,54,577,353,1818,1872,1.0,0.028846153846153848,0.9711538461538461,942,0.30822649572649574,0.18856837606837606,0.5032051282051282
556,003,1052,6,423,458,1046,1052,1.0,0.005703422053231939,0.9942965779467681,171,0.40209125475285173,0.435361216730038,0.16254752851711027
557,003,2713,101,522,185,2612,2713,1.0,0.03722816070770365,0.9627718392922964,2006,0.19240692959823075,0.0681901953556948,0.7394028750460745
558,003,1407,45,449,492,1362,1407,1.0,0.031982942430703626,0.9680170575692963,466,0.3191186922530206,0.34968017057569295,0.3312011371712864
559,003,1393,52,445,269,1341,1393,1.0,0.03732950466618808,0.9626704953338119,679,0.3194544149318019,0.19310839913854988,0.48743718592964824
560,003,2560,106,702,248,2454,2560,1.0,0.04140625,0.95859375,1610,0.27421875,0.096875,0.62890625
561,003,946,22,202,388,924,946,1.0,0.023255813953488372,0.9767441860465116,356,0.2135306553911205,0.41014799154334036,0.3763213530655391
562,003,1259,22,339,701,1237,1259,1.0,0.017474185861795076,0.982525814138205,219,0.2692613185067514,0.556791104050834,0.17394757744241462
563,003,1397,71,519,427,1326,1397,1.0,0.05082319255547602,0.9491768074445239,451,0.37151037938439513,0.30565497494631355,0.3228346456692913
564,003,1551,62,493,484,1489,1551,1.0,0.039974210186976146,0.9600257898130239,574,0.31785944551902,0.3120567375886525,0.37008381689232756
566,003,58,1,0,0,57,58,1.0,0.017241379310344827,0.9827586206896551,58,0.0,0.0,1.0
567,003,1770,66,420,144,1704,1770,1.0,0.03728813559322034,0.9627118644067797,1206,0.23728813559322035,0.08135593220338982,0.6813559322033899
568,003,5945,162,986,485,5783,5945,1.0,0.027249789739276702,0.9727502102607233,4474,0.16585365853658537,0.0815811606391926,0.7525651808242221
569,003,180,140,63,19,40,180,1.0,0.7777777777777778,0.2222222222222222,98,0.35,0.10555555555555556,0.5444444444444444
570,003,1292,6,516,599,1286,1292,1.0,0.0046439628482972135,0.9953560371517027,177,0.3993808049535604,0.46362229102167185,0.1369969040247678
571,003,2812,95,643,299,2717,2812,1.0,0.033783783783783786,0.9662162162162162,1870,0.2286628733997155,0.10633001422475107,0.6650071123755334
572,003,3026,100,543,212,2926,3026,1.0,0.03304692663582287,0.9669530733641771,2271,0.1794448116325182,0.07005948446794448,0.7504957038995373
573,003,2069,38,724,323,2031,2069,1.0,0.01836636056065732,0.9816336394393427,1022,0.3499275012083132,0.15611406476558723,0.49395843402609957
574,003,1677,91,533,355,1586,1677,1.0,0.05426356589147287,0.9457364341085271,789,0.3178294573643411,0.2116875372689326,0.47048300536672627
575,003,2481,104,477,297,2377,2481,1.0,0.04191858121725111,0.9580814187827489,1707,0.19226118500604594,0.11970979443772672,0.6880290205562273
576,003,33,0,2,24,33,33,1.0,0.0,1.0,7,0.06060606060606061,0.7272727272727273,0.21212121212121213
577,003,1476,43,336,844,1433,1476,1.0,0.029132791327913278,0.9708672086720868,296,0.22764227642276422,0.5718157181571816,0.2005420054200542
578,003,2517,56,855,831,2461,2517,1.0,0.022248708780294002,0.977751291219706,831,0.3396901072705602,0.3301549463647199,0.3301549463647199
579,003,2885,91,1104,503,2794,2885,1.0,0.03154246100519931,0.9684575389948007,1278,0.3826689774696707,0.17435008665511265,0.44298093587521664
580,003,1664,35,515,590,1629,1664,1.0,0.021033653846153848,0.9789663461538461,559,0.3094951923076923,0.3545673076923077,0.3359375
581,003,1909,71,567,295,1838,1909,1.0,0.03719224724986904,0.962807752750131,1047,0.2970141435306443,0.15453116815086432,0.5484546883184913
582,003,582,10,167,224,572,582,1.0,0.01718213058419244,0.9828178694158075,191,0.2869415807560137,0.3848797250859107,0.3281786941580756
584,003,1840,80,521,508,1760,1840,1.0,0.043478260869565216,0.9565217391304348,811,0.2831521739130435,0.27608695652173915,0.4407608695652174
585,003,44,2,12,22,42,44,1.0,0.045454545454545456,0.9545454545454546,10,0.2727272727272727,0.5,0.22727272727272727
586,003,2968,186,829,295,2782,2968,1.0,0.06266846361185983,0.9373315363881402,1844,0.27931266846361186,0.09939353099730458,0.6212938005390836
587,003,1128,51,121,71,1077,1128,1.0,0.04521276595744681,0.9547872340425532,936,0.10726950354609929,0.06294326241134751,0.8297872340425532
588,003,2470,85,506,172,2385,2470,1.0,0.03441295546558704,0.9655870445344129,1792,0.2048582995951417,0.06963562753036437,0.725506072874494
589,003,1832,48,565,888,1784,1832,1.0,0.026200873362445413,0.9737991266375546,379,0.3084061135371179,0.4847161572052402,0.20687772925764192
590,003,1400,30,460,251,1370,1400,1.0,0.02142857142857143,0.9785714285714285,689,0.32857142857142857,0.1792857142857143,0.49214285714285716
591,003,2276,85,645,382,2191,2276,1.0,0.03734622144112478,0.9626537785588752,1249,0.28339191564147626,0.1678383128295255,0.5487697715289982
592,003,1399,31,505,393,1368,1399,1.0,0.02215868477483917,0.9778413152251608,501,0.36097212294496067,0.2809149392423159,0.35811293781272335
593,003,2776,77,982,219,2699,2776,1.0,0.027737752161383286,0.9722622478386167,1575,0.3537463976945245,0.07889048991354466,0.5673631123919308
594,003,1926,47,687,263,1879,1926,1.0,0.024402907580477674,0.9755970924195223,976,0.35669781931464173,0.13655244029075805,0.5067497403946002
595,003,3776,129,859,314,3647,3776,1.0,0.03416313559322034,0.9658368644067796,2603,0.227489406779661,0.08315677966101695,0.689353813559322
596,003,1670,68,380,136,1602,1670,1.0,0.0407185628742515,0.9592814371257485,1154,0.2275449101796407,0.081437125748503,0.6910179640718563
597,003,1086,31,335,215,1055,1086,1.0,0.0285451197053407,0.9714548802946593,536,0.30847145488029465,0.19797421731123388,0.49355432780847147
598,003,13,1,1,11,12,13,1.0,0.07692307692307693,0.9230769230769231,1,0.07692307692307693,0.8461538461538461,0.07692307692307693
599,003,2217,40,747,589,2177,2217,1.0,0.018042399639152006,0.981957600360848,881,0.33694181326116374,0.2656743346865133,0.39738385205232296
600,003,1340,34,419,666,1306,1340,1.0,0.025373134328358207,0.9746268656716418,255,0.3126865671641791,0.49701492537313435,0.19029850746268656
601,003,2077,79,311,96,1998,2077,1.0,0.03803562831006259,0.9619643716899374,1670,0.14973519499277804,0.046220510351468465,0.8040442946557534
602,003,1026,15,331,584,1011,1026,1.0,0.014619883040935672,0.9853801169590644,111,0.3226120857699805,0.5692007797270955,0.10818713450292397
603,003,3619,140,987,277,3479,3619,1.0,0.03868471953578337,0.9613152804642167,2355,0.2727272727272727,0.07654048079579995,0.6507322464769273
604,003,1513,35,454,625,1478,1513,1.0,0.023132848645076007,0.976867151354924,434,0.30006609385327165,0.41308658294778583,0.2868473231989425
605,003,3088,60,914,858,3028,3088,1.0,0.019430051813471502,0.9805699481865285,1316,0.2959844559585492,0.2778497409326425,0.4261658031088083
606,003,2505,81,796,741,2424,2505,1.0,0.032335329341317366,0.9676646706586827,968,0.31776447105788425,0.2958083832335329,0.38642714570858283
607,003,2018,18,9,25,2000,2018,1.0,0.008919722497522299,0.9910802775024777,1984,0.0044598612487611496,0.012388503468780971,0.9831516352824579
608,003,3751,99,1162,1497,3652,3751,1.0,0.026392961876832845,0.9736070381231672,1092,0.3097840575846441,0.3990935750466542,0.2911223673687017
609,003,1151,13,465,306,1138,1151,1.0,0.011294526498696786,0.9887054735013032,380,0.40399652476107734,0.26585577758470896,0.3301476976542137
612,003,7,0,0,0,7,7,1.0,0.0,1.0,7,0.0,0.0,1.0
613,003,2282,71,620,274,2211,2282,1.0,0.031113058720420684,0.9688869412795793,1388,0.27169149868536374,0.1200701139351446,0.6082383873794917
614,003,1099,13,175,186,1086,1099,1.0,0.011828935395814377,0.9881710646041856,738,0.1592356687898089,0.16924476797088261,0.6715195632393085
615,003,4038,89,1575,1431,3949,4038,1.0,0.02204061416542843,0.9779593858345715,1032,0.3900445765230312,0.35438335809806837,0.2555720653789004
616,003,2711,64,627,242,2647,2711,1.0,0.023607524898561418,0.9763924751014386,1842,0.23127997049059387,0.08926595352268536,0.6794540759867208
617,003,4539,148,1446,771,4391,4539,1.0,0.03260630094734523,0.9673936990526548,2322,0.3185723727693325,0.16986120290812953,0.511566424322538
618,003,2215,122,385,183,2093,2215,1.0,0.055079006772009026,0.944920993227991,1647,0.17381489841986456,0.08261851015801354,0.7435665914221219
621,003,3229,97,569,229,3132,3229,1.0,0.030040260142458964,0.969959739857541,2431,0.17621554660885724,0.0709197894084856,0.7528646639826572
622,003,18,3,0,0,15,18,1.0,0.16666666666666666,0.8333333333333334,18,0.0,0.0,1.0
623,003,2487,73,651,186,2414,2487,1.0,0.029352633695215118,0.9706473663047849,1650,0.2617611580217129,0.07478890229191798,0.6634499396863691
625,003,3099,59,955,485,3040,3099,1.0,0.01903839948370442,0.9809616005162956,1659,0.30816392384640207,0.15650209745079058,0.5353339787028074
626,003,2,0,0,0,2,2,1.0,0.0,1.0,2,0.0,0.0,1.0
627,003,2156,72,431,229,2084,2156,1.0,0.03339517625231911,0.9666048237476809,1496,0.19990723562152132,0.1062152133580705,0.6938775510204082
628,003,1985,57,556,249,1928,1985,1.0,0.02871536523929471,0.9712846347607053,1180,0.2801007556675063,0.12544080604534005,0.5944584382871536
629,003,2,0,0,0,2,2,1.0,0.0,1.0,2,0.0,0.0,1.0
630,003,1574,67,448,294,1507,1574,1.0,0.042566709021601014,0.957433290978399,832,0.2846251588310038,0.18678526048284624,0.5285895806861499
631,003,4088,168,718,194,3920,4088,1.0,0.0410958904109589,0.958904109589041,3176,0.17563600782778865,0.0474559686888454,0.776908023483366
632,003,2402,47,955,925,2355,2402,1.0,0.019567027477102414,0.9804329725228976,522,0.39758534554537883,0.3850957535387177,0.21731890091590342
633,003,1889,48,641,728,1841,1889,1.0,0.02541026998411858,0.9745897300158815,520,0.3393329804129169,0.3853890947591318,0.27527792482795127
634,003,1137,37,351,314,1100,1137,1.0,0.032541776605101144,0.9674582233948988,472,0.3087071240105541,0.27616534740545295,0.415127528583993
635,003,1447,52,388,258,1395,1447,1.0,0.0359364201796821,0.9640635798203179,801,0.2681409813407049,0.17829993089149965,0.5535590877677954
636,003,2974,97,757,527,2877,2974,1.0,0.03261600537995965,0.9673839946200403,1690,0.25453934095494285,0.17720242098184263,0.5682582380632145
637,003,1724,56,542,496,1668,1724,1.0,0.03248259860788863,0.9675174013921114,686,0.314385150812065,0.2877030162412993,0.39791183294663574
638,003,1119,29,342,539,1090,1119,1.0,0.025915996425379804,0.9740840035746202,238,0.30563002680965146,0.48168007149240394,0.2126899016979446
639,003,836,24,311,289,812,836,1.0,0.028708133971291867,0.9712918660287081,236,0.37200956937799046,0.3456937799043062,0.2822966507177033
640,003,1104,29,246,649,1075,1104,1.0,0.026268115942028984,0.9737318840579711,209,0.22282608695652173,0.5878623188405797,0.18931159420289856
641,003,1609,14,644,782,1595,1609,1.0,0.00870105655686762,0.9912989434431324,183,0.4002486016159105,0.4860161591050342,0.11373523927905531
642,003,37,0,7,14,37,37,1.0,0.0,1.0,16,0.1891891891891892,0.3783783783783784,0.43243243243243246
643,003,3730,178,779,213,3552,3730,1.0,0.04772117962466488,0.9522788203753351,2738,0.20884718498659519,0.05710455764075067,0.7340482573726541
644,003,1692,35,470,998,1657,1692,1.0,0.020685579196217493,0.9793144208037825,224,0.2777777777777778,0.5898345153664303,0.13238770685579196
645,003,2485,26,792,790,2459,2485,1.0,0.010462776659959759,0.9895372233400402,903,0.3187122736418511,0.317907444668008,0.36338028169014086
646,003,637,15,225,174,622,637,1.0,0.023547880690737835,0.9764521193092621,238,0.3532182103610675,0.2731554160125589,0.37362637362637363
647,003,1277,48,334,184,1229,1277,1.0,0.037588097102584185,0.9624119028974158,759,0.2615505090054816,0.14408770555990602,0.5943617854346124
648,003,1536,46,582,413,1490,1536,1.0,0.029947916666666668,0.9700520833333334,541,0.37890625,0.2688802083333333,0.3522135416666667
649,003,1382,41,386,734,1341,1382,1.0,0.029667149059334298,0.9703328509406657,262,0.2793053545586107,0.5311143270622286,0.18958031837916064
650,003,1789,67,522,428,1722,1789,1.0,0.03745108999441028,0.9625489100055897,839,0.2917831190609279,0.23923979877026272,0.4689770821688094
651,003,1658,40,527,501,1618,1658,1.0,0.024125452352231604,0.9758745476477684,630,0.3178528347406514,0.30217129071170085,0.37997587454764775
652,003,3158,51,839,526,3107,3158,1.0,0.016149461684610514,0.9838505383153895,1793,0.2656744775174161,0.16656111462951234,0.5677644078530716
653,003,2263,62,760,526,2201,2263,1.0,0.0273972602739726,0.9726027397260274,977,0.33583738400353513,0.23243482103402563,0.43172779496243924
654,003,2217,88,540,165,2129,2217,1.0,0.03969327920613441,0.9603067207938656,1512,0.2435723951285521,0.07442489851150202,0.6820027063599459
655,003,1245,26,476,474,1219,1245,1.0,0.020883534136546186,0.9791164658634538,295,0.3823293172690763,0.38072289156626504,0.23694779116465864
657,003,1039,6,364,527,1033,1039,1.0,0.005774783445620789,0.9942252165543792,148,0.3503368623676612,0.507218479307026,0.1424446583253128
658,003,1479,23,442,563,1456,1479,1.0,0.01555104800540906,0.9844489519945909,474,0.2988505747126437,0.38066260987153483,0.3204868154158215
659,003,2714,85,652,430,2629,2714,1.0,0.03131908621960206,0.9686809137803979,1632,0.24023581429624172,0.1584377302873987,0.6013264554163597
660,003,1553,56,429,685,1497,1553,1.0,0.0360592401802962,0.9639407598197038,439,0.2762395363811977,0.44108177720540886,0.28267868641339344
661,003,3602,183,941,256,3419,3602,1.0,0.05080510827318157,0.9491948917268185,2405,0.26124375347029427,0.07107162687395892,0.6676846196557468
662,003,2496,75,845,729,2421,2496,1.0,0.030048076923076924,0.9699519230769231,922,0.3385416666666667,0.2920673076923077,0.36939102564102566
663,003,1253,41,332,252,1212,1253,1.0,0.03272146847565842,0.9672785315243416,669,0.2649640861931365,0.2011173184357542,0.5339185953711093
665,003,3869,61,1165,761,3808,3869,1.0,0.015766347893512535,0.9842336521064875,1943,0.30111139829413286,0.19669165158955804,0.5021969501163092
668,003,1368,31,493,487,1337,1368,1.0,0.02266081871345029,0.9773391812865497,388,0.3603801169590643,0.35599415204678364,0.28362573099415206
669,003,1361,58,451,353,1303,1361,1.0,0.0426157237325496,0.9573842762674504,557,0.331373989713446,0.25936811168258633,0.40925789860396766
670,003,1738,57,459,310,1681,1738,1.0,0.03279631760644419,0.9672036823935558,969,0.26409666283084005,0.17836593785960875,0.5575373993095513
671,003,1138,18,421,479,1120,1138,1.0,0.015817223198594025,0.984182776801406,238,0.36994727592267135,0.4209138840070299,0.20913884007029876
672,003,1784,32,591,553,1752,1784,1.0,0.017937219730941704,0.9820627802690582,640,0.3312780269058296,0.3099775784753363,0.35874439461883406
673,003,3458,101,1498,946,3357,3458,1.0,0.029207634470792367,0.9707923655292077,1014,0.4331983805668016,0.27356853672643144,0.2932330827067669
674,003,2416,68,810,464,2348,2416,1.0,0.028145695364238412,0.9718543046357616,1142,0.3352649006622517,0.19205298013245034,0.472682119205298
675,003,363,21,82,35,342,363,1.0,0.05785123966942149,0.9421487603305785,246,0.22589531680440772,0.09641873278236915,0.6776859504132231
677,003,2163,72,664,447,2091,2163,1.0,0.033287101248266296,0.9667128987517337,1052,0.3069810448451225,0.20665742024965325,0.4863615349052242
678,003,3892,110,594,304,3782,3892,1.0,0.02826310380267215,0.9717368961973278,2994,0.1526207605344296,0.07810894141829394,0.7692702980472764
679,003,2396,69,738,935,2327,2396,1.0,0.028797996661101836,0.9712020033388982,723,0.3080133555926544,0.3902337228714524,0.30175292153589317
680,003,1437,35,524,590,1402,1437,1.0,0.024356297842727904,0.9756437021572721,323,0.36464857341684065,0.41057759220598466,0.22477383437717466
681,003,1805,68,584,333,1737,1805,1.0,0.037673130193905814,0.9623268698060942,888,0.3235457063711911,0.18448753462603878,0.4919667590027701
682,003,19,3,0,0,16,19,1.0,0.15789473684210525,0.8421052631578947,19,0.0,0.0,1.0
683,003,22,1,9,6,21,22,1.0,0.045454545454545456,0.9545454545454546,7,0.4090909090909091,0.2727272727272727,0.3181818181818182
684,003,1348,34,364,219,1314,1348,1.0,0.025222551928783383,0.9747774480712166,765,0.27002967359050445,0.16246290801186944,0.5675074183976261
686,003,1938,56,525,324,1882,1938,1.0,0.02889576883384933,0.9711042311661506,1089,0.2708978328173375,0.16718266253869968,0.5619195046439629
687,003,1387,43,301,149,1344,1387,1.0,0.031002162941600575,0.9689978370583994,937,0.21701514059120403,0.10742609949531362,0.6755587599134824
688,003,1798,18,623,757,1780,1798,1.0,0.010011123470522803,0.9899888765294772,418,0.346496106785317,0.42102335928809786,0.2324805339265851
689,003,1321,54,306,762,1267,1321,1.0,0.0408781226343679,0.9591218773656321,253,0.23164269492808479,0.5768357305071915,0.19152157456472368
690,003,1700,63,551,406,1637,1700,1.0,0.03705882352941176,0.9629411764705882,743,0.3241176470588235,0.2388235294117647,0.4370588235294118
691,003,770,20,287,351,750,770,1.0,0.025974025974025976,0.974025974025974,132,0.37272727272727274,0.45584415584415583,0.17142857142857143
692,003,3101,68,933,227,3033,3101,1.0,0.021928410190261205,0.9780715898097387,1941,0.3008706868752015,0.07320219284101903,0.6259271202837794
693,003,2505,80,601,282,2425,2505,1.0,0.031936127744510975,0.9680638722554891,1622,0.23992015968063873,0.1125748502994012,0.6475049900199601
694,003,833,18,280,330,815,833,1.0,0.021608643457382955,0.978391356542617,223,0.33613445378151263,0.39615846338535415,0.26770708283313327
695,003,1950,44,665,395,1906,1950,1.0,0.022564102564102566,0.9774358974358974,890,0.34102564102564104,0.20256410256410257,0.4564102564102564
696,003,1375,30,349,81,1345,1375,1.0,0.02181818181818182,0.9781818181818182,945,0.25381818181818183,0.05890909090909091,0.6872727272727273
697,003,2723,102,764,282,2621,2723,1.0,0.0374586852735953,0.9625413147264047,1677,0.2805728975394785,0.10356224752111641,0.615864854939405
698,003,1244,19,341,302,1225,1244,1.0,0.01527331189710611,0.9847266881028939,601,0.2741157556270096,0.2427652733118971,0.48311897106109325
699,003,4046,140,712,349,3906,4046,1.0,0.03460207612456748,0.9653979238754326,2985,0.175976272862086,0.08625803262481463,0.7377656945130994
700,003,635,10,183,388,625,635,1.0,0.015748031496062992,0.984251968503937,64,0.28818897637795277,0.6110236220472441,0.10078740157480315
701,003,2055,86,662,731,1969,2055,1.0,0.04184914841849149,0.9581508515815085,662,0.3221411192214112,0.3557177615571776,0.3221411192214112
702,003,1374,63,432,335,1311,1374,1.0,0.04585152838427948,0.9541484716157205,607,0.314410480349345,0.2438136826783115,0.4417758369723435
703,003,1172,34,287,660,1138,1172,1.0,0.02901023890784983,0.9709897610921502,225,0.24488054607508533,0.5631399317406144,0.19197952218430034
704,003,2108,86,627,311,2022,2108,1.0,0.04079696394686907,0.959203036053131,1170,0.297438330170778,0.14753320683111953,0.5550284629981025
705,003,1724,58,521,235,1666,1724,1.0,0.033642691415313224,0.9663573085846868,968,0.30220417633410673,0.13631090487238978,0.5614849187935035
706,003,2167,35,682,496,2132,2167,1.0,0.016151361329026302,0.9838486386709737,989,0.3147208121827411,0.22888786340562992,0.456391324411629
707,003,1305,25,532,559,1280,1305,1.0,0.019157088122605363,0.9808429118773946,214,0.4076628352490421,0.42835249042145596,0.16398467432950192
708,003,2005,84,647,651,1921,2005,1.0,0.041895261845386535,0.9581047381546135,707,0.3226932668329177,0.32468827930174565,0.35261845386533663
709,003,2485,101,593,253,2384,2485,1.0,0.040643863179074445,0.9593561368209256,1639,0.2386317907444668,0.10181086519114688,0.6595573440643863
710,003,1909,46,584,511,1863,1909,1.0,0.024096385542168676,0.9759036144578314,814,0.30591932949188055,0.2676794133053955,0.4264012572027239
711,003,1160,23,347,448,1137,1160,1.0,0.019827586206896553,0.9801724137931035,365,0.2991379310344828,0.38620689655172413,0.3146551724137931
712,003,1388,54,335,665,1334,1388,1.0,0.03890489913544669,0.9610951008645533,388,0.2413544668587896,0.47910662824207495,0.27953890489913547
713,003,3618,100,945,449,3518,3618,1.0,0.027639579878385848,0.9723604201216142,2224,0.26119402985074625,0.12410171365395246,0.6147042564953012
714,003,1738,43,590,327,1695,1738,1.0,0.02474108170310702,0.9752589182968929,821,0.3394706559263521,0.18814729574223246,0.4723820483314154
715,003,2736,125,808,497,2611,2736,1.0,0.04568713450292398,0.9543128654970761,1431,0.2953216374269006,0.18165204678362573,0.5230263157894737
716,003,2242,82,658,460,2160,2242,1.0,0.036574487065120426,0.9634255129348795,1124,0.29348795718108833,0.20517395182872436,0.5013380909901873
717,003,2810,34,861,555,2776,2810,1.0,0.012099644128113879,0.9879003558718861,1394,0.3064056939501779,0.19750889679715303,0.49608540925266903
718,003,2580,87,672,383,2493,2580,1.0,0.03372093023255814,0.9662790697674418,1525,0.26046511627906976,0.14844961240310078,0.5910852713178295
720,003,1760,60,341,841,1700,1760,1.0,0.03409090909090909,0.9659090909090909,578,0.19375,0.4778409090909091,0.32840909090909093
721,003,1225,34,449,456,1191,1225,1.0,0.027755102040816326,0.9722448979591837,320,0.36653061224489797,0.3722448979591837,0.2612244897959184
723,003,829,26,338,278,803,829,1.0,0.031363088057901084,0.9686369119420989,213,0.4077201447527141,0.3353437876960193,0.2569360675512666
724,003,983,14,373,486,969,983,1.0,0.014242115971515769,0.9857578840284842,124,0.37945066124109866,0.49440488301119023,0.12614445574771108
725,003,463,32,86,24,431,463,1.0,0.06911447084233262,0.9308855291576674,353,0.1857451403887689,0.05183585313174946,0.7624190064794817
726,003,725,12,279,256,713,725,1.0,0.016551724137931035,0.983448275862069,190,0.38482758620689655,0.35310344827586204,0.2620689655172414
727,003,2221,122,461,199,2099,2221,1.0,0.054930211616389016,0.945069788383611,1561,0.2075641602881585,0.08959927960378208,0.7028365601080594
728,003,749,10,251,317,739,749,1.0,0.01335113484646195,0.986648865153538,181,0.33511348464619495,0.4232309746328438,0.2416555407209613
729,003,2989,119,967,441,2870,2989,1.0,0.03981264637002342,0.9601873536299765,1581,0.3235195717631315,0.14754098360655737,0.5289394446303112
730,003,1287,46,373,226,1241,1287,1.0,0.035742035742035744,0.9642579642579643,688,0.2898212898212898,0.17560217560217561,0.5345765345765345
731,003,1358,46,133,84,1312,1358,1.0,0.033873343151693665,0.9661266568483063,1141,0.0979381443298969,0.061855670103092786,0.8402061855670103
732,003,1916,56,454,164,1860,1916,1.0,0.029227557411273485,0.9707724425887265,1298,0.23695198329853862,0.08559498956158663,0.6774530271398748
733,003,1496,24,508,593,1472,1496,1.0,0.016042780748663103,0.983957219251337,395,0.339572192513369,0.3963903743315508,0.2640374331550802
734,003,1138,9,479,528,1129,1138,1.0,0.007908611599297012,0.992091388400703,131,0.4209138840070299,0.46397188049209137,0.11511423550087874
735,003,2448,34,659,643,2414,2448,1.0,0.013888888888888888,0.9861111111111112,1146,0.26919934640522875,0.26266339869281047,0.4681372549019608
737,003,1772,76,461,458,1696,1772,1.0,0.04288939051918736,0.9571106094808126,853,0.2601580135440181,0.2584650112866817,0.4813769751693002
738,003,1530,41,423,362,1489,1530,1.0,0.02679738562091503,0.973202614379085,745,0.27647058823529413,0.23660130718954248,0.4869281045751634
740,003,768,12,275,389,756,768,1.0,0.015625,0.984375,104,0.3580729166666667,0.5065104166666666,0.13541666666666666
741,003,1340,28,380,541,1312,1340,1.0,0.020895522388059702,0.9791044776119403,419,0.2835820895522388,0.40373134328358207,0.3126865671641791
742,003,1470,52,580,109,1418,1470,1.0,0.03537414965986395,0.964625850340136,781,0.3945578231292517,0.07414965986394557,0.5312925170068027
743,003,833,20,299,228,813,833,1.0,0.024009603841536616,0.9759903961584634,306,0.3589435774309724,0.2737094837935174,0.3673469387755102
744,003,1836,52,646,395,1784,1836,1.0,0.02832244008714597,0.971677559912854,795,0.35185185185185186,0.21514161220043573,0.43300653594771243
745,003,1293,20,384,549,1273,1293,1.0,0.015467904098994586,0.9845320959010054,360,0.29698375870069604,0.4245939675174014,0.27842227378190254
746,003,2728,58,959,1173,2670,2728,1.0,0.02126099706744868,0.9787390029325513,596,0.35153958944281527,0.42998533724340177,0.218475073313783
747,003,1542,37,537,468,1505,1542,1.0,0.023994811932555125,0.9760051880674449,537,0.34824902723735407,0.3035019455252918,0.34824902723735407
748,003,1752,44,529,378,1708,1752,1.0,0.02511415525114155,0.9748858447488584,845,0.3019406392694064,0.21575342465753425,0.4823059360730594
749,003,1824,96,502,351,1728,1824,1.0,0.05263157894736842,0.9473684210526315,971,0.27521929824561403,0.1924342105263158,0.5323464912280702
750,003,2570,41,579,301,2529,2570,1.0,0.015953307392996108,0.9840466926070038,1690,0.22529182879377432,0.11712062256809339,0.6575875486381323
751,003,2274,63,458,233,2211,2274,1.0,0.027704485488126648,0.9722955145118733,1583,0.20140721196130168,0.10246262093227793,0.6961301671064204
752,003,1604,53,348,179,1551,1604,1.0,0.033042394014962596,0.9669576059850374,1077,0.2169576059850374,0.11159600997506235,0.6714463840399002
753,003,1953,52,617,624,1901,1953,1.0,0.026625704045058884,0.9733742959549411,712,0.3159242191500256,0.3195084485407066,0.3645673323092678
754,003,1434,46,389,663,1388,1434,1.0,0.03207810320781032,0.9679218967921897,382,0.2712691771269177,0.46234309623430964,0.26638772663877264
755,003,1751,48,555,705,1703,1751,1.0,0.02741290691033695,0.9725870930896631,491,0.316961736150771,0.402627070245574,0.2804111936036551
756,003,2322,88,710,372,2234,2322,1.0,0.03789836347975883,0.9621016365202412,1240,0.305770887166236,0.16020671834625322,0.5340223944875108
757,003,2816,69,819,462,2747,2816,1.0,0.024502840909090908,0.9754971590909091,1535,0.2908380681818182,0.1640625,0.5450994318181818
758,003,2319,75,793,720,2244,2319,1.0,0.03234152652005175,0.9676584734799483,806,0.34195774040534715,0.31047865459249674,0.3475636050021561
759,003,1837,27,688,644,1810,1837,1.0,0.014697876973326075,0.985302123026674,505,0.3745236799129015,0.3505715841045182,0.2749047359825803
760,003,252,9,71,143,243,252,1.0,0.03571428571428571,0.9642857142857143,38,0.28174603174603174,0.5674603174603174,0.15079365079365079
761,003,5880,100,355,88,5780,5880,1.0,0.017006802721088437,0.9829931972789115,5437,0.06037414965986394,0.014965986394557823,0.9246598639455782
762,003,1187,35,339,282,1152,1187,1.0,0.02948609941027801,0.970513900589722,566,0.2855939342881213,0.2375737152485257,0.476832350463353
763,003,3511,107,1090,610,3404,3511,1.0,0.03047564796354315,0.9695243520364568,1811,0.3104528624323555,0.17373967530618056,0.515807462261464
764,003,1895,62,626,381,1833,1895,1.0,0.03271767810026385,0.9672823218997362,888,0.33034300791556725,0.20105540897097626,0.46860158311345645
765,003,1810,20,497,953,1790,1810,1.0,0.011049723756906077,0.988950276243094,360,0.274585635359116,0.5265193370165746,0.19889502762430938
766,003,1152,36,517,95,1116,1152,1.0,0.03125,0.96875,540,0.4487847222222222,0.08246527777777778,0.46875
767,003,1471,47,503,479,1424,1471,1.0,0.03195105370496261,0.9680489462950373,489,0.3419442556084296,0.3256288239292998,0.33242692046227057
768,003,748,7,311,330,741,748,1.0,0.009358288770053475,0.9906417112299465,107,0.4157754010695187,0.4411764705882353,0.14304812834224598
769,003,2250,71,431,188,2179,2250,1.0,0.03155555555555556,0.9684444444444444,1631,0.19155555555555556,0.08355555555555555,0.7248888888888889
770,003,2342,114,517,253,2228,2342,1.0,0.04867634500426986,0.9513236549957301,1572,0.22075149444918873,0.10802732707087959,0.6712211784799317
771,003,2997,47,1069,563,2950,2997,1.0,0.01568234901568235,0.9843176509843177,1365,0.35669002335669003,0.18785452118785453,0.45545545545545546
772,003,21,0,0,0,21,21,1.0,0.0,1.0,21,0.0,0.0,1.0
773,003,1438,55,269,78,1383,1438,1.0,0.03824756606397774,0.9617524339360223,1091,0.1870653685674548,0.054242002781641166,0.758692628650904
774,003,1534,65,475,541,1469,1534,1.0,0.0423728813559322,0.9576271186440678,518,0.30964797913950454,0.35267275097783574,0.3376792698826597
775,003,3331,52,1155,422,3279,3331,1.0,0.015610927649354548,0.9843890723506454,1754,0.34674271990393274,0.1266886820774542,0.526568598018613
776,003,1940,54,544,153,1886,1940,1.0,0.027835051546391754,0.9721649484536082,1243,0.2804123711340206,0.0788659793814433,0.6407216494845361
777,003,396,18,118,156,378,396,1.0,0.045454545454545456,0.9545454545454546,122,0.29797979797979796,0.3939393939393939,0.30808080808080807
778,003,339,20,86,154,319,339,1.0,0.058997050147492625,0.9410029498525073,99,0.2536873156342183,0.45427728613569324,0.2920353982300885
780,003,18,2,0,0,16,18,1.0,0.1111111111111111,0.8888888888888888,18,0.0,0.0,1.0
782,003,204,11,56,90,193,204,1.0,0.05392156862745098,0.946078431372549,58,0.27450980392156865,0.4411764705882353,0.28431372549019607
783,003,2312,58,737,568,2254,2312,1.0,0.025086505190311418,0.9749134948096886,1007,0.3187716262975779,0.24567474048442905,0.43555363321799306
784,003,61,5,15,6,56,61,1.0,0.08196721311475409,0.9180327868852459,40,0.2459016393442623,0.09836065573770492,0.6557377049180327
785,003,34,1,8,22,33,34,1.0,0.029411764705882353,0.9705882352941176,4,0.23529411764705882,0.6470588235294118,0.11764705882352941
786,003,172,6,59,20,166,172,1.0,0.03488372093023256,0.9651162790697675,93,0.3430232558139535,0.11627906976744186,0.5406976744186046
787,003,1423,37,373,292,1386,1423,1.0,0.02600140548137737,0.9739985945186226,758,0.26212227687983136,0.20520028109627547,0.5326774420238932
788,003,55,0,23,23,55,55,1.0,0.0,1.0,9,0.41818181818181815,0.41818181818181815,0.16363636363636364
789,003,1888,13,545,404,1875,1888,1.0,0.006885593220338983,0.993114406779661,939,0.2886652542372881,0.21398305084745764,0.4973516949152542
790,003,3,0,0,0,3,3,1.0,0.0,1.0,3,0.0,0.0,1.0
791,003,2146,71,639,437,2075,2146,1.0,0.03308480894687791,0.9669151910531221,1070,0.2977632805219012,0.20363466915191053,0.49860205032618826
792,003,4742,104,1184,472,4638,4742,1.0,0.021931674398987768,0.9780683256010122,3086,0.24968367777309153,0.09953606073386756,0.6507802614930409
793,003,3193,111,1068,914,3082,3193,1.0,0.03476354525524585,0.9652364547447542,1211,0.3344816786720952,0.2862511744440965,0.3792671468838083
794,003,2288,54,690,575,2234,2288,1.0,0.0236013986013986,0.9763986013986014,1023,0.30157342657342656,0.2513111888111888,0.44711538461538464
795,003,1062,10,448,407,1052,1062,1.0,0.009416195856873822,0.9905838041431262,207,0.4218455743879473,0.3832391713747646,0.19491525423728814
796,003,1322,33,476,497,1289,1322,1.0,0.024962178517397883,0.9750378214826021,349,0.3600605143721634,0.37594553706505296,0.2639939485627837
797,003,3055,101,1087,482,2954,3055,1.0,0.033060556464811784,0.9669394435351882,1486,0.355810147299509,0.15777414075286417,0.48641571194762684
798,003,91,0,20,52,91,91,1.0,0.0,1.0,19,0.21978021978021978,0.5714285714285714,0.2087912087912088
799,003,782,27,212,304,755,782,1.0,0.034526854219948847,0.9654731457800512,266,0.2710997442455243,0.3887468030690537,0.340153452685422
800,003,1570,39,514,442,1531,1570,1.0,0.024840764331210193,0.9751592356687898,614,0.3273885350318471,0.28152866242038216,0.3910828025477707
801,003,1855,56,663,582,1799,1855,1.0,0.03018867924528302,0.969811320754717,610,0.3574123989218329,0.3137466307277628,0.3288409703504043
802,003,2787,88,751,363,2699,2787,1.0,0.03157517043415859,0.9684248295658414,1673,0.2694653749551489,0.1302475780409042,0.6002870470039469
803,003,1964,51,559,735,1913,1964,1.0,0.025967413441955193,0.9740325865580448,670,0.2846232179226069,0.3742362525458248,0.3411405295315682
804,003,3084,108,646,264,2976,3084,1.0,0.03501945525291829,0.9649805447470817,2174,0.20946822308690013,0.08560311284046693,0.704928664072633
805,003,4096,136,914,327,3960,4096,1.0,0.033203125,0.966796875,2855,0.22314453125,0.079833984375,0.697021484375
806,003,1232,10,439,354,1222,1232,1.0,0.008116883116883116,0.9918831168831169,439,0.35633116883116883,0.28733766233766234,0.35633116883116883
807,003,790,20,309,206,770,790,1.0,0.02531645569620253,0.9746835443037974,275,0.3911392405063291,0.2607594936708861,0.34810126582278483
808,003,2079,65,618,332,2014,2079,1.0,0.031265031265031266,0.9687349687349688,1129,0.2972582972582973,0.1596921596921597,0.543049543049543
809,003,1771,74,562,379,1697,1771,1.0,0.04178430265386787,0.9582156973461321,830,0.31733483907396953,0.2140033879164314,0.4686617730095991
810,003,1184,29,278,684,1155,1184,1.0,0.024493243243243243,0.9755067567567568,222,0.23479729729729729,0.5777027027027027,0.1875
811,003,2973,63,854,746,2910,2973,1.0,0.02119071644803229,0.9788092835519677,1373,0.2872519340733266,0.2509249915909855,0.46182307433568787
812,003,2281,80,554,514,2201,2281,1.0,0.035072336694432264,0.9649276633055678,1213,0.24287593160894344,0.2253397632617273,0.5317843051293293
813,003,1483,21,399,541,1462,1483,1.0,0.014160485502360081,0.98583951449764,543,0.26904922454484154,0.3648010788941335,0.366149696561025
814,003,1813,88,525,257,1725,1813,1.0,0.04853833425261997,0.95146166574738,1031,0.28957528957528955,0.14175399889685603,0.5686707115278544
816,003,710,19,184,234,691,710,1.0,0.02676056338028169,0.9732394366197183,292,0.2591549295774648,0.3295774647887324,0.4112676056338028
817,003,1504,35,641,406,1469,1504,1.0,0.02327127659574468,0.9767287234042553,457,0.4261968085106383,0.2699468085106383,0.3038563829787234
818,003,2211,48,742,536,2163,2211,1.0,0.021709633649932156,0.9782903663500678,933,0.3355947535052013,0.24242424242424243,0.42198100407055633
819,003,1660,65,491,323,1595,1660,1.0,0.0391566265060241,0.9608433734939759,846,0.2957831325301205,0.19457831325301206,0.5096385542168674
820,003,1155,19,253,93,1136,1155,1.0,0.01645021645021645,0.9835497835497835,809,0.21904761904761905,0.08051948051948052,0.7004329004329004
821,003,2045,48,697,903,1997,2045,1.0,0.0234718826405868,0.9765281173594133,445,0.3408312958435208,0.4415647921760391,0.2176039119804401
822,003,4088,153,1035,311,3935,4088,1.0,0.037426614481409,0.962573385518591,2742,0.25318003913894327,0.07607632093933464,0.6707436399217221
823,003,1624,57,456,487,1567,1624,1.0,0.035098522167487683,0.9649014778325123,681,0.28078817733990147,0.2998768472906404,0.41933497536945813
824,003,2424,104,847,448,2320,2424,1.0,0.0429042904290429,0.9570957095709571,1129,0.3494224422442244,0.1848184818481848,0.46575907590759075
825,003,3497,83,716,1094,3414,3497,1.0,0.023734629682585072,0.9762653703174149,1687,0.20474692593651703,0.3128395767800972,0.4824134972833858
826,003,1501,45,459,450,1456,1501,1.0,0.029980013324450366,0.9700199866755497,592,0.30579613590939375,0.29980013324450366,0.3944037308461026
827,003,1894,55,664,344,1839,1894,1.0,0.02903907074973601,0.970960929250264,886,0.3505807814149947,0.1816261879619852,0.4677930306230201
828,003,1430,48,474,407,1382,1430,1.0,0.033566433566433566,0.9664335664335665,549,0.33146853146853145,0.2846153846153846,0.3839160839160839
829,003,1843,36,508,470,1807,1843,1.0,0.019533369506239826,0.9804666304937601,865,0.27563754747693975,0.25501899077590884,0.46934346174715136
830,003,1058,10,369,552,1048,1058,1.0,0.00945179584120983,0.9905482041587902,137,0.3487712665406427,0.5217391304347826,0.12948960302457466
831,003,1292,9,469,662,1283,1292,1.0,0.00696594427244582,0.9930340557275542,161,0.36300309597523217,0.5123839009287926,0.12461300309597523
832,003,1295,47,384,674,1248,1295,1.0,0.036293436293436294,0.9637065637065637,237,0.2965250965250965,0.5204633204633204,0.18301158301158302
833,003,2408,64,705,457,2344,2408,1.0,0.026578073089700997,0.973421926910299,1246,0.29277408637873753,0.1897840531561462,0.5174418604651163
834,003,1775,27,449,370,1748,1775,1.0,0.015211267605633802,0.9847887323943662,956,0.25295774647887326,0.2084507042253521,0.5385915492957747
835,003,1219,16,367,462,1203,1219,1.0,0.013125512715340444,0.9868744872846595,390,0.3010664479081214,0.37899917965545526,0.3199343724364233
836,003,2234,69,860,439,2165,2234,1.0,0.03088630259623993,0.9691136974037601,935,0.38495971351835273,0.19650850492390332,0.41853178155774395
837,003,1806,54,595,619,1752,1806,1.0,0.029900332225913623,0.9700996677740864,592,0.32945736434108525,0.3427464008859358,0.327796234772979
838,003,3567,134,580,279,3433,3567,1.0,0.03756658256237735,0.9624334174376227,2708,0.16260162601626016,0.0782169890664424,0.7591813849172975
839,003,1965,31,687,733,1934,1965,1.0,0.015776081424936386,0.9842239185750636,545,0.34961832061068704,0.37302798982188295,0.27735368956743
840,003,3014,110,492,148,2904,3014,1.0,0.0364963503649635,0.9635036496350365,2374,0.16323822163238222,0.0491041804910418,0.787657597876576
841,003,1336,51,477,324,1285,1336,1.0,0.03817365269461078,0.9618263473053892,535,0.3570359281437126,0.24251497005988024,0.4004491017964072
842,003,2165,34,483,196,2131,2165,1.0,0.015704387990762125,0.9842956120092379,1486,0.223094688221709,0.09053117782909931,0.6863741339491917
844,003,604,30,179,164,574,604,1.0,0.04966887417218543,0.9503311258278145,261,0.29635761589403975,0.271523178807947,0.43211920529801323
845,003,447,7,55,38,440,447,1.0,0.015659955257270694,0.9843400447427293,354,0.12304250559284116,0.08501118568232663,0.7919463087248322
846,003,1989,69,546,916,1920,1989,1.0,0.03469079939668175,0.9653092006033183,527,0.27450980392156865,0.4605329311211664,0.26495726495726496
847,003,2909,58,907,508,2851,2909,1.0,0.019938123066345823,0.9800618769336542,1494,0.3117909934685459,0.17463045720178755,0.5135785493296665
848,003,1995,28,710,573,1967,1995,1.0,0.014035087719298246,0.9859649122807017,712,0.3558897243107769,0.28721804511278193,0.3568922305764411
849,003,1025,22,324,414,1003,1025,1.0,0.021463414634146343,0.9785365853658536,287,0.31609756097560976,0.40390243902439027,0.28
850,003,1524,21,506,441,1503,1524,1.0,0.013779527559055118,0.9862204724409449,577,0.3320209973753281,0.28937007874015747,0.37860892388451445
851,003,1344,36,450,354,1308,1344,1.0,0.026785714285714284,0.9732142857142857,540,0.33482142857142855,0.26339285714285715,0.4017857142857143
852,003,230,8,118,80,222,230,1.0,0.034782608695652174,0.9652173913043478,32,0.5130434782608696,0.34782608695652173,0.1391304347826087
853,003,665,13,175,32,652,665,1.0,0.019548872180451128,0.9804511278195489,458,0.2631578947368421,0.0481203007518797,0.6887218045112782
854,003,416,5,174,140,411,416,1.0,0.01201923076923077,0.9879807692307693,102,0.4182692307692308,0.33653846153846156,0.24519230769230768
855,003,1351,28,434,355,1323,1351,1.0,0.02072538860103627,0.9792746113989638,562,0.32124352331606215,0.2627683197631384,0.41598815692079943
856,003,1104,29,251,672,1075,1104,1.0,0.026268115942028984,0.9737318840579711,181,0.22735507246376813,0.6086956521739131,0.16394927536231885
858,003,2718,76,727,305,2642,2718,1.0,0.027961736571008096,0.9720382634289919,1686,0.26747608535688006,0.11221486387049301,0.6203090507726269
859,003,1329,32,433,603,1297,1329,1.0,0.024078254326561323,0.9759217456734387,293,0.3258088788562829,0.45372460496614,0.22046651617757712
860,003,9,0,0,0,9,9,1.0,0.0,1.0,9,0.0,0.0,1.0
861,003,1114,27,410,380,1087,1114,1.0,0.02423698384201077,0.9757630161579892,324,0.36804308797127466,0.34111310592459604,0.29084380610412924
862,003,1832,56,648,497,1776,1832,1.0,0.03056768558951965,0.9694323144104804,687,0.3537117903930131,0.2712882096069869,0.375
863,003,2030,72,599,311,1958,2030,1.0,0.035467980295566505,0.9645320197044335,1120,0.29507389162561576,0.15320197044334977,0.5517241379310345
864,003,110,1,38,21,109,110,1.0,0.00909090909090909,0.990909090909091,51,0.34545454545454546,0.19090909090909092,0.4636363636363636
866,003,1340,35,322,169,1305,1340,1.0,0.026119402985074626,0.9738805970149254,849,0.24029850746268658,0.12611940298507462,0.6335820895522388
867,003,987,21,307,303,966,987,1.0,0.02127659574468085,0.9787234042553191,377,0.3110435663627153,0.3069908814589666,0.3819655521783181
868,003,1925,84,432,233,1841,1925,1.0,0.04363636363636364,0.9563636363636364,1260,0.22441558441558443,0.12103896103896104,0.6545454545454545
869,003,599,11,110,22,588,599,1.0,0.018363939899833055,0.9816360601001669,467,0.18363939899833054,0.03672787979966611,0.7796327212020033
870,003,9,0,0,0,9,9,1.0,0.0,1.0,9,0.0,0.0,1.0
872,017,174,12,30,86,162,174,1.0,0.06896551724137931,0.9310344827586207,58,0.1724137931034483,0.4942528735632184,0.3333333333333333
873,017,739,20,95,395,719,739,1.0,0.02706359945872801,0.972936400541272,249,0.12855209742895804,0.5345060893098782,0.33694181326116374
875,031,2,0,0,0,2,2,1.0,0.0,1.0,2,0.0,0.0,1.0
876,031,16,0,0,0,16,16,1.0,0.0,1.0,16,0.0,0.0,1.0
877,031,7,2,0,0,5,7,1.0,0.2857142857142857,0.7142857142857143,7,0.0,0.0,1.0
878,031,1209,18,404,136,1191,1209,1.0,0.01488833746898263,0.9851116625310173,669,0.33416046319272125,0.11248966087675766,0.5533498759305211
879,031,211,10,54,41,201,211,1.0,0.04739336492890995,0.95260663507109,116,0.2559241706161137,0.1943127962085308,0.5497630331753555
882,031,242,10,100,82,232,242,1.0,0.04132231404958678,0.9586776859504132,60,0.4132231404958678,0.33884297520661155,0.24793388429752067
885,031,665,30,232,305,635,665,1.0,0.045112781954887216,0.9548872180451128,128,0.34887218045112783,0.45864661654135336,0.1924812030075188
888,031,5,1,0,0,4,5,1.0,0.2,0.8,5,0.0,0.0,1.0
895,031,1,0,0,0,1,1,1.0,0.0,1.0,1,0.0,0.0,1.0
896,031,195,3,58,72,192,195,1.0,0.015384615384615385,0.9846153846153847,65,0.29743589743589743,0.36923076923076925,0.3333333333333333
897,031,227,126,85,57,101,227,1.0,0.5550660792951542,0.44493392070484583,85,0.3744493392070485,0.2511013215859031,0.3744493392070485
898,031,1652,68,332,142,1584,1652,1.0,0.04116222760290557,0.9588377723970944,1178,0.2009685230024213,0.08595641646489104,0.7130750605326877
899,031,337,318,165,18,19,337,1.0,0.9436201780415431,0.05637982195845697,154,0.4896142433234421,0.05341246290801187,0.456973293768546
900,031,1527,94,336,272,1433,1527,1.0,0.06155861165684348,0.9384413883431565,919,0.2200392927308448,0.17812704649639816,0.601833660772757
903,031,332,315,200,32,17,332,1.0,0.9487951807228916,0.05120481927710843,100,0.6024096385542169,0.0963855421686747,0.30120481927710846
904,031,1022,63,299,86,959,1022,1.0,0.06164383561643835,0.9383561643835616,637,0.2925636007827789,0.08414872798434442,0.6232876712328768
905,031,1335,86,379,304,1249,1335,1.0,0.06441947565543071,0.9355805243445693,652,0.28389513108614234,0.22771535580524344,0.4883895131086142
906,031,682,48,246,128,634,682,1.0,0.07038123167155426,0.9296187683284457,308,0.36070381231671556,0.187683284457478,0.45161290322580644
907,031,952,41,301,426,911,952,1.0,0.0430672268907563,0.9569327731092437,225,0.3161764705882353,0.4474789915966387,0.23634453781512604
908,031,32,5,1,14,27,32,1.0,0.15625,0.84375,17,0.03125,0.4375,0.53125
909,031,1004,30,179,563,974,1004,1.0,0.029880478087649404,0.9701195219123506,262,0.17828685258964144,0.5607569721115537,0.26095617529880477
910,031,467,22,93,65,445,467,1.0,0.047109207708779445,0.9528907922912205,309,0.19914346895074947,0.139186295503212,0.6616702355460385
911,031,236,4,76,70,232,236,1.0,0.01694915254237288,0.9830508474576272,90,0.3220338983050847,0.2966101694915254,0.3813559322033898
912,031,2918,82,813,304,2836,2918,1.0,0.02810143934201508,0.971898560657985,1801,0.27861549006168607,0.1041809458533242,0.6172035640849897
919,031,1,0,0,0,1,1,1.0,0.0,1.0,1,0.0,0.0,1.0
920,031,12,2,0,0,10,12,1.0,0.16666666666666666,0.8333333333333334,12,0.0,0.0,1.0
925,031,11,1,0,0,10,11,1.0,0.09090909090909091,0.9090909090909091,11,0.0,0.0,1.0
926,031,22,3,0,0,19,22,1.0,0.13636363636363635,0.8636363636363636,22,0.0,0.0,1.0
927,031,92,3,32,59,89,92,2.1666666666666665,0.03260869565217391,0.967391304347826,1,0.34782608695652173,0.6413043478260869,0.010869565217391304
929,031,1,0,0,0,1,1,1.0,0.0,1.0,1,0.0,0.0,1.0
931,031,36,0,10,7,36,36,1.0,0.0,1.0,19,0.2777777777777778,0.19444444444444445,0.5277777777777778
932,031,10,0,0,0,10,10,1.0,0.0,1.0,10,0.0,0.0,1.0
935,031,11,1,0,0,10,11,1.0,0.09090909090909091,0.9090909090909091,11,0.0,0.0,1.0
937,031,75,2,24,47,73,75,1.0,0.02666666666666667,0.9733333333333334,4,0.32,0.6266666666666667,0.05333333333333334
940,031,35,1,8,17,34,35,1.0,0.02857142857142857,0.9714285714285714,10,0.22857142857142856,0.4857142857142857,0.2857142857142857
941,031,2214,92,828,935,2122,2214,1.0,0.04155374887082204,0.9584462511291779,451,0.37398373983739835,0.4223125564588979,0.2037037037037037
942,031,11,6,0,0,5,11,1.0,0.5454545454545454,0.45454545454545453,11,0.0,0.0,1.0
943,031,20,1,3,12,19,20,1.0,0.05,0.95,5,0.15,0.6,0.25
944,031,2045,83,435,357,1962,2045,1.0,0.04058679706601467,0.9594132029339854,1253,0.21271393643031786,0.1745721271393643,0.6127139364303178
947,031,2058,51,756,1026,2007,2058,1.0,0.02478134110787172,0.9752186588921283,276,0.3673469387755102,0.49854227405247814,0.13411078717201166
948,031,81,5,21,59,76,81,1.0389610389610389,0.06172839506172839,0.9382716049382716,1,0.25925925925925924,0.7283950617283951,0.012345679012345678
949,031,189,7,24,74,182,189,1.0,0.037037037037037035,0.9629629629629629,91,0.12698412698412698,0.3915343915343915,0.48148148148148145
953,031,3026,101,918,977,2925,3026,1.0,0.0333773959021811,0.9666226040978189,1131,0.30337078651685395,0.3228684732319894,0.37376074025115663
954,031,2659,89,425,138,2570,2659,1.0,0.033471229785633695,0.9665287702143663,2096,0.15983452425723957,0.051899210229409555,0.7882662655133509
955,031,3618,113,568,297,3505,3618,1.0,0.03123272526257601,0.968767274737424,2753,0.15699281370923163,0.08208955223880597,0.7609176340519624
956,031,957,36,292,301,921,957,1.0,0.03761755485893417,0.9623824451410659,364,0.3051201671891327,0.31452455590386624,0.38035527690700105
957,031,1212,69,177,133,1143,1212,1.0,0.05693069306930693,0.943069306930693,902,0.14603960396039603,0.10973597359735973,0.7442244224422442
958,031,40,3,13,12,37,40,1.0,0.075,0.925,15,0.325,0.3,0.375
960,031,279,19,74,148,260,279,1.0,0.06810035842293907,0.931899641577061,57,0.26523297491039427,0.5304659498207885,0.20430107526881722
961,031,457,7,168,172,450,457,1.0,0.015317286652078774,0.9846827133479212,117,0.3676148796498906,0.37636761487964987,0.25601750547045954
962,031,14,0,0,0,14,14,1.0,0.0,1.0,14,0.0,0.0,1.0
963,031,1241,43,290,125,1198,1241,1.0,0.0346494762288477,0.9653505237711523,826,0.233682514101531,0.10072522159548751,0.6655922643029815
966,031,918,41,377,301,877,918,1.0,0.044662309368191724,0.9553376906318083,240,0.4106753812636166,0.32788671023965144,0.26143790849673204
969,031,62,5,22,11,57,62,1.0,0.08064516129032258,0.9193548387096774,29,0.3548387096774194,0.1774193548387097,0.46774193548387094
979,031,1792,63,505,562,1729,1792,1.0,0.03515625,0.96484375,725,0.2818080357142857,0.31361607142857145,0.40457589285714285
982,031,1221,26,453,498,1195,1221,1.0,0.021294021294021293,0.9787059787059788,270,0.371007371007371,0.40786240786240785,0.22113022113022113
983,031,425,8,120,155,417,425,1.0,0.018823529411764704,0.9811764705882353,150,0.2823529411764706,0.36470588235294116,0.35294117647058826
988,031,122,1,34,68,121,122,1.0,0.00819672131147541,0.9918032786885246,20,0.2786885245901639,0.5573770491803278,0.16393442622950818
989,031,38,1,6,22,37,38,1.0,0.02631578947368421,0.9736842105263158,10,0.15789473684210525,0.5789473684210527,0.2631578947368421
991,031,818,52,274,208,766,818,1.0,0.06356968215158924,0.9364303178484108,336,0.33496332518337407,0.254278728606357,0.41075794621026895
993,031,272,6,85,61,266,272,1.0,0.022058823529411766,0.9779411764705882,126,0.3125,0.22426470588235295,0.4632352941176471
994,031,648,12,219,186,636,648,1.0,0.018518518518518517,0.9814814814814815,243,0.33796296296296297,0.28703703703703703,0.375
995,031,30,2,14,6,28,30,1.0,0.06666666666666667,0.9333333333333333,10,0.4666666666666667,0.2,0.3333333333333333
996,031,74,0,36,12,74,74,1.0,0.0,1.0,26,0.4864864864864865,0.16216216216216217,0.35135135135135137
997,031,1501,74,319,292,1427,1501,1.0,0.04930046635576282,0.9506995336442372,890,0.21252498334443704,0.19453697534976683,0.5929380413057961
998,031,341,18,115,130,323,341,1.0,0.05278592375366569,0.9472140762463344,96,0.33724340175953077,0.3812316715542522,0.28152492668621704
999,031,24,5,0,0,19,24,1.0,0.20833333333333334,0.7916666666666666,24,0.0,0.0,1.0
1000,031,2634,136,577,379,2498,2634,1.0,0.051632498101746395,0.9483675018982536,1678,0.2190584662110858,0.14388762338648445,0.6370539104024298
1001,031,953,58,354,210,895,953,1.0,0.060860440713536204,0.9391395592864638,389,0.37145855194123817,0.2203567681007345,0.40818467995802726
1004,031,1163,24,505,506,1139,1163,1.0,0.02063628546861565,0.9793637145313844,152,0.4342218400687876,0.4350816852966466,0.13069647463456577
1005,031,1445,21,485,488,1424,1445,1.0,0.01453287197231834,0.9854671280276817,472,0.3356401384083045,0.33771626297577856,0.32664359861591696
1007,031,2,1,0,0,1,2,1.0,0.5,0.5,2,0.0,0.0,1.0
1009,031,56,1,19,9,55,56,1.0,0.017857142857142856,0.9821428571428571,28,0.3392857142857143,0.16071428571428573,0.5
1013,011,250,16,16,137,234,250,1.0,0.064,0.936,97,0.064,0.548,0.388
1014,011,385,2,41,247,383,385,1.0,0.005194805194805195,0.9948051948051948,97,0.10649350649350649,0.6415584415584416,0.2519480519480519
1015,011,389,10,20,171,379,389,1.0,0.02570694087403599,0.974293059125964,198,0.05141388174807198,0.43958868894601544,0.5089974293059126
1016,011,425,19,27,332,406,425,1.0,0.04470588235294118,0.9552941176470588,66,0.06352941176470588,0.7811764705882352,0.15529411764705883
1017,510,1885,65,588,886,1820,1885,1.0,0.034482758620689655,0.9655172413793104,411,0.3119363395225464,0.470026525198939,0.2180371352785146
1018,510,1507,38,494,705,1469,1507,1.0,0.025215660252156602,0.9747843397478434,308,0.3278035832780358,0.4678168546781685,0.20437956204379562
1019,510,2646,131,660,691,2515,2646,1.0,0.04950869236583522,0.9504913076341648,1295,0.2494331065759637,0.26114890400604684,0.4894179894179894
1020,510,1082,24,445,583,1058,1082,1.0,0.022181146025878003,0.977818853974122,54,0.411275415896488,0.5388170055452866,0.04990757855822551
1021,510,1923,105,515,529,1818,1923,1.0,0.054602184087363496,0.9453978159126365,879,0.26781071242849713,0.2750910036401456,0.45709828393135726
1022,510,2128,67,701,823,2061,2128,1.0,0.03148496240601504,0.9685150375939849,604,0.3294172932330827,0.3867481203007519,0.28383458646616544
1023,510,1154,32,484,548,1122,1154,1.0,0.02772963604852686,0.9722703639514731,122,0.4194107452339688,0.4748700173310225,0.10571923743500866
1024,510,1311,55,382,537,1256,1311,1.0,0.041952707856598014,0.958047292143402,392,0.2913806254767353,0.4096109839816934,0.2990083905415713
1025,510,1956,82,539,648,1874,1956,1.0,0.041922290388548056,0.9580777096114519,769,0.27556237218813906,0.3312883435582822,0.39314928425357876
1026,510,1560,213,607,584,1347,1560,1.0,0.13653846153846153,0.8634615384615385,369,0.3891025641025641,0.37435897435897436,0.23653846153846153
1027,510,3788,191,932,873,3597,3788,1.0,0.05042238648363252,0.9495776135163675,1983,0.24604012671594508,0.23046462513199578,0.5234952481520592
1028,510,3702,254,567,1054,3448,3702,1.0,0.06861156131820638,0.9313884386817937,2081,0.15316045380875204,0.2847109670448406,0.5621285791464073
1029,510,1306,88,363,546,1218,1306,1.0,0.06738131699846861,0.9326186830015314,397,0.277947932618683,0.41807044410413474,0.30398162327718226
1030,510,1645,99,375,453,1546,1645,1.0,0.06018237082066869,0.9398176291793313,817,0.22796352583586627,0.2753799392097264,0.4966565349544073
1031,510,833,17,249,481,816,833,1.0,0.02040816326530612,0.9795918367346939,103,0.29891956782713086,0.5774309723889556,0.12364945978391356
1032,510,2376,113,661,676,2263,2376,1.0,0.04755892255892256,0.9524410774410774,1039,0.2781986531986532,0.2845117845117845,0.4372895622895623
1033,510,2250,122,489,698,2128,2250,1.0,0.05422222222222222,0.9457777777777778,1063,0.21733333333333332,0.31022222222222223,0.47244444444444444
1034,510,2721,86,702,871,2635,2721,1.0,0.031606027195883866,0.9683939728041161,1148,0.2579933847850055,0.3201029033443587,0.4219037118706358
1035,510,1835,77,468,563,1758,1835,1.0,0.041961852861035424,0.9580381471389646,804,0.2550408719346049,0.3068119891008174,0.43814713896457763
1036,510,2134,108,646,722,2026,2134,1.0,0.05060918462980318,0.9493908153701968,766,0.302717900656045,0.338331771321462,0.358950328022493
1037,510,2806,128,436,542,2678,2806,1.0,0.045616535994297935,0.9543834640057021,1828,0.15538132573057734,0.1931575196008553,0.6514611546685674
1038,510,1409,60,496,687,1349,1409,1.0,0.042583392476934,0.957416607523066,226,0.3520227111426544,0.48757984386089426,0.1603974449964514
1039,510,1798,81,428,461,1717,1798,1.0,0.04505005561735261,0.9549499443826474,909,0.23804226918798665,0.25639599555061177,0.5055617352614016
1040,510,1645,47,503,938,1598,1645,1.0,0.02857142857142857,0.9714285714285714,204,0.3057750759878419,0.5702127659574469,0.12401215805471125
1041,027,2128,138,162,585,1990,2128,1.0,0.06484962406015038,0.9351503759398496,1381,0.07612781954887218,0.274906015037594,0.6489661654135338
1042,027,995,38,52,171,957,995,1.0,0.03819095477386935,0.9618090452261306,772,0.05226130653266332,0.17185929648241205,0.7758793969849246
1043,027,234,23,14,109,211,234,1.0,0.09829059829059829,0.9017094017094017,111,0.05982905982905983,0.4658119658119658,0.47435897435897434
1044,027,792,31,80,398,761,792,1.0,0.039141414141414144,0.9608585858585859,314,0.10101010101010101,0.5025252525252525,0.39646464646464646
1045,027,634,46,110,203,588,634,1.0,0.07255520504731862,0.9274447949526814,321,0.17350157728706625,0.32018927444794953,0.5063091482649842
1046,027,632,23,129,265,609,632,1.0,0.03639240506329114,0.9636075949367089,238,0.20411392405063292,0.41930379746835444,0.37658227848101267
1047,007,791,40,131,279,751,791,1.0,0.05056890012642225,0.9494310998735778,381,0.16561314791403287,0.3527180783817952,0.48166877370417194
1048,007,1920,62,203,1264,1858,1920,1.0,0.03229166666666667,0.9677083333333333,453,0.10572916666666667,0.6583333333333333,0.2359375
1049,007,924,166,154,323,758,924,1.0,0.17965367965367965,0.8203463203463204,447,0.16666666666666666,0.3495670995670996,0.4837662337662338
1050,007,845,45,168,347,800,845,1.0,0.05325443786982249,0.9467455621301775,330,0.19881656804733727,0.4106508875739645,0.3905325443786982
1051,007,1625,89,183,342,1536,1625,1.0,0.05476923076923077,0.9452307692307692,1100,0.11261538461538462,0.21046153846153845,0.676923076923077
1052,007,1993,75,292,928,1918,1993,1.0,0.03763171098845961,0.9623682890115404,773,0.14651279478173607,0.46562970396387354,0.3878575012543904
1053,007,1236,51,123,695,1185,1236,1.0,0.0412621359223301,0.9587378640776699,418,0.09951456310679611,0.5622977346278317,0.33818770226537215
1054,007,2091,64,264,1270,2027,2091,1.0,0.030607364897178385,0.9693926351028216,557,0.12625538020086083,0.6073648971783836,0.2663797226207556
1055,007,1968,68,327,321,1900,1968,1.0,0.034552845528455285,0.9654471544715447,1320,0.16615853658536586,0.16310975609756098,0.6707317073170732
1056,007,138,8,18,99,130,138,1.0,0.057971014492753624,0.9420289855072463,21,0.13043478260869565,0.717391304347826,0.15217391304347827
1057,007,708,631,98,29,77,708,1.0,0.8912429378531074,0.10875706214689265,581,0.1384180790960452,0.04096045197740113,0.8206214689265536
1058,007,15,1,0,0,14,15,1.0,0.06666666666666667,0.9333333333333333,15,0.0,0.0,1.0
1059,007,149,3,9,82,146,149,1.0,0.020134228187919462,0.9798657718120806,58,0.06040268456375839,0.5503355704697986,0.38926174496644295
1060,007,630,22,31,342,608,630,1.0,0.03492063492063492,0.9650793650793651,257,0.049206349206349205,0.5428571428571428,0.40793650793650793
1061,007,960,45,67,376,915,960,1.0,0.046875,0.953125,517,0.06979166666666667,0.39166666666666666,0.5385416666666667
1062,007,581,96,41,381,485,581,1.0,0.16523235800344235,0.8347676419965576,159,0.07056798623063683,0.6557659208261618,0.2736660929432014
1063,007,957,46,83,443,911,957,1.0,0.04806687565308255,0.9519331243469175,431,0.08672936259143156,0.46290491118077326,0.4503657262277952
1064,007,872,37,124,337,835,872,1.0,0.04243119266055046,0.9575688073394495,411,0.14220183486238533,0.38646788990825687,0.4713302752293578
1065,007,1199,90,188,524,1109,1199,1.0,0.0750625521267723,0.9249374478732277,487,0.15679733110925773,0.4370308590492077,0.4061718098415346
1066,007,797,63,99,514,734,797,1.0,0.07904642409033877,0.9209535759096612,184,0.12421580928481807,0.644918444165621,0.23086574654956085
1067,007,193,10,18,101,183,193,1.0,0.05181347150259067,0.9481865284974094,74,0.09326424870466321,0.5233160621761658,0.38341968911917096
1068,007,1404,70,75,750,1334,1404,1.0,0.04985754985754986,0.9501424501424501,579,0.053418803418803416,0.5341880341880342,0.41239316239316237
1069,007,130,9,10,114,121,130,1.0,0.06923076923076923,0.9307692307692308,6,0.07692307692307693,0.8769230769230769,0.046153846153846156
1070,007,1594,87,232,712,1507,1594,1.0,0.054579673776662486,0.9454203262233375,650,0.14554579673776663,0.4466750313676286,0.4077791718946048
1071,007,689,30,104,341,659,689,1.0,0.04354136429608128,0.9564586357039188,244,0.1509433962264151,0.4949201741654572,0.35413642960812775
1072,007,1631,402,220,750,1229,1631,1.0,0.24647455548743102,0.753525444512569,661,0.134886572654813,0.4598405885959534,0.4052728387492336
1073,007,1758,77,156,295,1681,1758,1.0,0.04379977246871445,0.9562002275312855,1307,0.08873720136518772,0.16780432309442547,0.7434584755403868
1074,007,1386,101,134,361,1285,1386,1.0,0.07287157287157287,0.9271284271284271,891,0.09668109668109669,0.26046176046176045,0.6428571428571429
1075,007,44,2,12,24,42,44,1.0,0.045454545454545456,0.9545454545454546,8,0.2727272727272727,0.5454545454545454,0.18181818181818182
1076,007,1669,55,168,1155,1614,1669,1.0,0.0329538645895746,0.9670461354104254,346,0.1006590772917915,0.6920311563810665,0.20730976632714201
1077,007,1597,68,179,1024,1529,1597,1.0,0.042579837194740136,0.9574201628052599,394,0.11208515967438948,0.641202254226675,0.2467125860989355
1078,007,1426,44,101,741,1382,1426,1.0,0.030855539971949508,0.9691444600280504,584,0.07082748948106592,0.5196353436185134,0.40953716690042075
1079,007,1214,50,136,515,1164,1214,1.0,0.04118616144975288,0.9588138385502472,563,0.11202635914332784,0.4242174629324547,0.46375617792421747
1080,007,315,14,16,103,301,315,1.0,0.044444444444444446,0.9555555555555556,196,0.050793650793650794,0.326984126984127,0.6222222222222222
1081,007,125,5,11,97,120,125,1.0,0.04,0.96,17,0.088,0.776,0.136
1082,007,472,41,52,190,431,472,1.0,0.08686440677966102,0.913135593220339,230,0.11016949152542373,0.4025423728813559,0.4872881355932203
1083,007,675,35,125,92,640,675,1.0,0.05185185185185185,0.9481481481481482,458,0.18518518518518517,0.1362962962962963,0.6785185185185185
1084,007,172,8,22,97,164,172,1.0,0.046511627906976744,0.9534883720930233,53,0.12790697674418605,0.563953488372093,0.3081395348837209
1085,007,59,5,5,47,54,59,1.0,0.0847457627118644,0.9152542372881356,7,0.0847457627118644,0.7966101694915254,0.11864406779661017
1086,007,474,68,76,233,406,474,1.0,0.14345991561181434,0.8565400843881856,165,0.16033755274261605,0.49156118143459915,0.34810126582278483
1087,007,982,55,100,96,927,982,1.0,0.0560081466395112,0.9439918533604889,786,0.10183299389002037,0.09775967413441955,0.8004073319755601
1088,001,866,438,199,270,428,866,1.0,0.5057736720554272,0.4942263279445728,397,0.22979214780600463,0.3117782909930716,0.45842956120092376
1089,001,687,28,84,269,659,687,1.0,0.040756914119359534,0.9592430858806404,334,0.1222707423580786,0.3915574963609898,0.4861717612809316
1090,001,1197,62,176,700,1135,1197,1.0,0.05179615705931495,0.948203842940685,321,0.14703425229741018,0.5847953216374269,0.2681704260651629
1091,001,789,44,129,363,745,789,1.0,0.05576679340937896,0.944233206590621,297,0.1634980988593156,0.4600760456273764,0.376425855513308
1092,001,1654,110,230,857,1544,1654,1.0,0.06650544135429262,0.9334945586457074,567,0.13905683192261184,0.5181378476420798,0.34280532043530837
1093,001,674,89,119,347,585,674,1.0,0.13204747774480713,0.8679525222551929,208,0.17655786350148367,0.5148367952522255,0.3086053412462908
1094,001,628,36,89,305,592,628,1.0,0.05732484076433121,0.9426751592356688,234,0.14171974522292993,0.4856687898089172,0.37261146496815284
1095,001,876,55,117,504,821,876,1.0,0.06278538812785388,0.9372146118721462,255,0.13356164383561644,0.5753424657534246,0.2910958904109589
1096,001,914,35,112,528,879,914,1.0,0.038293216630196934,0.9617067833698031,274,0.12253829321663019,0.5776805251641138,0.29978118161925604
1097,001,1029,48,184,595,981,1029,1.0,0.04664723032069971,0.9533527696793003,250,0.17881438289601556,0.5782312925170068,0.24295432458697766
1098,001,1583,79,265,888,1504,1583,1.0,0.04990524320909665,0.9500947567909034,430,0.16740366392924827,0.5609602021478206,0.2716361339229311
1099,001,792,44,100,500,748,792,1.0,0.05555555555555555,0.9444444444444444,192,0.12626262626262627,0.6313131313131313,0.24242424242424243
1100,001,1124,87,142,365,1037,1124,1.0,0.07740213523131673,0.9225978647686833,617,0.12633451957295375,0.32473309608540923,0.548932384341637
1101,001,1380,88,216,383,1292,1380,1.0,0.06376811594202898,0.936231884057971,781,0.1565217391304348,0.27753623188405796,0.5659420289855073
1102,001,623,18,68,396,605,623,1.0,0.028892455858747994,0.971107544141252,159,0.10914927768860354,0.6356340288924559,0.2552166934189406
1103,001,1571,86,266,498,1485,1571,1.0,0.0547422024188415,0.9452577975811585,807,0.16931890515595163,0.316995544239338,0.5136855506047103
1104,001,1334,66,227,510,1268,1334,1.0,0.049475262368815595,0.9505247376311844,597,0.1701649175412294,0.3823088455772114,0.44752623688155924
1105,001,911,57,151,352,854,911,1.0,0.06256860592755215,0.9374313940724479,408,0.16575192096597147,0.38638858397365533,0.4478594950603732
1106,001,1149,57,174,737,1092,1149,1.0,0.04960835509138381,0.9503916449086162,238,0.1514360313315927,0.6414273281114012,0.2071366405570061
1107,009,98,16,4,42,82,98,1.0,0.16326530612244897,0.8367346938775511,52,0.04081632653061224,0.42857142857142855,0.5306122448979592
1108,009,215,7,36,178,208,215,1.1204188481675392,0.03255813953488372,0.9674418604651163,1,0.16744186046511628,0.827906976744186,0.004651162790697674
1109,009,22,1,2,11,21,22,1.0,0.045454545454545456,0.9545454545454546,9,0.09090909090909091,0.5,0.4090909090909091
1110,009,17,0,0,0,17,17,1.0,0.0,1.0,17,0.0,0.0,1.0
1111,009,268,19,30,164,249,268,1.0,0.0708955223880597,0.9291044776119403,74,0.11194029850746269,0.6119402985074627,0.27611940298507465
1112,013,345,22,37,195,323,345,1.0,0.06376811594202898,0.936231884057971,113,0.1072463768115942,0.5652173913043478,0.32753623188405795
1113,013,243,13,29,126,230,243,1.0,0.053497942386831275,0.9465020576131687,88,0.11934156378600823,0.5185185185185185,0.36213991769547327
1114,013,238,13,23,133,225,238,1.0,0.0546218487394958,0.9453781512605042,82,0.09663865546218488,0.5588235294117647,0.3445378151260504
1115,013,487,27,51,240,460,487,1.0,0.055441478439425054,0.944558521560575,196,0.10472279260780287,0.4928131416837782,0.4024640657084189
1116,013,1275,46,124,781,1229,1275,1.0,0.03607843137254902,0.9639215686274509,370,0.09725490196078432,0.6125490196078431,0.2901960784313726
1117,013,931,32,94,564,899,931,1.0,0.034371643394199784,0.9656283566058003,273,0.10096670247046187,0.6058002148227712,0.2932330827067669
1118,013,299,5,18,219,294,299,1.0,0.016722408026755852,0.9832775919732442,62,0.06020066889632107,0.7324414715719063,0.20735785953177258
1119,013,308,199,65,48,109,308,1.0,0.6461038961038961,0.3538961038961039,195,0.21103896103896103,0.15584415584415584,0.6331168831168831
1120,013,177,2,10,94,175,177,1.0,0.011299435028248588,0.9887005649717514,73,0.05649717514124294,0.5310734463276836,0.4124293785310734
1121,013,1797,71,217,875,1726,1797,1.0,0.03951029493600445,0.9604897050639956,705,0.12075681691708402,0.4869226488592098,0.39232053422370616
1122,013,1328,54,181,512,1274,1328,1.0,0.04066265060240964,0.9593373493975904,635,0.13629518072289157,0.3855421686746988,0.47816265060240964
1123,013,1585,97,221,448,1488,1585,1.0,0.061198738170347,0.938801261829653,916,0.13943217665615143,0.28264984227129336,0.5779179810725552
1124,013,1278,40,241,770,1238,1278,1.0,0.03129890453834116,0.9687010954616588,267,0.18857589984350548,0.6025039123630673,0.20892018779342722
1125,013,1357,66,215,434,1291,1357,1.0,0.04863669859985262,0.9513633014001474,708,0.1584377302873987,0.3198231392778187,0.5217391304347826
1126,013,1108,84,157,423,1024,1108,1.0,0.07581227436823104,0.924187725631769,528,0.14169675090252706,0.38176895306859204,0.47653429602888087
1127,005,1224,48,339,595,1176,1224,1.0,0.0392156862745098,0.9607843137254902,290,0.2769607843137255,0.4861111111111111,0.2369281045751634
1128,005,1763,35,406,950,1728,1763,1.0,0.019852524106636415,0.9801474758933636,407,0.23028927963698242,0.5388542257515598,0.23085649461145774
1129,005,275,262,97,40,13,275,1.0,0.9527272727272728,0.04727272727272727,138,0.3527272727272727,0.14545454545454545,0.5018181818181818
1130,005,1355,42,376,820,1313,1355,1.0,0.03099630996309963,0.9690036900369003,159,0.2774907749077491,0.6051660516605166,0.11734317343173432
1131,005,854,28,267,429,826,854,1.0,0.03278688524590164,0.9672131147540983,158,0.3126463700234192,0.5023419203747073,0.18501170960187355
1132,005,1243,41,289,829,1202,1243,1.0,0.03298471440064361,0.9670152855993563,125,0.2325020112630732,0.666934835076428,0.1005631536604988
1133,005,502,7,113,305,495,502,1.0,0.013944223107569721,0.9860557768924303,84,0.2250996015936255,0.6075697211155379,0.16733067729083664
1134,005,942,31,218,655,911,942,1.0,0.032908704883227176,0.9670912951167728,69,0.23142250530785563,0.6953290870488322,0.0732484076433121
1135,005,1701,97,378,999,1604,1701,1.0,0.05702527924750147,0.9429747207524986,324,0.2222222222222222,0.5873015873015873,0.19047619047619047
1136,005,549,8,140,388,541,549,1.0,0.014571948998178506,0.9854280510018215,21,0.2550091074681239,0.7067395264116576,0.03825136612021858
1137,005,916,20,318,497,896,916,1.0,0.021834061135371178,0.9781659388646288,101,0.3471615720524017,0.5425764192139738,0.11026200873362445
1138,005,1569,53,461,650,1516,1569,1.0,0.033779477374123644,0.9662205226258763,458,0.29381771829190567,0.41427660930529,0.29190567240280435
1139,005,953,26,222,608,927,953,1.0,0.02728226652675761,0.9727177334732424,123,0.23294858342077648,0.6379853095487933,0.12906610703043023
1140,005,719,25,217,349,694,719,1.0,0.03477051460361613,0.9652294853963839,153,0.30180806675938804,0.4853963838664812,0.21279554937413073
1141,005,929,36,340,489,893,929,1.0,0.038751345532831,0.961248654467169,100,0.36598493003229277,0.5263724434876211,0.10764262648008611
1142,005,995,41,213,648,954,995,1.0,0.04120603015075377,0.9587939698492463,134,0.21407035175879396,0.6512562814070352,0.13467336683417086
1143,005,1310,40,301,499,1270,1310,1.0,0.030534351145038167,0.9694656488549618,510,0.2297709923664122,0.38091603053435114,0.3893129770992366
1144,005,773,18,215,435,755,773,1.0,0.02328589909443726,0.9767141009055628,123,0.278137128072445,0.5627425614489003,0.1591203104786546
1145,005,1732,62,436,915,1670,1732,1.0,0.03579676674364896,0.964203233256351,381,0.2517321016166282,0.5282909930715936,0.2199769053117783
1146,005,1518,76,384,803,1442,1518,1.0,0.05006587615283267,0.9499341238471674,331,0.25296442687747034,0.5289855072463768,0.21805006587615283
1147,005,1474,46,335,642,1428,1474,1.0,0.031207598371777476,0.9687924016282226,497,0.22727272727272727,0.4355495251017639,0.33717774762550884
1148,005,8,3,0,0,5,8,1.0,0.375,0.625,8,0.0,0.0,1.0
1149,005,597,22,157,343,575,597,1.0,0.03685092127303183,0.9631490787269682,97,0.2629815745393635,0.5745393634840871,0.1624790619765494
1150,005,1265,39,310,830,1226,1265,1.0,0.0308300395256917,0.9691699604743083,125,0.2450592885375494,0.6561264822134387,0.09881422924901186
1151,005,1703,68,496,748,1635,1703,1.0,0.03992953611274222,0.9600704638872578,459,0.2912507339988256,0.4392248972401644,0.26952436876101
1152,005,597,23,167,310,574,597,1.0,0.038525963149078725,0.9614740368509213,120,0.2797319932998325,0.5192629815745393,0.20100502512562815
1153,005,1156,26,371,556,1130,1156,1.0,0.02249134948096886,0.9775086505190311,229,0.3209342560553633,0.4809688581314879,0.1980968858131488
1154,005,1657,86,494,789,1571,1657,1.0,0.05190102595051298,0.9480989740494871,374,0.29812914906457455,0.47616173808086903,0.22570911285455642
1155,005,962,20,288,614,942,962,1.0,0.02079002079002079,0.9792099792099792,60,0.2993762993762994,0.6382536382536382,0.062370062370062374
1156,005,797,13,237,500,784,797,1.0,0.01631116687578419,0.9836888331242158,60,0.2973651191969887,0.6273525721455459,0.07528230865746549
1157,005,734,14,199,500,720,734,1.0,0.01907356948228883,0.9809264305177112,35,0.27111716621253407,0.6811989100817438,0.047683923705722074
1158,005,627,16,229,301,611,627,1.0,0.025518341307814992,0.9744816586921851,97,0.3652312599681021,0.4800637958532695,0.1547049441786284
1159,005,785,24,353,301,761,785,1.0,0.030573248407643312,0.9694267515923567,131,0.4496815286624204,0.3834394904458599,0.16687898089171974
1160,005,496,7,165,280,489,496,1.0,0.014112903225806451,0.9858870967741935,51,0.3326612903225806,0.5645161290322581,0.1028225806451613
1161,005,522,5,155,286,517,522,1.0,0.009578544061302681,0.9904214559386973,81,0.29693486590038315,0.5478927203065134,0.15517241379310345
1162,005,972,23,514,342,949,972,1.0,0.023662551440329218,0.9763374485596708,116,0.5288065843621399,0.35185185185185186,0.11934156378600823
1163,005,491,24,135,124,467,491,1.0,0.048879837067209775,0.9511201629327902,232,0.27494908350305497,0.2525458248472505,0.4725050916496945
1164,005,1057,23,445,457,1034,1057,1.0,0.021759697256385997,0.978240302743614,155,0.4210028382213813,0.4323557237464522,0.1466414380321665
1165,005,666,29,110,360,637,666,1.0,0.04354354354354354,0.9564564564564565,196,0.16516516516516516,0.5405405405405406,0.29429429429429427
1166,005,1425,75,306,793,1350,1425,1.0,0.05263157894736842,0.9473684210526315,326,0.21473684210526317,0.5564912280701755,0.2287719298245614
1167,005,1408,66,374,644,1342,1408,1.0,0.046875,0.953125,390,0.265625,0.45738636363636365,0.27698863636363635
1168,033,1257,45,26,150,1212,1257,1.0,0.03579952267303103,0.964200477326969,1081,0.020684168655529037,0.11933174224343675,0.8599840891010342
1169,033,129,10,67,61,119,129,1.0,0.07751937984496124,0.9224806201550387,1,0.5193798449612403,0.4728682170542636,0.007751937984496124
1170,033,1491,176,172,934,1315,1491,1.0,0.11804158283031523,0.8819584171696848,385,0.1153588195841717,0.6264252179745138,0.25821596244131456
1171,033,635,17,94,324,618,635,1.0,0.026771653543307086,0.9732283464566929,217,0.14803149606299212,0.510236220472441,0.3417322834645669
1172,033,813,39,99,408,774,813,1.0,0.04797047970479705,0.9520295202952029,306,0.12177121771217712,0.5018450184501845,0.3763837638376384
1173,033,675,26,110,389,649,675,1.0,0.03851851851851852,0.9614814814814815,176,0.16296296296296298,0.5762962962962963,0.2607407407407407
1174,033,331,21,37,142,310,331,1.0,0.0634441087613293,0.9365558912386707,152,0.11178247734138973,0.42900302114803623,0.459214501510574
1175,033,758,45,121,336,713,758,1.0,0.059366754617414245,0.9406332453825857,301,0.15963060686015831,0.44327176781002636,0.3970976253298153
1176,033,289,3,17,261,286,289,1.0,0.010380622837370242,0.9896193771626297,11,0.058823529411764705,0.903114186851211,0.03806228373702422
1177,033,799,44,113,395,755,799,1.0,0.05506883604505632,0.9449311639549437,291,0.1414267834793492,0.49436795994993743,0.3642052565707134
1178,019,2164,108,470,1168,2056,2164,1.0,0.04990757855822551,0.9500924214417745,526,0.21719038817005545,0.5397412199630314,0.24306839186691312
1179,019,1641,102,250,830,1539,1641,1.0,0.062157221206581355,0.9378427787934186,561,0.15234613040828762,0.505789152955515,0.34186471663619744
1180,019,1192,57,207,626,1135,1192,1.0,0.047818791946308725,0.9521812080536913,359,0.17365771812080538,0.5251677852348994,0.3011744966442953
1181,019,554,27,114,270,527,554,1.0,0.048736462093862815,0.9512635379061372,170,0.20577617328519857,0.48736462093862815,0.30685920577617326
1182,019,182,9,81,44,173,182,1.0,0.04945054945054945,0.9505494505494505,57,0.44505494505494503,0.24175824175824176,0.3131868131868132
1183,019,952,40,219,463,912,952,1.0,0.04201680672268908,0.957983193277311,270,0.23004201680672268,0.48634453781512604,0.28361344537815125
1184,019,381,22,69,153,359,381,1.0,0.05774278215223097,0.9422572178477691,159,0.18110236220472442,0.4015748031496063,0.41732283464566927
1185,019,1525,70,341,763,1455,1525,1.0,0.04590163934426229,0.9540983606557377,421,0.22360655737704918,0.5003278688524591,0.2760655737704918
1186,019,1803,74,375,758,1729,1803,1.0,0.041042706600110924,0.9589572933998891,670,0.2079866888519135,0.4204104270660011,0.3716028840820854
1187,019,465,32,82,258,433,465,1.0,0.06881720430107527,0.9311827956989247,125,0.17634408602150536,0.5548387096774193,0.26881720430107525
1188,019,772,33,175,260,739,772,1.0,0.042746113989637305,0.9572538860103627,337,0.2266839378238342,0.33678756476683935,0.4365284974093264
1189,019,2019,88,406,1087,1931,2019,1.0,0.04358593363051015,0.9564140663694899,526,0.20108964834076276,0.5383853392768697,0.2605250123823675
1190,019,1280,24,318,777,1256,1280,1.0,0.01875,0.98125,185,0.2484375,0.60703125,0.14453125
1191,019,301,7,68,202,294,301,1.0,0.023255813953488372,0.9767441860465116,31,0.22591362126245848,0.6710963455149501,0.10299003322259136
1192,019,1469,70,233,523,1399,1469,1.0,0.047651463580667124,0.9523485364193329,713,0.15861130020422057,0.35602450646698436,0.4853641933287951
1193,019,1758,81,320,802,1677,1758,1.0,0.04607508532423208,0.9539249146757679,636,0.1820250284414107,0.45620022753128553,0.36177474402730375
1194,019,2369,151,392,701,2218,2369,1.0,0.06373997467285775,0.9362600253271423,1276,0.16547066272688898,0.29590544533558466,0.5386238919375264
1195,019,919,29,189,483,890,919,1.0,0.031556039173014146,0.9684439608269858,247,0.20565832426550598,0.5255712731229597,0.2687704026115343
1196,019,1865,84,336,893,1781,1865,1.0,0.04504021447721179,0.9549597855227882,636,0.18016085790884717,0.4788203753351206,0.34101876675603215
1197,019,1483,88,272,470,1395,1483,1.0,0.05933917734322319,0.9406608226567768,741,0.18341200269723534,0.31692515171948754,0.4996628455832771
1198,019,1388,89,260,610,1299,1388,1.0,0.06412103746397695,0.9358789625360231,518,0.1873198847262248,0.43948126801152737,0.37319884726224783
1199,019,482,25,78,185,457,482,1.0,0.05186721991701245,0.9481327800829875,219,0.16182572614107885,0.38381742738589214,0.45435684647302904
1200,019,665,38,116,321,627,665,1.0,0.05714285714285714,0.9428571428571428,228,0.17443609022556392,0.48270676691729325,0.34285714285714286
1201,019,1463,77,318,556,1386,1463,1.0,0.05263157894736842,0.9473684210526315,589,0.21736158578263842,0.380041011619959,0.4025974025974026
1202,019,515,12,109,247,503,515,1.0,0.02330097087378641,0.9766990291262136,159,0.21165048543689322,0.4796116504854369,0.3087378640776699
1203,019,1732,93,274,714,1639,1732,1.0,0.05369515011547344,0.9463048498845266,744,0.1581986143187067,0.4122401847575058,0.4295612009237875
1204,019,1297,70,230,554,1227,1297,1.0,0.05397070161912105,0.9460292983808789,513,0.17733230531996916,0.4271395528141866,0.39552814186584423
1205,019,1048,49,196,488,999,1048,1.0,0.046755725190839696,0.9532442748091603,364,0.18702290076335878,0.46564885496183206,0.3473282442748092
1206,019,1163,50,243,449,1113,1163,1.0,0.04299226139294927,0.9570077386070507,471,0.20894239036973344,0.3860705073086844,0.40498710232158214
1207,019,941,43,136,410,898,941,1.0,0.04569606801275239,0.9543039319872476,395,0.14452709883103082,0.4357066950053135,0.4197662061636557
1208,019,1117,114,139,389,1003,1117,1.0,0.10205908683974933,0.8979409131602507,589,0.12444046553267682,0.34825425246195163,0.5273052820053715
1209,019,1019,61,158,530,958,1019,1.0,0.05986261040235525,0.9401373895976447,331,0.155053974484789,0.5201177625122669,0.32482826300294404
1210,019,1172,53,211,541,1119,1172,1.0,0.04522184300341297,0.9547781569965871,420,0.18003412969283278,0.4616040955631399,0.3583617747440273
1211,019,676,28,90,346,648,676,1.0,0.04142011834319527,0.9585798816568047,240,0.13313609467455623,0.5118343195266272,0.35502958579881655
1212,019,1107,40,169,480,1067,1107,1.0,0.036133694670280034,0.96386630532972,458,0.15266485998193316,0.43360433604336046,0.4137308039747064
1213,019,99,18,15,28,81,99,1.0,0.18181818181818182,0.8181818181818182,56,0.15151515151515152,0.2828282828282828,0.5656565656565656
1214,019,1180,182,242,501,998,1180,1.0,0.15423728813559323,0.8457627118644068,437,0.20508474576271185,0.4245762711864407,0.37033898305084745
1215,019,416,13,68,269,403,416,1.0,0.03125,0.96875,79,0.16346153846153846,0.6466346153846154,0.18990384615384615
1216,019,2410,219,319,967,2191,2410,1.0,0.0908713692946058,0.9091286307053942,1124,0.13236514522821577,0.4012448132780083,0.46639004149377594
1217,019,1134,38,184,790,1096,1134,1.0,0.03350970017636684,0.9664902998236331,160,0.16225749559082892,0.6966490299823633,0.14109347442680775
1218,003,2342,65,646,354,2277,2342,1.0,0.02775405636208369,0.9722459436379163,1342,0.27583262169086253,0.1511528608027327,0.5730145175064048
1219,003,1702,49,559,368,1653,1702,1.0,0.028789659224441832,0.9712103407755581,775,0.3284371327849589,0.21621621621621623,0.45534665099882493
1220,003,2121,47,651,242,2074,2121,1.0,0.02215935879302216,0.9778406412069779,1228,0.3069306930693069,0.1140971239981141,0.578972182932579
1221,003,1846,42,657,646,1804,1846,1.0,0.02275189599133261,0.9772481040086674,543,0.35590465872156013,0.34994582881906827,0.2941495124593716
1222,003,2221,67,685,848,2154,2221,1.0,0.030166591625393965,0.9698334083746061,688,0.3084196307969383,0.38180999549752365,0.30977037370553806
1223,003,1818,73,537,627,1745,1818,1.0,0.040154015401540157,0.9598459845984598,654,0.2953795379537954,0.3448844884488449,0.35973597359735976
1224,003,2197,66,681,516,2131,2197,1.0,0.030040964952207556,0.9699590350477925,1000,0.30996813837050524,0.23486572598998634,0.4551661356395084
1225,003,2378,39,988,292,2339,2378,1.0,0.016400336417157275,0.9835996635828427,1098,0.415475189234651,0.12279226240538267,0.46173254835996635
1226,003,2119,44,578,496,2075,2119,1.0,0.020764511562057573,0.9792354884379424,1045,0.2727701746106654,0.2340726757904672,0.4931571495988674
1227,003,2786,147,627,631,2639,2786,1.0,0.052763819095477386,0.9472361809045227,1528,0.2250538406317301,0.22648959081119885,0.548456568557071
1228,003,1742,61,572,594,1681,1742,1.0,0.03501722158438576,0.9649827784156142,576,0.3283582089552239,0.3409873708381171,0.330654420206659
1229,003,1341,15,490,299,1326,1341,1.0,0.011185682326621925,0.9888143176733781,552,0.36539895600298283,0.22296793437733034,0.4116331096196868
1230,003,1494,31,548,442,1463,1494,1.0,0.020749665327978582,0.9792503346720214,504,0.3668005354752343,0.2958500669344043,0.3373493975903614
1231,003,524,10,97,42,514,524,1.0,0.019083969465648856,0.9809160305343512,385,0.1851145038167939,0.08015267175572519,0.7347328244274809
1232,003,1375,45,614,53,1330,1375,1.0,0.03272727272727273,0.9672727272727273,708,0.4465454545454545,0.03854545454545454,0.5149090909090909
1233,003,50,13,0,0,37,50,1.0,0.26,0.74,50,0.0,0.0,1.0
1234,003,1173,34,351,179,1139,1173,1.0,0.028985507246376812,0.9710144927536232,643,0.29923273657289,0.1526001705029838,0.5481670929241261
1236,003,2720,95,363,262,2625,2720,1.0,0.034926470588235295,0.9650735294117647,2095,0.13345588235294117,0.09632352941176471,0.7702205882352942
1237,003,1510,31,503,491,1479,1510,1.0,0.02052980132450331,0.9794701986754967,516,0.33311258278145695,0.3251655629139073,0.34172185430463575
1238,003,2262,76,684,882,2186,2262,1.0,0.03359858532272325,0.9664014146772767,696,0.30238726790450926,0.38992042440318303,0.3076923076923077
1239,003,1706,26,649,573,1680,1706,1.0,0.015240328253223915,0.984759671746776,484,0.38042203985932005,0.335873388042204,0.283704572098476
1240,003,1722,55,422,454,1667,1722,1.0,0.03193960511033682,0.9680603948896632,846,0.2450638792102207,0.26364692218350755,0.4912891986062718
1241,003,1091,33,403,30,1058,1091,1.0,0.03024747937671861,0.9697525206232814,658,0.3693858845096242,0.027497708524289642,0.6031164069660861
1242,003,3298,73,1051,618,3225,3298,1.0,0.022134627046694968,0.977865372953305,1629,0.31867798665858094,0.1873862947240752,0.49393571861734387
1243,003,2718,78,845,480,2640,2718,1.0,0.02869757174392936,0.9713024282560706,1393,0.31089036055923475,0.17660044150110377,0.5125091979396615
1244,003,2751,60,955,712,2691,2751,1.0,0.021810250817884406,0.9781897491821155,1084,0.34714649218466015,0.2588149763722283,0.3940385314431116
1245,003,914,6,393,460,908,914,1.0,0.006564551422319475,0.9934354485776805,61,0.4299781181619256,0.5032822757111597,0.06673960612691467
1249,003,775,26,266,113,749,775,1.0,0.03354838709677419,0.9664516129032258,396,0.3432258064516129,0.14580645161290323,0.5109677419354839
1252,003,4,0,0,0,4,4,1.0,0.0,1.0,4,0.0,0.0,1.0
1254,003,3,0,0,0,3,3,1.0,0.0,1.0,3,0.0,0.0,1.0
1256,003,3127,71,514,176,3056,3127,1.0,0.0227054685001599,0.9772945314998401,2437,0.16437480012791814,0.05628397825391749,0.7793412216181643
1257,003,12,0,0,0,12,12,1.0,0.0,1.0,12,0.0,0.0,1.0
1259,003,1656,87,574,445,1569,1656,1.0,0.05253623188405797,0.947463768115942,637,0.3466183574879227,0.26871980676328505,0.38466183574879226
1260,003,545,9,166,178,536,545,1.0,0.01651376146788991,0.9834862385321101,201,0.30458715596330277,0.326605504587156,0.3688073394495413
1261,003,1527,54,322,64,1473,1527,1.0,0.03536345776031434,0.9646365422396856,1141,0.2108709888670596,0.04191224623444663,0.7472167648984938
1266,003,3,0,0,0,3,3,1.0,0.0,1.0,3,0.0,0.0,1.0
1267,003,10,0,0,0,10,10,1.0,0.0,1.0,10,0.0,0.0,1.0
1268,003,6,0,0,0,6,6,1.0,0.0,1.0,6,0.0,0.0,1.0
1269,003,3003,54,879,489,2949,3003,1.0,0.017982017982017984,0.9820179820179821,1635,0.29270729270729273,0.16283716283716285,0.5444555444555444
1270,003,1933,33,497,408,1900,1933,1.0,0.017071908949818936,0.9829280910501811,1028,0.2571132953957579,0.21107087428867047,0.5318158303155717
1271,003,1753,32,530,271,1721,1753,1.0,0.01825442099258414,0.9817455790074159,952,0.30233884768967484,0.15459212778094694,0.5430690245293782
1272,003,895,15,308,283,880,895,1.0,0.01675977653631285,0.9832402234636871,304,0.34413407821229053,0.31620111731843575,0.3396648044692737
1273,003,1262,25,430,484,1237,1262,1.0,0.019809825673534072,0.9801901743264659,348,0.34072900158478603,0.38351822503961963,0.2757527733755943
1274,003,2755,63,839,676,2692,2755,1.0,0.022867513611615244,0.9771324863883848,1240,0.3045372050816697,0.2453720508166969,0.4500907441016334
1275,003,1113,25,280,142,1088,1113,1.0,0.022461814914645103,0.977538185085355,691,0.25157232704402516,0.1275831087151842,0.6208445642407907
1276,003,2081,99,587,715,1982,2081,1.0,0.04757328207592504,0.952426717924075,779,0.28207592503604034,0.3435848149927919,0.3743392599711677
1277,003,1150,37,323,519,1113,1150,1.0,0.03217391304347826,0.9678260869565217,308,0.2808695652173913,0.45130434782608697,0.2678260869565217
1278,003,2361,98,538,587,2263,2361,1.0,0.04150783566285472,0.9584921643371452,1236,0.22786954680220245,0.24862346463362983,0.5235069885641678
1279,003,2048,63,579,265,1985,2048,1.0,0.03076171875,0.96923828125,1204,0.28271484375,0.12939453125,0.587890625
1280,003,2066,45,629,478,2021,2066,1.0,0.021781219748305904,0.9782187802516941,959,0.3044530493707648,0.2313649564375605,0.4641819941916747
1281,003,996,32,352,351,964,996,1.0,0.0321285140562249,0.9678714859437751,293,0.3534136546184739,0.35240963855421686,0.29417670682730923
1283,003,1699,35,543,667,1664,1699,1.0,0.020600353148911125,0.9793996468510888,489,0.3195997645673926,0.392583872866392,0.2878163625662154
1284,003,1256,48,403,464,1208,1256,1.0,0.03821656050955414,0.9617834394904459,389,0.320859872611465,0.36942675159235666,0.30971337579617836
1285,003,2000,38,729,622,1962,2000,1.0,0.019,0.981,649,0.3645,0.311,0.3245
1286,003,360,5,87,226,355,360,1.0,0.013888888888888888,0.9861111111111112,47,0.24166666666666667,0.6277777777777778,0.13055555555555556
1287,003,970,6,372,479,964,970,1.0,0.006185567010309278,0.9938144329896907,119,0.3835051546391753,0.49381443298969074,0.12268041237113401
1288,003,2508,51,950,272,2457,2508,1.0,0.02033492822966507,0.9796650717703349,1286,0.3787878787878788,0.10845295055821372,0.5127591706539075
1289,003,1897,27,681,762,1870,1897,1.0,0.014232999472851872,0.9857670005271482,454,0.3589878755930416,0.40168687401159725,0.2393252503953611
1290,003,2017,61,687,587,1956,2017,1.0,0.03024293505205751,0.9697570649479424,743,0.3406048587010411,0.29102627664848785,0.368368864650471
1291,003,2875,42,880,775,2833,2875,1.0,0.014608695652173913,0.9853913043478261,1220,0.3060869565217391,0.26956521739130435,0.42434782608695654
1292,003,2087,18,672,862,2069,2087,1.0,0.008624820316243412,0.9913751796837565,553,0.3219932918064207,0.41303306181121224,0.26497364638236703
1293,003,1690,20,609,600,1670,1690,1.0,0.011834319526627219,0.9881656804733728,481,0.3603550295857988,0.35502958579881655,0.2846153846153846
1294,003,2219,82,667,398,2137,2219,1.0,0.036953582694907616,0.9630464173050924,1154,0.30058584948174855,0.1793600721045516,0.5200540784136999
1295,003,1088,38,391,370,1050,1088,1.0,0.034926470588235295,0.9650735294117647,327,0.359375,0.3400735294117647,0.3005514705882353
1296,003,2538,37,743,624,2501,2538,1.0,0.014578408195429472,0.9854215918045706,1171,0.29275019700551613,0.2458628841607565,0.46138691883372734
1297,003,2277,48,626,975,2229,2277,1.0,0.021080368906455864,0.9789196310935442,676,0.27492314448836186,0.4281949934123847,0.2968818620992534
1299,003,1051,12,412,377,1039,1051,1.0,0.011417697431018078,0.9885823025689819,262,0.39200761179828736,0.3587059942911513,0.24928639391056137
1300,003,1493,58,490,305,1435,1493,1.0,0.03884795713328868,0.9611520428667113,698,0.3281982585398526,0.2042866711319491,0.4675150703281983
1301,003,2135,13,631,942,2122,2135,1.0,0.006088992974238876,0.9939110070257611,562,0.2955503512880562,0.4412177985948478,0.26323185011709604
1302,003,2420,49,775,477,2371,2420,1.0,0.02024793388429752,0.9797520661157024,1168,0.3202479338842975,0.1971074380165289,0.4826446280991736
1303,003,701,11,263,328,690,701,1.0,0.015691868758915834,0.9843081312410842,110,0.3751783166904422,0.46790299572039945,0.15691868758915833
1304,003,864,5,305,418,859,864,1.0,0.005787037037037037,0.9942129629629629,141,0.35300925925925924,0.4837962962962963,0.16319444444444445
1305,003,1440,23,407,406,1417,1440,1.0,0.01597222222222222,0.9840277777777777,627,0.2826388888888889,0.28194444444444444,0.4354166666666667
1306,003,3822,81,1095,684,3741,3822,1.0,0.02119309262166405,0.978806907378336,2043,0.28649921507064363,0.17896389324960754,0.5345368916797488
1307,003,2295,42,817,725,2253,2295,1.0,0.018300653594771243,0.9816993464052287,753,0.3559912854030501,0.3159041394335512,0.3281045751633987
1308,003,1156,8,395,636,1148,1156,1.0,0.006920415224913495,0.9930795847750865,125,0.3416955017301038,0.5501730103806228,0.10813148788927336
1309,003,1333,39,459,444,1294,1333,1.0,0.029257314328582147,0.9707426856714179,430,0.34433608402100524,0.33308327081770445,0.3225806451612903
1310,003,3164,68,1120,829,3096,3164,1.0,0.021491782553729456,0.9785082174462706,1215,0.35398230088495575,0.2620101137800253,0.38400758533501894
1311,003,2130,56,758,606,2074,2130,1.0,0.02629107981220657,0.9737089201877934,766,0.355868544600939,0.28450704225352114,0.3596244131455399
1312,003,346,10,64,223,336,346,1.0,0.028901734104046242,0.9710982658959537,59,0.18497109826589594,0.6445086705202312,0.17052023121387283
1313,003,2005,64,629,249,1941,2005,1.0,0.03192019950124688,0.9680798004987531,1127,0.31371571072319204,0.12418952618453866,0.5620947630922694
1314,003,3099,90,699,346,3009,3099,1.0,0.02904162633107454,0.9709583736689255,2054,0.22555663117134558,0.11164891900613101,0.6627944498225234
1315,003,952,33,244,454,919,952,1.0,0.03466386554621849,0.9653361344537815,254,0.25630252100840334,0.47689075630252103,0.2668067226890756
1316,003,559,4,189,231,555,559,1.0,0.007155635062611807,0.9928443649373881,139,0.33810375670840787,0.41323792486583183,0.24865831842576028
1317,003,1202,10,382,548,1192,1202,1.0,0.008319467554076539,0.9916805324459235,272,0.3178036605657238,0.4559068219633943,0.22628951747088186
1318,003,1712,36,583,563,1676,1712,1.0,0.02102803738317757,0.9789719626168224,566,0.3405373831775701,0.32885514018691586,0.33060747663551404
1319,003,3946,61,1179,842,3885,3946,1.0,0.015458692346680182,0.9845413076533198,1925,0.29878357830714647,0.21338063862138876,0.4878357830714648
1320,003,1087,17,379,497,1070,1087,1.0,0.015639374425023,0.984360625574977,211,0.3486660533578657,0.45722171113155474,0.19411223551057957
1321,003,1418,34,483,605,1384,1418,1.0,0.023977433004231313,0.9760225669957687,330,0.34062059238363895,0.42665726375176305,0.23272214386459802
1322,003,1578,26,581,567,1552,1578,1.0,0.016476552598225603,0.9835234474017744,430,0.3681875792141952,0.3593155893536122,0.27249683143219267
1323,003,1254,40,407,504,1214,1254,1.0,0.03189792663476874,0.9681020733652312,343,0.32456140350877194,0.4019138755980861,0.27352472089314195
1324,003,1795,57,515,469,1738,1795,1.0,0.03175487465181059,0.9682451253481894,811,0.28690807799442897,0.26128133704735373,0.45181058495821724
1325,003,4003,95,1241,514,3908,4003,1.0,0.023732200849362978,0.976267799150637,2248,0.3100174868848364,0.1284036972270797,0.5615788158880839
1326,003,3092,52,966,670,3040,3092,1.0,0.016817593790426907,0.9831824062095731,1456,0.31241914618369987,0.2166882276843467,0.47089262613195343
1327,003,1584,36,448,197,1548,1584,1.0,0.022727272727272728,0.9772727272727273,939,0.2828282828282828,0.12436868686868686,0.5928030303030303
1328,003,1497,15,605,643,1482,1497,1.0,0.01002004008016032,0.9899799599198397,249,0.40414161656646624,0.42952571810287243,0.16633266533066132
1329,003,3633,91,1423,579,3542,3633,1.0,0.025048169556840076,0.9749518304431599,1631,0.3916873107624553,0.1593724194880264,0.4489402697495183
1330,003,3651,108,1316,778,3543,3651,1.0,0.029580936729663106,0.9704190632703369,1557,0.36044919200219117,0.21309230347849903,0.4264585045193098
1331,003,3156,81,1239,923,3075,3156,1.0,0.025665399239543727,0.9743346007604563,994,0.3925855513307985,0.29245880861850443,0.3149556400506971
1333,003,941,11,376,456,930,941,1.0,0.011689691817215728,0.9883103081827843,109,0.3995749202975558,0.48459086078639746,0.11583421891604676
1335,003,2437,56,745,554,2381,2437,1.0,0.022979072630283134,0.9770209273697169,1138,0.3057037340993024,0.22732868280672958,0.466967583093968
1337,003,2027,47,814,525,1980,2027,1.0,0.023186975826344353,0.9768130241736557,688,0.4015786877158362,0.2590034533793784,0.3394178589047854
1338,003,158,6,18,57,152,158,1.0,0.0379746835443038,0.9620253164556962,83,0.11392405063291139,0.36075949367088606,0.5253164556962026
1339,003,3388,83,729,677,3305,3388,1.0,0.024498229043683588,0.9755017709563164,1982,0.21517119244391972,0.19982290436835892,0.5850059031877214
1340,003,1457,40,334,268,1417,1457,1.0,0.027453671928620454,0.9725463280713795,855,0.22923816060398078,0.18393960192175704,0.5868222374742622
1341,003,4258,118,1516,1395,4140,4258,1.0,0.027712541099107563,0.9722874589008924,1347,0.35603569751056835,0.32761860028182244,0.3163457022076092
1342,003,1057,24,289,121,1033,1057,1.0,0.02270577105014191,0.9772942289498581,647,0.27341532639545885,0.11447492904446546,0.6121097445600757
1343,003,2131,92,630,275,2039,2131,1.0,0.04317221961520413,0.9568277803847959,1226,0.29563585171281087,0.1290473955889254,0.5753167526982638
1344,003,2265,68,738,388,2197,2265,1.0,0.030022075055187638,0.9699779249448124,1139,0.3258278145695364,0.17130242825607064,0.502869757174393
1345,003,1128,10,397,535,1118,1128,1.0,0.008865248226950355,0.9911347517730497,196,0.3519503546099291,0.47429078014184395,0.17375886524822695
1346,003,1961,61,801,801,1900,1961,1.0,0.031106578276389598,0.9688934217236104,359,0.40846506884242734,0.40846506884242734,0.18306986231514533
1347,003,1267,49,362,473,1218,1267,1.0,0.03867403314917127,0.9613259668508287,432,0.2857142857142857,0.3733228097868982,0.3409629044988161
1348,003,989,12,279,214,977,989,1.0,0.012133468149646108,0.9878665318503539,496,0.282103134479272,0.21638018200202225,0.5015166835187057
1349,003,2213,50,782,655,2163,2213,1.0,0.022593764121102575,0.9774062358788974,776,0.35336647085404427,0.29597830998644375,0.350655219159512
1350,003,2053,71,612,430,1982,2053,1.0,0.0345835362883585,0.9654164637116415,1011,0.29810034096444227,0.20944958597174865,0.49245007306380906
1351,003,1044,18,372,379,1026,1044,1.0,0.017241379310344827,0.9827586206896551,293,0.3563218390804598,0.36302681992337166,0.28065134099616856
1352,003,1003,14,412,275,989,1003,1.0,0.013958125623130608,0.9860418743768694,316,0.4107676969092722,0.2741774675972084,0.3150548354935194
1353,003,2260,70,860,385,2190,2260,1.0,0.030973451327433628,0.9690265486725663,1015,0.3805309734513274,0.17035398230088494,0.4491150442477876
1354,003,2084,65,725,515,2019,2084,1.0,0.031190019193857964,0.968809980806142,844,0.3478886756238004,0.24712092130518235,0.4049904030710173
1355,003,2043,68,337,147,1975,2043,1.0,0.033284385707293196,0.9667156142927068,1559,0.16495349975526186,0.07195301027900147,0.7630934899657367
1356,003,2231,80,673,375,2151,2231,1.0,0.03585835948005379,0.9641416405199462,1183,0.30165844912595247,0.16808606006275212,0.5302554908112954
1357,003,1298,43,394,240,1255,1298,1.0,0.03312788906009245,0.9668721109399075,664,0.3035439137134052,0.18489984591679506,0.5115562403697997
1358,003,4668,101,1570,1258,4567,4668,1.0,0.021636675235646958,0.9783633247643531,1840,0.3363324764353042,0.2694944301628106,0.39417309340188517
1359,003,1022,6,328,375,1016,1022,1.0,0.005870841487279843,0.9941291585127201,319,0.32093933463796476,0.3669275929549902,0.312133072407045
1360,003,1549,58,568,377,1491,1549,1.0,0.03744351194318916,0.9625564880568108,604,0.3666881859264041,0.2433828276307295,0.3899289864428664
1361,003,2400,50,732,570,2350,2400,1.0,0.020833333333333332,0.9791666666666666,1098,0.305,0.2375,0.4575
1362,003,1772,24,676,699,1748,1772,1.0,0.013544018058690745,0.9864559819413092,397,0.38148984198645597,0.39446952595936796,0.22404063205417607
1363,003,1223,21,445,468,1202,1223,1.0,0.017170891251022075,0.9828291087489779,310,0.36385936222403925,0.38266557645134913,0.2534750613246116
1364,003,1539,42,538,561,1497,1539,1.0,0.02729044834307992,0.9727095516569201,440,0.34957764782326184,0.3645224171539961,0.285899935022742
1365,003,1588,37,521,526,1551,1588,1.0,0.023299748110831235,0.9767002518891688,541,0.32808564231738035,0.33123425692695213,0.3406801007556675
1366,003,1484,32,557,510,1452,1484,1.0,0.0215633423180593,0.9784366576819407,417,0.3753369272237197,0.3436657681940701,0.28099730458221023
1367,003,1345,12,490,433,1333,1345,1.0,0.008921933085501859,0.9910780669144982,422,0.3643122676579926,0.32193308550185873,0.3137546468401487
1368,003,2190,41,622,439,2149,2190,1.0,0.01872146118721461,0.9812785388127854,1129,0.28401826484018267,0.2004566210045662,0.5155251141552512
1369,003,3890,115,1483,620,3775,3890,1.0,0.02956298200514139,0.9704370179948586,1787,0.38123393316195375,0.15938303341902313,0.45938303341902315
1370,003,1199,39,424,362,1160,1199,1.0,0.03252710592160134,0.9674728940783986,413,0.353628023352794,0.3019182652210175,0.34445371142618847
1371,003,2681,57,922,551,2624,2681,1.0,0.02126072361059306,0.9787392763894069,1208,0.34390152928011936,0.20552032823573294,0.4505781424841477
1372,003,1929,54,681,419,1875,1929,1.0,0.027993779160186624,0.9720062208398134,829,0.35303265940902023,0.21721099015033696,0.4297563504406428
1373,003,1625,28,527,721,1597,1625,1.0,0.01723076923076923,0.9827692307692307,377,0.3243076923076923,0.4436923076923077,0.232
1374,003,1909,38,629,552,1871,1909,1.0,0.01990570979570456,0.9800942902042954,728,0.32949188056574125,0.2891566265060241,0.38135149292823467
1375,003,1747,55,537,444,1692,1747,1.0,0.031482541499713794,0.9685174585002863,766,0.3073840870062965,0.25414997137950773,0.4384659416141958
1376,003,44,2,15,14,42,44,1.0,0.045454545454545456,0.9545454545454546,15,0.3409090909090909,0.3181818181818182,0.3409090909090909
1379,003,5,0,0,0,5,5,1.0,0.0,1.0,5,0.0,0.0,1.0
1384,003,1837,61,381,341,1776,1837,1.0,0.03320631464344039,0.9667936853565596,1115,0.20740337506804574,0.18562874251497005,0.6069678824169842
1385,003,472,19,136,112,453,472,1.0,0.04025423728813559,0.9597457627118644,224,0.288135593220339,0.23728813559322035,0.4745762711864407
1386,003,220,4,38,137,216,220,1.0,0.01818181818181818,0.9818181818181818,45,0.17272727272727273,0.6227272727272727,0.20454545454545456
1387,003,3850,69,152,309,3781,3850,1.0,0.017922077922077922,0.9820779220779221,3389,0.039480519480519484,0.08025974025974025,0.8802597402597403
1388,003,13,0,0,0,13,13,1.0,0.0,1.0,13,0.0,0.0,1.0
1389,003,1333,50,257,531,1283,1333,1.0,0.037509377344336084,0.9624906226556639,545,0.19279819954988747,0.3983495873968492,0.4088522130532633
1390,003,412,13,61,192,399,412,1.0,0.03155339805825243,0.9684466019417476,159,0.14805825242718446,0.46601941747572817,0.3859223300970874
1391,003,2229,72,360,797,2157,2229,1.0,0.03230148048452221,0.9676985195154778,1072,0.16150740242261102,0.357559443696725,0.480933153880664
1392,003,1169,29,393,532,1140,1169,1.0,0.02480752780153978,0.9751924721984602,244,0.3361847733105218,0.4550898203592814,0.20872540633019676
1393,003,190,10,35,56,180,190,1.0,0.05263157894736842,0.9473684210526315,99,0.18421052631578946,0.29473684210526313,0.5210526315789473
1394,003,8,0,0,0,8,8,1.0,0.0,1.0,8,0.0,0.0,1.0
1395,003,1,0,0,0,1,1,1.0,0.0,1.0,1,0.0,0.0,1.0
1396,003,3543,114,660,996,3429,3543,1.0,0.03217612193056731,0.9678238780694327,1887,0.18628281117696868,0.28111769686706184,0.5325994919559696
1397,003,3414,103,1273,989,3311,3414,1.0,0.03016988869361453,0.9698301113063855,1152,0.37287639132981837,0.28968951376684243,0.3374340949033392
1398,003,1833,61,122,71,1772,1833,1.0,0.033278777959629025,0.966721222040371,1640,0.06655755591925805,0.03873431533006001,0.894708128750682
1399,003,594,5,74,445,589,594,1.0,0.008417508417508417,0.9915824915824916,75,0.12457912457912458,0.7491582491582491,0.12626262626262627
1400,003,1055,28,354,515,1027,1055,1.0,0.026540284360189573,0.9734597156398104,186,0.3355450236966825,0.4881516587677725,0.176303317535545
1402,003,121,0,20,45,121,121,1.0,0.0,1.0,56,0.1652892561983471,0.371900826446281,0.4628099173553719
1403,003,11,0,0,0,11,11,1.0,0.0,1.0,11,0.0,0.0,1.0
1404,003,1919,39,677,763,1880,1919,1.0,0.020323084940072955,0.979676915059927,479,0.35278791036998436,0.3976029181865555,0.24960917144346015
1406,003,1959,42,671,553,1917,1959,1.0,0.021439509954058193,0.9785604900459418,735,0.34252169474221544,0.2822868810617662,0.37519142419601836
1407,003,2029,56,705,574,1973,2029,1.0,0.02759980285855101,0.972400197141449,750,0.34746180384425823,0.2828979793001479,0.3696402168555939
1408,003,2,0,0,0,2,2,1.0,0.0,1.0,2,0.0,0.0,1.0
1409,003,1299,22,517,601,1277,1299,1.0,0.016936104695919937,0.9830638953040801,181,0.39799846035411857,0.46266358737490376,0.13933795227097767
1410,003,1739,15,663,863,1724,1739,1.0,0.008625646923519264,0.9913743530764807,213,0.38125359401955145,0.496262219666475,0.12248418631397355
1411,003,1177,34,435,428,1143,1177,1.0,0.02888700084961767,0.9711129991503823,314,0.3695836873406967,0.36363636363636365,0.26677994902293967
1412,003,1512,36,526,515,1476,1512,1.0,0.023809523809523808,0.9761904761904762,471,0.3478835978835979,0.3406084656084656,0.3115079365079365
1413,003,1710,36,616,577,1674,1710,1.0,0.021052631578947368,0.9789473684210527,517,0.36023391812865496,0.3374269005847953,0.3023391812865497
1414,003,1147,10,375,627,1137,1147,1.0,0.008718395815170008,0.99128160418483,145,0.3269398430688753,0.5466434176111595,0.12641673931996514
1415,003,1187,27,278,619,1160,1187,1.0,0.02274641954507161,0.9772535804549284,290,0.2342038753159225,0.5214827295703454,0.2443133951137321
1416,003,820,8,329,369,812,820,1.0,0.00975609756097561,0.9902439024390244,122,0.401219512195122,0.45,0.14878048780487804
1417,003,1640,28,598,705,1612,1640,1.0,0.01707317073170732,0.9829268292682927,337,0.3646341463414634,0.4298780487804878,0.20548780487804877
1418,003,1539,32,513,674,1507,1539,1.0,0.02079272254710851,0.9792072774528915,352,0.3333333333333333,0.437946718648473,0.22871994801819362
1419,003,2479,39,900,870,2440,2479,1.0,0.01573215006050827,0.9842678499394917,709,0.36304961678096004,0.3509479628882614,0.28600242033077855
1420,003,1088,13,378,443,1075,1088,1.0,0.011948529411764705,0.9880514705882353,267,0.3474264705882353,0.4071691176470588,0.24540441176470587
1421,003,2719,46,823,694,2673,2719,1.0,0.016917984553144538,0.9830820154468555,1202,0.3026848105921295,0.25524089738874584,0.4420742920191247
1422,003,600,6,164,386,594,600,1.0,0.01,0.99,50,0.2733333333333333,0.6433333333333333,0.08333333333333333
1424,003,2362,34,834,1034,2328,2362,1.0,0.014394580863674851,0.9856054191363252,494,0.35309060118543606,0.4377646062658764,0.20914479254868756
1425,003,3094,38,1182,1180,3056,3094,1.0,0.012281835811247576,0.9877181641887525,732,0.3820297349709114,0.3813833225597931,0.2365869424692954
1428,003,1917,50,624,579,1867,1917,1.0,0.02608242044861763,0.9739175795513824,714,0.325508607198748,0.30203442879499215,0.37245696400625977
1429,003,6,0,0,0,6,6,1.0,0.0,1.0,6,0.0,0.0,1.0
1430,003,2403,36,835,811,2367,2403,1.0,0.0149812734082397,0.9850187265917603,757,0.3474823137744486,0.33749479816895545,0.3150228880565959
1431,003,2966,57,1132,468,2909,2966,1.0,0.01921780175320297,0.980782198246797,1366,0.38165879973027644,0.15778826702629806,0.4605529332434255
1432,003,2334,60,776,644,2274,2334,1.0,0.02570694087403599,0.974293059125964,914,0.3324764353041988,0.2759211653813196,0.3916023993144816
1433,003,7,0,0,0,7,7,1.0,0.0,1.0,7,0.0,0.0,1.0
1434,003,2632,64,765,598,2568,2632,1.0,0.0243161094224924,0.9756838905775076,1269,0.2906534954407295,0.22720364741641338,0.48214285714285715
1435,003,1483,47,432,299,1436,1483,1.0,0.03169251517194875,0.9683074848280513,752,0.29130141604855025,0.20161834120026972,0.50708024275118
1436,003,2449,63,739,572,2386,2449,1.0,0.025724785626786442,0.9742752143732135,1138,0.3017558187015108,0.23356472029399755,0.46467946100449165
1437,003,1578,33,500,231,1545,1578,1.0,0.02091254752851711,0.9790874524714829,847,0.31685678073510776,0.14638783269961977,0.5367553865652726
1438,003,4185,149,1192,767,4036,4185,1.0,0.035603345280764635,0.9643966547192354,2226,0.2848267622461171,0.18327359617682198,0.5318996415770609
1439,003,1071,19,421,383,1052,1071,1.0,0.017740429505135387,0.9822595704948646,267,0.3930905695611578,0.357609710550887,0.24929971988795518
1440,003,960,4,346,488,956,960,1.0,0.004166666666666667,0.9958333333333333,126,0.36041666666666666,0.5083333333333333,0.13125
1441,003,13,0,1,10,13,13,1.0,0.0,1.0,2,0.07692307692307693,0.7692307692307693,0.15384615384615385
1442,003,92,3,26,47,89,92,1.0,0.03260869565217391,0.967391304347826,19,0.2826086956521739,0.5108695652173914,0.20652173913043478
1444,003,343,7,44,25,336,343,1.0,0.02040816326530612,0.9795918367346939,274,0.1282798833819242,0.0728862973760933,0.7988338192419825
1445,003,1036,21,323,273,1015,1036,1.0,0.02027027027027027,0.9797297297297297,440,0.31177606177606176,0.2635135135135135,0.4247104247104247
1446,003,2049,27,656,834,2022,2049,1.0,0.013177159590043924,0.986822840409956,559,0.3201561737432894,0.40702781844802344,0.27281600780868714
1447,003,1684,44,563,340,1640,1684,1.0,0.026128266033254157,0.9738717339667459,781,0.3343230403800475,0.20190023752969122,0.4637767220902613
1448,003,16,0,0,0,16,16,1.0,0.0,1.0,16,0.0,0.0,1.0
1452,003,3,0,0,0,3,3,1.0,0.0,1.0,3,0.0,0.0,1.0
1453,003,3,0,0,0,3,3,1.0,0.0,1.0,3,0.0,0.0,1.0
1454,003,2264,59,565,280,2205,2264,1.0,0.026060070671378093,0.973939929328622,1419,0.2495583038869258,0.12367491166077739,0.6267667844522968
1455,003,2588,78,875,480,2510,2588,1.0,0.030139103554868624,0.9698608964451314,1233,0.33809891808346215,0.18547140649149924,0.4764296754250386
1456,003,1543,45,438,563,1498,1543,1.0,0.02916396629941672,0.9708360337005832,542,0.2838626053143227,0.3648736228127025,0.35126377187297475
1457,003,849,25,200,398,824,849,1.0,0.02944640753828033,0.9705535924617197,251,0.23557126030624265,0.46878680800942285,0.2956419316843345
1458,003,2330,79,658,661,2251,2330,1.0,0.03390557939914163,0.9660944206008584,1011,0.28240343347639485,0.2836909871244635,0.43390557939914165
1459,003,1739,70,520,365,1669,1739,1.0,0.04025301897642323,0.9597469810235768,854,0.29902242668200113,0.2098907418056354,0.49108683151236343
1460,003,1448,50,395,313,1398,1448,1.0,0.034530386740331494,0.9654696132596685,740,0.27279005524861877,0.21616022099447513,0.511049723756906
1461,003,1196,39,357,271,1157,1196,1.0,0.03260869565217391,0.967391304347826,568,0.298494983277592,0.2265886287625418,0.47491638795986624
1462,003,3663,95,837,254,3568,3663,1.0,0.025935025935025936,0.974064974064974,2572,0.2285012285012285,0.06934206934206934,0.7021567021567021
1463,003,1959,46,490,156,1913,1959,1.0,0.02348136804492088,0.9765186319550792,1313,0.2501276161306789,0.07963246554364471,0.6702399183256764
1464,003,2443,52,572,351,2391,2443,1.0,0.02128530495292673,0.9787146950470733,1520,0.23413835448219403,0.14367580843225541,0.6221858370855505
1465,003,2079,63,788,267,2016,2079,1.0,0.030303030303030304,0.9696969696969697,1024,0.37902837902837905,0.12842712842712842,0.49254449254449256
1466,003,3148,74,756,383,3074,3148,1.0,0.023506988564167726,0.9764930114358322,2009,0.24015247776365947,0.12166454891994917,0.6381829733163914
1467,003,1606,44,574,454,1562,1606,1.0,0.0273972602739726,0.9726027397260274,578,0.3574097135740971,0.28268991282689915,0.35990037359900373
1468,003,2327,46,706,627,2281,2327,1.0,0.019767941555651054,0.9802320584443489,994,0.3033949290932531,0.269445638160722,0.4271594327460249
1469,003,1601,36,601,451,1565,1601,1.0,0.022485946283572766,0.9775140537164272,549,0.37539038101186756,0.2816989381636477,0.34291068082448467
1470,003,1650,50,575,523,1600,1650,1.0,0.030303030303030304,0.9696969696969697,552,0.3484848484848485,0.31696969696969696,0.33454545454545453
1471,003,2450,43,795,618,2407,2450,1.0,0.017551020408163264,0.9824489795918367,1037,0.32448979591836735,0.2522448979591837,0.423265306122449
1472,003,2569,92,868,564,2477,2569,1.0,0.035811599844297395,0.9641884001557026,1137,0.33787465940054495,0.21954067730634488,0.44258466329311014
1473,003,2722,61,920,753,2661,2722,1.0,0.022409992652461425,0.9775900073475385,1049,0.33798677443056574,0.2766348273328435,0.38537839823659076
1474,003,1932,35,656,620,1897,1932,1.0,0.018115942028985508,0.9818840579710145,656,0.33954451345755693,0.32091097308488614,0.33954451345755693
1475,003,2689,41,856,454,2648,2689,1.0,0.015247303830420231,0.9847526961695797,1379,0.3183339531424321,0.16883599851245817,0.5128300483451097
1476,003,2000,53,643,449,1947,2000,1.0,0.0265,0.9735,908,0.3215,0.2245,0.454
1477,003,2071,49,587,419,2022,2071,1.0,0.023660067600193145,0.9763399323998069,1065,0.2834379526798648,0.20231772090777403,0.5142443264123612
1478,003,859,9,314,359,850,859,1.0,0.010477299185098952,0.989522700814901,186,0.36554132712456344,0.4179278230500582,0.21653084982537835
1479,003,3233,56,823,484,3177,3233,1.0,0.01732137333745747,0.9826786266625426,1926,0.254562326012991,0.14970615527373957,0.5957315187132695
1480,003,1808,49,552,357,1759,1808,1.0,0.027101769911504425,0.9728982300884956,899,0.3053097345132743,0.19745575221238937,0.49723451327433627
1481,003,2085,48,910,107,2037,2085,1.0,0.02302158273381295,0.9769784172661871,1068,0.4364508393285372,0.0513189448441247,0.5122302158273381
1482,003,2400,75,852,580,2325,2400,1.0,0.03125,0.96875,968,0.355,0.24166666666666667,0.4033333333333333
1483,003,1497,36,781,93,1461,1497,1.0,0.02404809619238477,0.9759519038076152,623,0.5217100868403474,0.06212424849699399,0.41616566466265864
1484,003,4125,145,1264,1242,3980,4125,1.0,0.03515151515151515,0.9648484848484848,1619,0.30642424242424243,0.3010909090909091,0.3924848484848485
1485,003,2793,65,838,726,2728,2793,1.0,0.02327246688148944,0.9767275331185106,1229,0.3000358037952023,0.25993555316863587,0.44002864303616185
1486,003,845,21,316,260,824,845,1.0,0.02485207100591716,0.9751479289940829,269,0.3739644970414201,0.3076923076923077,0.3183431952662722
1487,003,3333,106,1143,475,3227,3333,1.0,0.0318031803180318,0.9681968196819682,1715,0.34293429342934295,0.1425142514251425,0.5145514551455146
1488,003,1788,26,670,798,1762,1788,1.0,0.0145413870246085,0.9854586129753915,320,0.37472035794183445,0.4463087248322148,0.1789709172259508
1489,003,2383,60,910,682,2323,2383,1.0,0.02517834662190516,0.9748216533780948,791,0.3818715904322283,0.28619387326898865,0.33193453629878306
1490,003,3255,83,1062,679,3172,3255,1.0,0.025499231950844855,0.9745007680491552,1514,0.3262672811059908,0.2086021505376344,0.4651305683563748
1491,003,2584,89,731,308,2495,2584,1.0,0.03444272445820434,0.9655572755417957,1545,0.28289473684210525,0.11919504643962849,0.5979102167182663
1492,003,2636,52,860,617,2584,2636,1.0,0.019726858877086494,0.9802731411229135,1159,0.3262518968133536,0.2340667678300455,0.4396813353566009
1493,003,2420,52,939,687,2368,2420,1.0,0.021487603305785124,0.9785123966942149,794,0.38801652892561983,0.28388429752066113,0.328099173553719
1494,003,2814,94,1062,740,2720,2814,1.0,0.033404406538734895,0.9665955934612651,1012,0.3773987206823028,0.26297085998578534,0.35963041933191187
1495,003,3048,92,1034,603,2956,3048,1.0,0.030183727034120734,0.9698162729658792,1411,0.339238845144357,0.19783464566929135,0.4629265091863517
1496,003,2604,73,799,1011,2531,2604,1.0,0.02803379416282642,0.9719662058371735,794,0.3068356374807988,0.3882488479262673,0.3049155145929339
1497,003,3151,107,912,597,3044,3151,1.0,0.03395747381783561,0.9660425261821644,1642,0.28943192637258014,0.18946366232941922,0.5211044112980007
1499,003,1564,35,529,495,1529,1564,1.0,0.02237851662404092,0.9776214833759591,540,0.3382352941176471,0.31649616368286443,0.3452685421994885
1500,003,70,6,0,0,64,70,1.0,0.08571428571428572,0.9142857142857143,70,0.0,0.0,1.0
1501,003,3076,80,1045,828,2996,3076,1.0,0.02600780234070221,0.9739921976592978,1203,0.3397269180754226,0.26918075422626786,0.3910923276983095
1503,003,2910,104,791,540,2806,2910,1.0,0.03573883161512027,0.9642611683848797,1579,0.2718213058419244,0.18556701030927836,0.5426116838487972
1504,003,4,0,0,0,4,4,1.0,0.0,1.0,4,0.0,0.0,1.0
1505,003,5,0,0,0,5,5,1.0,0.0,1.0,5,0.0,0.0,1.0
1506,003,2,1,0,0,1,2,1.0,0.5,0.5,2,0.0,0.0,1.0
1508,003,4,0,0,0,4,4,1.0,0.0,1.0,4,0.0,0.0,1.0
1510,003,6,1,0,0,5,6,1.0,0.16666666666666666,0.8333333333333334,6,0.0,0.0,1.0
1511,003,3,2,0,0,1,3,1.0,0.6666666666666666,0.3333333333333333,3,0.0,0.0,1.0
1512,003,680,40,97,349,640,680,1.0,0.058823529411764705,0.9411764705882353,234,0.1426470588235294,0.513235294117647,0.34411764705882353
1513,003,1,0,0,0,1,1,1.0,0.0,1.0,1,0.0,0.0,1.0
1514,003,1560,31,136,1273,1529,1560,1.0,0.01987179487179487,0.9801282051282051,151,0.08717948717948718,0.816025641025641,0.0967948717948718
1516,003,1925,34,675,493,1891,1925,1.0,0.017662337662337664,0.9823376623376623,757,0.35064935064935066,0.2561038961038961,0.39324675324675323
1517,003,1064,15,359,245,1049,1064,1.0,0.014097744360902255,0.9859022556390977,460,0.337406015037594,0.23026315789473684,0.4323308270676692
1519,003,3545,107,1158,804,3438,3545,1.0,0.030183356840620592,0.9698166431593794,1583,0.32665726375176307,0.22679830747531735,0.4465444287729196
1520,003,2581,84,920,926,2497,2581,1.0,0.03254552499031383,0.9674544750096862,735,0.3564509879891515,0.3587756683456025,0.28477334366524604
1521,003,4,0,0,0,4,4,1.0,0.0,1.0,4,0.0,0.0,1.0
1522,003,921,14,356,409,907,921,1.0,0.01520086862106406,0.9847991313789359,156,0.38653637350705755,0.44408251900108575,0.16938110749185667
1523,003,2917,79,643,273,2838,2917,1.0,0.027082619129242372,0.9729173808707576,2001,0.22043195063421323,0.09358930407953377,0.685978745286253
1524,003,1441,50,355,113,1391,1441,1.0,0.03469812630117974,0.9653018736988203,973,0.24635669673837612,0.0784177654406662,0.6752255378209576
1525,003,2164,54,724,627,2110,2164,1.0,0.024953789279112754,0.9750462107208873,813,0.3345656192236599,0.2897412199630314,0.37569316081330867
1526,003,2538,78,638,292,2460,2538,1.0,0.030732860520094562,0.9692671394799054,1608,0.25137903861308114,0.11505122143420016,0.6335697399527187
1527,003,214,3,54,14,211,214,1.0,0.014018691588785047,0.985981308411215,146,0.2523364485981308,0.06542056074766354,0.6822429906542056
1528,003,2409,43,504,930,2366,2409,1.0,0.0178497301784973,0.9821502698215027,975,0.20921544209215442,0.386052303860523,0.40473225404732255
1529,003,4441,72,1613,1706,4369,4441,1.0,0.016212564737671697,0.9837874352623283,1122,0.3632064850258951,0.38414771447872104,0.25264580049538393
1530,003,1122,7,332,617,1115,1122,1.0,0.006238859180035651,0.9937611408199644,173,0.29590017825311943,0.5499108734402852,0.15418894830659535
1531,003,1675,38,562,585,1637,1675,1.0,0.022686567164179106,0.977313432835821,528,0.33552238805970147,0.3492537313432836,0.31522388059701495
1532,003,2530,41,849,891,2489,2530,1.0,0.016205533596837945,0.983794466403162,790,0.3355731225296443,0.3521739130434783,0.31225296442687744
1533,003,11,0,0,0,11,11,1.0,0.0,1.0,11,0.0,0.0,1.0
1534,003,1681,17,600,844,1664,1681,1.0,0.010113027959547887,0.9898869720404521,237,0.35693039857227843,0.5020820939916716,0.14098750743604996
1535,003,683,6,203,335,677,683,1.0,0.008784773060029283,0.9912152269399708,145,0.2972181551976574,0.4904831625183016,0.212298682284041
1537,003,787,11,294,351,776,787,1.0,0.01397712833545108,0.9860228716645489,142,0.3735705209656925,0.44599745870393903,0.18043202033036848
1538,003,1423,25,529,532,1398,1423,1.0,0.017568517217146872,0.9824314827828531,362,0.37174982431482784,0.37385804638088543,0.25439212930428673
1539,003,2483,82,710,595,2401,2483,1.0,0.03302456705598067,0.9669754329440193,1178,0.28594442207007653,0.2396294804671768,0.47442609746274667
1540,003,1729,38,590,619,1691,1729,1.0,0.02197802197802198,0.978021978021978,520,0.34123770965876227,0.3580104106419896,0.3007518796992481
1541,003,882,11,310,418,871,882,1.0,0.012471655328798186,0.9875283446712018,154,0.35147392290249435,0.47392290249433106,0.1746031746031746
1542,003,1023,8,391,444,1015,1023,1.0,0.007820136852394917,0.9921798631476051,188,0.38220918866080156,0.4340175953079179,0.18377321603128055
1543,003,2668,46,967,990,2622,2668,1.0,0.017241379310344827,0.9827586206896551,711,0.3624437781109445,0.37106446776611696,0.2664917541229385
1544,003,8,0,0,0,8,8,1.0,0.0,1.0,8,0.0,0.0,1.0
1545,003,4,0,0,0,4,4,1.0,0.0,1.0,4,0.0,0.0,1.0
1546,003,1666,53,381,248,1613,1666,1.0,0.03181272509003601,0.968187274909964,1037,0.22869147659063627,0.148859543817527,0.6224489795918368
1547,003,2185,81,549,345,2104,2185,1.0,0.037070938215102975,0.962929061784897,1291,0.25125858123569794,0.15789473684210525,0.5908466819221968
1548,003,3012,79,1153,616,2933,3012,1.0,0.026228419654714476,0.9737715803452855,1243,0.38280212483399734,0.20451527224435592,0.41268260292164677
1552,003,3349,89,655,271,3260,3349,1.0,0.0265750970438937,0.9734249029561063,2423,0.19558077037921767,0.08091967751567632,0.723499552105106
1553,003,91,2,39,11,89,91,1.0,0.02197802197802198,0.978021978021978,41,0.42857142857142855,0.12087912087912088,0.45054945054945056
1555,003,1398,37,420,359,1361,1398,1.0,0.026466380543633764,0.9735336194563662,619,0.30042918454935624,0.25679542203147354,0.4427753934191702
1556,003,1617,22,547,716,1595,1617,1.0,0.013605442176870748,0.9863945578231292,354,0.33828076685219544,0.4427952999381571,0.2189239332096475
1557,003,1981,48,639,664,1933,1981,1.0,0.024230186774356385,0.9757698132256436,678,0.3225643614336194,0.33518425037859667,0.34225138818778394
1559,003,4536,82,1444,1177,4454,4536,1.0,0.018077601410934743,0.9819223985890653,1915,0.318342151675485,0.2594797178130511,0.42217813051146386
1560,003,3043,113,932,749,2930,3043,1.0,0.037134406835359846,0.9628655931646402,1362,0.30627670062438384,0.24613867893526126,0.4475846204403549
1561,003,2743,68,1010,775,2675,2743,1.0,0.024790375501275976,0.9752096244987241,958,0.3682099890630696,0.2825373678454247,0.34925264309150567
1562,003,1433,50,514,370,1383,1433,1.0,0.034891835310537335,0.9651081646894627,549,0.3586880669923238,0.25819958129797627,0.3831123517096999
1563,003,3007,46,991,1109,2961,3007,1.0,0.015297638842700367,0.9847023611572996,907,0.32956434985034916,0.36880611905553706,0.3016295310941137
1564,003,1459,12,449,772,1447,1459,1.0,0.00822481151473612,0.9917751884852639,238,0.30774503084304317,0.5291295407813571,0.16312542837559973
1566,003,3,0,0,0,3,3,1.0,0.0,1.0,3,0.0,0.0,1.0
1567,003,47,4,18,22,43,47,1.0,0.0851063829787234,0.9148936170212766,7,0.3829787234042553,0.46808510638297873,0.14893617021276595
1568,003,1460,37,371,840,1423,1460,1.0,0.025342465753424658,0.9746575342465753,249,0.2541095890410959,0.5753424657534246,0.17054794520547945
1569,003,2380,50,670,330,2330,2380,1.0,0.02100840336134454,0.9789915966386554,1380,0.2815126050420168,0.13865546218487396,0.5798319327731093
1570,003,1894,53,390,178,1841,1894,1.0,0.0279831045406547,0.9720168954593453,1326,0.20591341077085534,0.09398099260823653,0.7001055966209081
1571,003,1262,44,228,198,1218,1262,1.0,0.03486529318541997,0.96513470681458,836,0.18066561014263074,0.15689381933438987,0.6624405705229794
1572,003,1485,40,494,378,1445,1485,1.0,0.026936026936026935,0.9730639730639731,613,0.33265993265993266,0.2545454545454545,0.41279461279461277
1573,003,1806,65,498,211,1741,1806,1.0,0.03599114064230343,0.9640088593576965,1097,0.2757475083056478,0.1168327796234773,0.6074197120708749
1574,003,1574,51,514,284,1523,1574,1.0,0.032401524777636595,0.9675984752223634,776,0.32655654383735705,0.18043202033036848,0.49301143583227447
1575,003,3307,99,754,326,3208,3307,1.0,0.029936498336861204,0.9700635016631388,2227,0.22800120955548836,0.09857877230117931,0.6734200181433323
1576,003,1382,43,428,303,1339,1382,1.0,0.031114327062228653,0.9688856729377714,651,0.3096960926193922,0.21924746743849494,0.4710564399421129
1577,003,1484,62,534,390,1422,1484,1.0,0.04177897574123989,0.9582210242587601,560,0.35983827493261455,0.2628032345013477,0.37735849056603776
1578,003,1121,49,299,531,1072,1121,1.0,0.043710972346119537,0.9562890276538805,291,0.26672613737734163,0.47368421052631576,0.25958965209634255
1579,003,844,36,242,267,808,844,1.0,0.04265402843601896,0.957345971563981,335,0.28672985781990523,0.31635071090047395,0.39691943127962087
1580,003,2360,101,825,607,2259,2360,1.0,0.042796610169491524,0.9572033898305085,928,0.3495762711864407,0.2572033898305085,0.39322033898305087
1581,003,2394,54,825,259,2340,2394,1.0,0.022556390977443608,0.9774436090225563,1310,0.34461152882205515,0.10818713450292397,0.5472013366750209
1582,003,1350,36,625,48,1314,1350,1.0,0.02666666666666667,0.9733333333333334,677,0.46296296296296297,0.035555555555555556,0.5014814814814815
1583,003,1280,30,384,396,1250,1280,1.0,0.0234375,0.9765625,500,0.3,0.309375,0.390625
1584,003,1775,73,534,401,1702,1775,1.0,0.04112676056338028,0.9588732394366197,840,0.3008450704225352,0.2259154929577465,0.4732394366197183
1585,003,28,9,13,14,19,28,2.076923076923077,0.32142857142857145,0.6785714285714286,1,0.4642857142857143,0.5,0.03571428571428571
1586,003,1413,12,454,509,1401,1413,1.0,0.008492569002123142,0.9915074309978769,450,0.3213021939136589,0.3602264685067233,0.3184713375796178
1588,003,687,15,160,215,672,687,1.0,0.021834061135371178,0.9781659388646288,312,0.2328966521106259,0.3129548762736536,0.45414847161572053
1589,003,1940,50,699,499,1890,1940,1.0,0.02577319587628866,0.9742268041237113,742,0.36030927835051546,0.2572164948453608,0.3824742268041237
1595,029,40,0,2,20,40,40,1.0,0.0,1.0,18,0.05,0.5,0.45
1596,029,7,1,0,0,6,7,1.0,0.14285714285714285,0.8571428571428571,7,0.0,0.0,1.0
1599,029,51,1,3,8,50,51,1.0,0.0196078431372549,0.9803921568627451,40,0.058823529411764705,0.1568627450980392,0.7843137254901961
1600,029,624,35,128,312,589,624,1.0,0.05608974358974359,0.9439102564102564,184,0.20512820512820512,0.5,0.2948717948717949
1601,029,1103,56,299,700,1047,1103,1.0,0.050770625566636446,0.9492293744333635,104,0.27107887579329104,0.6346328195829556,0.0942883046237534
1605,029,868,33,243,377,835,868,1.0,0.038018433179723504,0.9619815668202765,248,0.2799539170506912,0.434331797235023,0.2857142857142857
1606,029,384,24,127,240,360,384,1.0,0.0625,0.9375,17,0.3307291666666667,0.625,0.044270833333333336
1607,029,399,20,98,244,379,399,1.0,0.05012531328320802,0.949874686716792,57,0.24561403508771928,0.6115288220551378,0.14285714285714285
1609,029,9,0,0,0,9,9,1.0,0.0,1.0,9,0.0,0.0,1.0
1611,003,1815,36,507,563,1779,1815,1.0,0.019834710743801654,0.9801652892561984,745,0.2793388429752066,0.31019283746556475,0.41046831955922863
1612,003,1952,55,620,891,1897,1952,1.0,0.02817622950819672,0.9718237704918032,441,0.3176229508196721,0.45645491803278687,0.22592213114754098
1613,003,943,29,245,401,914,943,1.0,0.030752916224814422,0.9692470837751855,297,0.2598091198303287,0.4252386002120891,0.3149522799575822
1614,003,2565,60,761,567,2505,2565,1.0,0.023391812865497075,0.9766081871345029,1237,0.29668615984405455,0.22105263157894736,0.48226120857699806
1615,003,1338,28,462,536,1310,1338,1.0,0.02092675635276532,0.9790732436472347,340,0.3452914798206278,0.40059790732436473,0.25411061285500747
1616,023,855,38,133,256,817,855,1.0,0.044444444444444446,0.9555555555555556,466,0.15555555555555556,0.2994152046783626,0.5450292397660819
1617,023,729,34,100,278,695,729,1.0,0.04663923182441701,0.953360768175583,351,0.13717421124828533,0.3813443072702332,0.48148148148148145
1619,023,117,93,53,24,24,117,1.0,0.7948717948717948,0.20512820512820512,40,0.452991452991453,0.20512820512820512,0.3418803418803419
1620,023,22,0,5,17,22,22,1.5714285714285714,0.0,1.0,0,0.22727272727272727,0.7727272727272727,0.0
1621,023,75,10,5,50,65,75,1.0,0.13333333333333333,0.8666666666666667,20,0.06666666666666667,0.6666666666666666,0.26666666666666666
1622,023,40,23,13,6,17,40,1.0,0.575,0.425,21,0.325,0.15,0.525
1623,023,157,10,17,56,147,157,1.0,0.06369426751592357,0.9363057324840764,84,0.10828025477707007,0.35668789808917195,0.535031847133758
1624,023,644,30,95,316,614,644,1.0,0.046583850931677016,0.953416149068323,233,0.14751552795031056,0.4906832298136646,0.36180124223602483
1625,023,1994,65,336,813,1929,1994,1.0,0.03259779338014042,0.9674022066198595,845,0.16850551654964896,0.40772316950852555,0.4237713139418255
1626,023,2854,86,394,996,2768,2854,1.0,0.030133146461107218,0.9698668535388928,1464,0.13805185704274703,0.34898388227049754,0.5129642606867554
1627,023,2002,67,339,1009,1935,2002,1.0,0.033466533466533464,0.9665334665334665,654,0.16933066933066934,0.503996003996004,0.32667332667332666
1628,023,92,5,14,29,87,92,1.0,0.05434782608695652,0.9456521739130435,49,0.15217391304347827,0.31521739130434784,0.532608695652174
1629,023,1813,56,320,720,1757,1813,1.0,0.03088803088803089,0.9691119691119691,773,0.1765030336458908,0.3971318257032543,0.42636514065085496
1630,023,1328,54,201,433,1274,1328,1.0,0.04066265060240964,0.9593373493975904,694,0.15135542168674698,0.3260542168674699,0.5225903614457831
1631,023,2657,108,445,967,2549,2657,1.0,0.04064734663153933,0.9593526533684607,1245,0.16748212269476853,0.36394429808054196,0.4685735792246895
1632,023,2131,64,420,833,2067,2131,1.0,0.03003284842796809,0.969967151572032,878,0.1970905678085406,0.39089629282027216,0.4120131393711872
1633,023,2592,100,481,1119,2492,2592,1.0,0.038580246913580245,0.9614197530864198,992,0.18557098765432098,0.43171296296296297,0.38271604938271603
1634,023,2200,76,412,954,2124,2200,1.0,0.034545454545454546,0.9654545454545455,834,0.18727272727272729,0.43363636363636365,0.3790909090909091
1635,023,1354,50,121,262,1304,1354,1.0,0.03692762186115214,0.9630723781388478,971,0.08936484490398819,0.1935007385524372,0.7171344165435746
1636,023,3547,104,783,1754,3443,3547,1.0,0.02932055257964477,0.9706794474203553,1010,0.22074992951790245,0.4945023963913166,0.28474767409078094
1637,023,2685,88,539,1182,2597,2685,1.0,0.03277467411545624,0.9672253258845438,964,0.20074487895716947,0.4402234636871508,0.3590316573556797
1638,023,2167,66,291,638,2101,2167,1.0,0.030456852791878174,0.9695431472081218,1238,0.13428703276419013,0.29441624365482233,0.5712967235809875
1639,023,1286,54,361,812,1232,1286,1.0,0.041990668740279936,0.9580093312597201,113,0.2807153965785381,0.6314152410575428,0.08786936236391912
1640,023,605,25,19,349,580,605,1.0,0.04132231404958678,0.9586776859504132,237,0.03140495867768595,0.5768595041322314,0.39173553719008264
1641,023,103,5,15,27,98,103,1.0,0.04854368932038835,0.9514563106796117,61,0.14563106796116504,0.2621359223300971,0.5922330097087378
1642,023,618,35,56,336,583,618,1.0,0.05663430420711974,0.9433656957928802,226,0.09061488673139159,0.5436893203883495,0.3656957928802589
1643,023,165,12,13,49,153,165,1.0,0.07272727272727272,0.9272727272727272,103,0.07878787878787878,0.296969696969697,0.6242424242424243
1644,023,1184,60,201,476,1124,1184,1.0,0.05067567567567568,0.9493243243243243,507,0.16976351351351351,0.40202702702702703,0.4282094594594595
1645,023,2385,81,405,740,2304,2385,1.0,0.033962264150943396,0.9660377358490566,1240,0.16981132075471697,0.31027253668763105,0.519916142557652
1646,023,1402,55,238,629,1347,1402,1.0,0.039229671897289584,0.9607703281027105,535,0.16975748930099857,0.4486447931526391,0.38159771754636235
1647,023,1590,75,261,624,1515,1590,1.0,0.04716981132075472,0.9528301886792453,705,0.1641509433962264,0.39245283018867927,0.44339622641509435
1648,023,1719,90,188,753,1629,1719,1.0,0.05235602094240838,0.9476439790575916,778,0.10936591041303083,0.43804537521815007,0.4525887143688191
1649,021,135,9,17,69,126,135,1.0,0.06666666666666667,0.9333333333333333,49,0.1259259259259259,0.5111111111111111,0.362962962962963
1650,021,505,17,108,227,488,505,1.0,0.033663366336633666,0.9663366336633663,170,0.21386138613861386,0.4495049504950495,0.33663366336633666
1651,021,344,28,71,115,316,344,1.0,0.08139534883720931,0.9186046511627907,158,0.2063953488372093,0.33430232558139533,0.45930232558139533
1652,021,324,18,72,112,306,324,1.0,0.05555555555555555,0.9444444444444444,140,0.2222222222222222,0.345679012345679,0.43209876543209874
1653,021,500,25,92,239,475,500,1.0,0.05,0.95,169,0.184,0.478,0.338
1654,021,231,8,36,124,223,231,1.0,0.03463203463203463,0.9653679653679653,71,0.15584415584415584,0.5367965367965368,0.30735930735930733
1655,021,468,29,96,163,439,468,1.0,0.06196581196581197,0.938034188034188,209,0.20512820512820512,0.3482905982905983,0.4465811965811966
1656,021,367,21,67,165,346,367,1.0,0.05722070844686648,0.9427792915531336,135,0.18256130790190736,0.44959128065395093,0.3678474114441417
1657,021,3,1,0,0,2,3,1.0,0.3333333333333333,0.6666666666666666,3,0.0,0.0,1.0
1658,021,43,7,4,24,36,43,1.0,0.16279069767441862,0.8372093023255814,15,0.09302325581395349,0.5581395348837209,0.3488372093023256
1659,021,145,10,22,73,135,145,1.0,0.06896551724137931,0.9310344827586207,50,0.15172413793103448,0.503448275862069,0.3448275862068966
1660,021,566,497,239,109,69,566,1.0,0.8780918727915195,0.12190812720848057,218,0.42226148409893993,0.19257950530035337,0.38515901060070673
1661,031,616,8,319,282,608,616,1.0,0.012987012987012988,0.987012987012987,15,0.5178571428571429,0.4577922077922078,0.024350649350649352
1662,031,1082,13,438,577,1069,1082,1.0,0.012014787430683918,0.987985212569316,67,0.4048059149722736,0.533271719038817,0.06192236598890943
1663,031,500,9,200,270,491,500,1.0,0.018,0.982,30,0.4,0.54,0.06
1664,031,1352,25,722,565,1327,1352,1.0,0.01849112426035503,0.981508875739645,65,0.5340236686390533,0.41789940828402367,0.04807692307692308
1665,031,743,21,386,343,722,743,1.0,0.02826379542395693,0.971736204576043,14,0.5195154777927322,0.4616419919246299,0.018842530282637954
1666,031,581,7,326,243,574,581,1.0,0.012048192771084338,0.9879518072289156,12,0.5611015490533563,0.41824440619621345,0.020654044750430294
1667,031,1018,14,310,278,1004,1018,1.0,0.0137524557956778,0.9862475442043221,430,0.3045186640471513,0.2730844793713163,0.4223968565815324
1668,031,391,7,174,172,384,391,1.0,0.017902813299232736,0.9820971867007673,45,0.44501278772378516,0.4398976982097187,0.11508951406649616
1669,031,33,4,3,9,29,33,1.0,0.12121212121212122,0.8787878787878788,21,0.09090909090909091,0.2727272727272727,0.6363636363636364
1670,031,652,10,217,112,642,652,1.0,0.015337423312883436,0.9846625766871165,323,0.3328220858895706,0.17177914110429449,0.495398773006135
1671,031,635,2,227,387,633,635,1.0,0.0031496062992125984,0.9968503937007874,21,0.35748031496062993,0.6094488188976378,0.03307086614173228
1672,031,738,28,359,278,710,738,1.0,0.037940379403794036,0.962059620596206,101,0.48644986449864497,0.37669376693766937,0.13685636856368563
1673,031,606,14,331,219,592,606,1.0,0.0231023102310231,0.976897689768977,56,0.5462046204620462,0.3613861386138614,0.0924092409240924
1674,031,450,7,172,245,443,450,1.0,0.015555555555555555,0.9844444444444445,33,0.38222222222222224,0.5444444444444444,0.07333333333333333
1676,031,2278,120,435,190,2158,2278,1.0,0.05267778753292362,0.9473222124670764,1653,0.19095697980684812,0.08340649692712906,0.7256365232660228
1677,031,1670,80,242,201,1590,1670,1.0,0.04790419161676647,0.9520958083832335,1227,0.14491017964071856,0.12035928143712575,0.7347305389221557
1678,031,3,1,0,0,2,3,1.0,0.3333333333333333,0.6666666666666666,3,0.0,0.0,1.0
1679,031,684,21,247,175,663,684,1.0,0.03070175438596491,0.9692982456140351,262,0.3611111111111111,0.25584795321637427,0.3830409356725146
1680,031,438,5,248,106,433,438,1.0,0.01141552511415525,0.9885844748858448,84,0.5662100456621004,0.2420091324200913,0.1917808219178082
1681,031,1826,35,880,396,1791,1826,1.0,0.019167579408543262,0.9808324205914567,550,0.4819277108433735,0.21686746987951808,0.30120481927710846
1682,031,1252,23,403,251,1229,1252,1.0,0.018370607028753993,0.981629392971246,598,0.3218849840255591,0.20047923322683706,0.4776357827476038
1683,031,886,18,282,323,868,886,1.0,0.020316027088036117,0.9796839729119639,281,0.3182844243792325,0.36455981941309257,0.31715575620767494
1684,031,1031,27,401,483,1004,1031,1.0,0.026188166828322017,0.973811833171678,147,0.3889427740058196,0.4684772065955383,0.1425800193986421
1685,031,1556,22,724,606,1534,1556,1.0,0.014138817480719794,0.9858611825192802,226,0.4652956298200514,0.38946015424164526,0.14524421593830333
1686,031,932,545,319,190,387,932,1.0,0.5847639484978541,0.41523605150214593,423,0.34227467811158796,0.20386266094420602,0.453862660944206
1687,031,40,0,8,12,40,40,1.0,0.0,1.0,20,0.2,0.3,0.5
1689,031,463,14,169,136,449,463,1.0,0.03023758099352052,0.9697624190064795,158,0.3650107991360691,0.2937365010799136,0.3412526997840173
1693,031,12,0,4,8,12,12,1.0909090909090908,0.0,1.0,0,0.3333333333333333,0.6666666666666666,0.0
1696,031,272,8,58,160,264,272,1.0,0.029411764705882353,0.9705882352941176,54,0.21323529411764705,0.5882352941176471,0.19852941176470587
1697,031,2823,147,895,794,2676,2823,1.0,0.052072263549415514,0.9479277364505845,1134,0.31703861140630535,0.2812610697839178,0.40170031880977686
1698,031,2344,99,568,522,2245,2344,1.0,0.04223549488054607,0.9577645051194539,1254,0.24232081911262798,0.2226962457337884,0.5349829351535836
1699,031,2504,77,745,544,2427,2504,1.0,0.03075079872204473,0.9692492012779552,1215,0.2975239616613419,0.21725239616613418,0.48522364217252395
1700,031,1153,72,353,311,1081,1153,1.0,0.062445793581960105,0.9375542064180399,489,0.3061578490893322,0.2697311361665221,0.4241110147441457
1701,031,330,12,59,75,318,330,1.0,0.03636363636363636,0.9636363636363636,196,0.1787878787878788,0.22727272727272727,0.593939393939394
1702,031,2236,86,633,862,2150,2236,1.0,0.038461538461538464,0.9615384615384616,741,0.2830948121645796,0.3855098389982111,0.3313953488372093
1703,031,740,21,170,486,719,740,1.0,0.02837837837837838,0.9716216216216216,84,0.22972972972972974,0.6567567567567567,0.11351351351351352
1704,031,2,0,0,0,2,2,1.0,0.0,1.0,2,0.0,0.0,1.0
1705,031,2236,95,591,1085,2141,2236,1.0,0.042486583184257604,0.9575134168157424,560,0.2643112701252236,0.48524150268336314,0.2504472271914132
1706,031,1728,72,513,420,1656,1728,1.0,0.041666666666666664,0.9583333333333334,795,0.296875,0.24305555555555555,0.4600694444444444
1707,031,1655,56,437,730,1599,1655,1.0,0.033836858006042296,0.9661631419939577,488,0.26404833836858005,0.44108761329305135,0.2948640483383686
1708,031,916,38,229,367,878,916,1.0,0.04148471615720524,0.9585152838427947,320,0.25,0.40065502183406115,0.34934497816593885
1709,031,851,36,225,467,815,851,1.0,0.04230317273795535,0.9576968272620446,159,0.26439482961222094,0.5487661574618097,0.18683901292596944
1710,031,570,13,139,201,557,570,1.0,0.02280701754385965,0.9771929824561404,230,0.24385964912280703,0.3526315789473684,0.40350877192982454
1711,031,1776,96,452,833,1680,1776,1.0,0.05405405405405406,0.9459459459459459,491,0.2545045045045045,0.46903153153153154,0.27646396396396394
1712,031,1023,48,344,242,975,1023,1.0,0.0469208211143695,0.9530791788856305,437,0.3362658846529814,0.23655913978494625,0.42717497556207235
1713,031,403,2,118,214,401,403,1.0,0.004962779156327543,0.9950372208436724,71,0.29280397022332505,0.5310173697270472,0.1761786600496278
1714,031,7,2,0,0,5,7,1.0,0.2857142857142857,0.7142857142857143,7,0.0,0.0,1.0
1718,031,124,4,46,19,120,124,1.0,0.03225806451612903,0.967741935483871,59,0.3709677419354839,0.1532258064516129,0.47580645161290325
1720,031,1884,44,600,590,1840,1884,1.0,0.02335456475583864,0.9766454352441614,694,0.3184713375796178,0.31316348195329086,0.36836518046709127
1721,031,531,13,277,168,518,531,1.0,0.02448210922787194,0.975517890772128,86,0.5216572504708098,0.3163841807909605,0.16195856873822975
1723,031,296,7,140,154,289,296,1.0,0.02364864864864865,0.9763513513513513,2,0.47297297297297297,0.5202702702702703,0.006756756756756757
1724,031,180,0,52,111,180,180,1.0,0.0,1.0,17,0.28888888888888886,0.6166666666666667,0.09444444444444444
1725,031,174,10,66,101,164,174,1.0,0.05747126436781609,0.9425287356321839,7,0.3793103448275862,0.5804597701149425,0.040229885057471264
1726,031,656,23,249,173,633,656,1.0,0.0350609756097561,0.9649390243902439,234,0.3795731707317073,0.26371951219512196,0.3567073170731707
1727,031,72,11,0,0,61,72,1.0,0.1527777777777778,0.8472222222222222,72,0.0,0.0,1.0
1728,031,1320,49,367,193,1271,1320,1.0,0.037121212121212124,0.9628787878787879,760,0.278030303030303,0.1462121212121212,0.5757575757575758
1729,031,1507,66,254,161,1441,1507,1.0,0.043795620437956206,0.9562043795620438,1092,0.16854678168546783,0.10683477106834771,0.7246184472461845
1731,031,2513,135,910,286,2378,2513,1.0,0.05372065260644648,0.9462793473935536,1317,0.362116991643454,0.11380819737365698,0.524074810982889
1732,031,1022,32,277,246,990,1022,1.0,0.03131115459882583,0.9686888454011742,499,0.2710371819960861,0.24070450097847357,0.4882583170254403
1733,031,1890,124,589,206,1766,1890,1.0,0.0656084656084656,0.9343915343915344,1095,0.31164021164021166,0.10899470899470899,0.5793650793650794
1734,031,1620,51,682,477,1569,1620,1.0,0.03148148148148148,0.9685185185185186,461,0.42098765432098767,0.29444444444444445,0.2845679012345679
1735,031,1124,30,507,436,1094,1124,1.0,0.026690391459074734,0.9733096085409253,181,0.451067615658363,0.3879003558718861,0.1610320284697509
1736,031,1205,45,617,294,1160,1205,1.0,0.03734439834024896,0.9626556016597511,294,0.5120331950207468,0.24398340248962655,0.24398340248962655
1737,031,1618,74,637,432,1544,1618,1.0,0.04573547589616811,0.9542645241038319,549,0.3936959208899876,0.2669962917181706,0.33930778739184175
1738,031,881,50,143,48,831,881,1.0,0.056753688989784334,0.9432463110102156,690,0.1623155505107832,0.05448354143019296,0.7832009080590239
1739,031,1480,48,617,456,1432,1480,1.0,0.032432432432432434,0.9675675675675676,407,0.4168918918918919,0.3081081081081081,0.275
1740,031,1788,76,649,496,1712,1788,1.0,0.042505592841163314,0.9574944071588367,643,0.3629753914988814,0.27740492170022374,0.35961968680089484
1741,031,1340,46,551,320,1294,1340,1.0,0.034328358208955224,0.9656716417910448,469,0.41119402985074627,0.23880597014925373,0.35
1742,031,619,25,171,88,594,619,1.0,0.04038772213247173,0.9596122778675282,360,0.2762520193861066,0.1421647819063005,0.5815831987075929
1743,031,1047,39,312,236,1008,1047,1.0,0.03724928366762178,0.9627507163323782,499,0.2979942693409742,0.22540592168099333,0.47659980897803245
1744,031,2336,69,874,890,2267,2336,1.0,0.029537671232876712,0.9704623287671232,572,0.3741438356164384,0.3809931506849315,0.24486301369863014
1745,031,909,36,348,291,873,909,1.0,0.039603960396039604,0.9603960396039604,270,0.38283828382838286,0.3201320132013201,0.297029702970297
1747,031,43,0,12,21,43,43,1.0,0.0,1.0,10,0.27906976744186046,0.4883720930232558,0.23255813953488372
1748,031,539,12,140,61,527,539,1.0,0.022263450834879406,0.9777365491651205,338,0.2597402597402597,0.11317254174397032,0.62708719851577
1749,031,1222,70,561,366,1152,1222,1.0,0.057283142389525366,0.9427168576104746,295,0.4590834697217676,0.2995090016366612,0.2414075286415712
1750,031,1367,30,522,704,1337,1367,1.0,0.021945866861741038,0.978054133138259,141,0.38185808339429406,0.514996342355523,0.10314557425018288
1751,031,1595,51,595,370,1544,1595,1.0,0.03197492163009404,0.9680250783699059,630,0.3730407523510972,0.23197492163009403,0.3949843260188088
1752,031,1662,72,599,367,1590,1662,1.0,0.04332129963898917,0.9566787003610109,696,0.36040914560770154,0.22081829121540314,0.4187725631768953
1753,031,861,17,334,212,844,861,1.0,0.019744483159117306,0.9802555168408827,315,0.3879210220673635,0.2462253193960511,0.36585365853658536
1754,031,1764,61,515,349,1703,1764,1.0,0.03458049886621315,0.9654195011337868,900,0.2919501133786848,0.19784580498866214,0.5102040816326531
1755,031,1771,63,596,393,1708,1771,1.0,0.03557312252964427,0.9644268774703557,782,0.3365330321852061,0.22190852625635235,0.44155844155844154
1756,031,1135,20,436,402,1115,1135,1.0,0.01762114537444934,0.9823788546255506,297,0.3841409691629956,0.3541850220264317,0.2616740088105727
1758,031,963,40,413,139,923,963,1.0,0.04153686396677051,0.9584631360332295,411,0.4288681204569055,0.14434060228452752,0.42679127725856697
1759,031,1864,47,715,339,1817,1864,1.0,0.02521459227467811,0.9747854077253219,810,0.38358369098712447,0.18186695278969958,0.434549356223176
1760,031,690,16,233,348,674,690,1.0,0.02318840579710145,0.9768115942028985,109,0.33768115942028987,0.5043478260869565,0.15797101449275364
1761,031,426,9,101,269,417,426,1.0,0.02112676056338028,0.9788732394366197,56,0.23708920187793428,0.6314553990610329,0.13145539906103287
1762,031,837,19,286,449,818,837,1.0,0.022700119474313024,0.977299880525687,102,0.34169653524492233,0.5364396654719236,0.12186379928315412
1763,031,573,8,195,247,565,573,1.0,0.013961605584642234,0.9860383944153578,131,0.3403141361256545,0.43106457242582896,0.2286212914485166
1764,031,1403,91,332,475,1312,1403,1.0,0.06486101211689238,0.9351389878831077,596,0.23663578047042053,0.33856022808268,0.4248039914468995
1766,031,5,1,0,0,4,5,1.0,0.2,0.8,5,0.0,0.0,1.0
1767,031,904,11,355,479,893,904,1.0,0.012168141592920354,0.9878318584070797,70,0.3926991150442478,0.5298672566371682,0.07743362831858407
1768,031,58,3,11,21,55,58,1.0,0.05172413793103448,0.9482758620689655,26,0.1896551724137931,0.3620689655172414,0.4482758620689655
1769,031,101,5,35,36,96,101,1.0,0.04950495049504951,0.9504950495049505,30,0.3465346534653465,0.3564356435643564,0.297029702970297
1770,031,985,20,404,480,965,985,1.0,0.02030456852791878,0.9796954314720813,101,0.4101522842639594,0.4873096446700508,0.10253807106598985
1771,031,130,3,42,87,127,130,1.0078125,0.023076923076923078,0.9769230769230769,1,0.3230769230769231,0.6692307692307692,0.007692307692307693
1772,031,940,36,330,317,904,940,1.0,0.03829787234042553,0.9617021276595744,293,0.35106382978723405,0.3372340425531915,0.31170212765957445
1773,031,691,14,254,295,677,691,1.0,0.020260492040520984,0.9797395079594791,142,0.3675832127351664,0.426917510853835,0.20549927641099855
1775,031,430,9,152,225,421,430,1.0,0.020930232558139535,0.9790697674418605,53,0.35348837209302325,0.5232558139534884,0.12325581395348838
1776,031,12,1,0,0,11,12,1.0,0.08333333333333333,0.9166666666666666,12,0.0,0.0,1.0
1777,031,1299,20,688,522,1279,1299,1.0,0.015396458814472672,0.9846035411855273,89,0.5296381832178599,0.4018475750577367,0.06851424172440339
1778,031,606,11,209,275,595,606,1.0,0.018151815181518153,0.9818481848184818,122,0.3448844884488449,0.4537953795379538,0.20132013201320131
1779,031,760,10,370,312,750,760,1.0,0.013157894736842105,0.9868421052631579,78,0.4868421052631579,0.4105263157894737,0.10263157894736842
1780,031,692,4,338,293,688,692,1.0,0.005780346820809248,0.9942196531791907,61,0.4884393063583815,0.4234104046242775,0.08815028901734104
1781,031,396,5,238,142,391,396,1.0,0.012626262626262626,0.9873737373737373,16,0.601010101010101,0.35858585858585856,0.04040404040404041
1782,031,859,28,369,434,831,859,1.0,0.03259604190919674,0.9674039580908033,56,0.42956926658905703,0.5052386495925495,0.06519208381839348
1783,031,1347,32,723,458,1315,1347,1.0,0.023756495916852263,0.9762435040831478,166,0.5367483296213809,0.340014847809948,0.12323682256867112
1784,031,726,23,301,252,703,726,1.0,0.03168044077134986,0.9683195592286501,173,0.41460055096418735,0.34710743801652894,0.23829201101928374
1785,031,352,9,118,205,343,352,1.0,0.02556818181818182,0.9744318181818182,29,0.3352272727272727,0.5823863636363636,0.08238636363636363
1786,031,225,0,78,147,225,225,1.076555023923445,0.0,1.0,0,0.3466666666666667,0.6533333333333333,0.0
1787,031,1484,39,709,246,1445,1484,1.0,0.02628032345013477,0.9737196765498652,529,0.4777628032345013,0.16576819407008087,0.3564690026954178
1788,031,1058,9,609,338,1049,1058,1.0,0.008506616257088847,0.9914933837429112,111,0.5756143667296786,0.31947069943289225,0.10491493383742911
1789,031,1370,37,725,452,1333,1370,1.0,0.027007299270072994,0.972992700729927,193,0.5291970802919708,0.32992700729927005,0.14087591240875913
1790,031,555,18,204,297,537,555,1.0,0.032432432432432434,0.9675675675675676,54,0.3675675675675676,0.5351351351351351,0.0972972972972973
1795,031,885,35,462,170,850,885,1.0,0.03954802259887006,0.96045197740113,253,0.5220338983050847,0.192090395480226,0.2858757062146893
1796,031,1104,19,612,434,1085,1104,1.0,0.017210144927536232,0.9827898550724637,58,0.5543478260869565,0.39311594202898553,0.05253623188405797
1797,031,707,26,396,160,681,707,1.0,0.036775106082036775,0.9632248939179632,151,0.5601131541725601,0.2263083451202263,0.21357850070721357
1798,031,663,20,352,122,643,663,1.0,0.030165912518853696,0.9698340874811463,189,0.530920060331825,0.18401206636500755,0.2850678733031674
1799,031,627,15,270,231,612,627,1.0,0.023923444976076555,0.9760765550239234,126,0.430622009569378,0.3684210526315789,0.20095693779904306
1800,031,1206,41,304,269,1165,1206,1.0,0.03399668325041459,0.9660033167495854,633,0.25207296849087896,0.2230514096185738,0.5248756218905473
1802,031,828,21,426,317,807,828,1.0,0.025362318840579712,0.9746376811594203,85,0.5144927536231884,0.3828502415458937,0.10265700483091787
1803,031,990,13,523,362,977,990,1.0,0.013131313131313131,0.9868686868686869,105,0.5282828282828282,0.3656565656565657,0.10606060606060606
1804,031,1931,86,464,436,1845,1931,1.0,0.044536509580528225,0.9554634904194718,1031,0.24029000517866392,0.22578974624546866,0.5339202485758674
1805,031,988,38,318,226,950,988,1.0,0.038461538461538464,0.9615384615384616,444,0.32186234817813764,0.22874493927125505,0.4493927125506073
1807,031,12,0,0,0,12,12,1.0,0.0,1.0,12,0.0,0.0,1.0
1808,031,658,7,217,333,651,658,1.0,0.010638297872340425,0.9893617021276596,108,0.32978723404255317,0.506079027355623,0.1641337386018237
1809,031,221,17,33,17,204,221,1.0,0.07692307692307693,0.9230769230769231,171,0.1493212669683258,0.07692307692307693,0.7737556561085973
1810,031,281,12,54,21,269,281,1.0,0.042704626334519574,0.9572953736654805,206,0.19217081850533807,0.07473309608540925,0.7330960854092526
1811,031,1575,47,598,435,1528,1575,1.0,0.029841269841269842,0.9701587301587301,542,0.3796825396825397,0.2761904761904762,0.3441269841269841
1812,031,4,0,0,0,4,4,1.0,0.0,1.0,4,0.0,0.0,1.0
1813,031,1982,87,475,215,1895,1982,1.0,0.04389505549949546,0.9561049445005045,1292,0.239656912209889,0.10847628657921292,0.6518668012108981
1814,031,22,0,9,2,22,22,1.0,0.0,1.0,11,0.4090909090909091,0.09090909090909091,0.5
1815,031,176,1,41,103,175,176,1.0,0.005681818181818182,0.9943181818181818,32,0.23295454545454544,0.5852272727272727,0.18181818181818182
1816,031,967,5,540,397,962,967,1.0,0.005170630816959669,0.9948293691830403,30,0.5584281282316442,0.4105480868665977,0.031023784901758014
1817,031,1049,17,424,434,1032,1049,1.0,0.016205910390848427,0.9837940896091516,191,0.4041944709246902,0.41372735938989513,0.18207816968541468
1818,031,1665,37,763,572,1628,1665,1.0,0.022222222222222223,0.9777777777777777,330,0.4582582582582583,0.34354354354354355,0.1981981981981982
1819,031,546,34,176,124,512,546,1.0,0.06227106227106227,0.9377289377289377,246,0.32234432234432236,0.2271062271062271,0.45054945054945056
1820,031,2127,69,789,522,2058,2127,1.0,0.03244005641748942,0.9675599435825106,816,0.3709449929478138,0.2454160789844852,0.383638928067701
1821,031,772,17,327,289,755,772,1.0,0.022020725388601035,0.977979274611399,156,0.42357512953367876,0.3743523316062176,0.20207253886010362
1822,031,1432,62,493,145,1370,1432,1.0,0.04329608938547486,0.9567039106145251,794,0.3442737430167598,0.10125698324022346,0.5544692737430168
1823,031,516,36,164,127,480,516,1.0,0.06976744186046512,0.9302325581395349,225,0.3178294573643411,0.24612403100775193,0.436046511627907
1824,031,1465,27,592,512,1438,1465,1.0,0.018430034129692834,0.9815699658703072,361,0.4040955631399317,0.34948805460750854,0.24641638225255974
1825,031,539,16,182,100,523,539,1.0,0.029684601113172542,0.9703153988868275,257,0.33766233766233766,0.18552875695732837,0.47680890538033394
1826,031,636,27,177,119,609,636,1.0,0.04245283018867924,0.9575471698113207,340,0.2783018867924528,0.1871069182389937,0.5345911949685535
1827,031,517,37,125,92,480,517,1.0,0.07156673114119923,0.9284332688588007,300,0.24177949709864605,0.17794970986460348,0.5802707930367504
1828,031,118,10,20,20,108,118,1.0,0.0847457627118644,0.9152542372881356,78,0.1694915254237288,0.1694915254237288,0.6610169491525424
1829,031,1507,74,334,215,1433,1507,1.0,0.0491041804910418,0.9508958195089582,958,0.2216323822163238,0.1426675514266755,0.6357000663570007
1830,031,1892,111,581,465,1781,1892,1.0,0.05866807610993657,0.9413319238900634,846,0.3070824524312896,0.24577167019027485,0.44714587737843553
1831,031,49,4,11,6,45,49,1.0,0.08163265306122448,0.9183673469387755,32,0.22448979591836735,0.12244897959183673,0.6530612244897959
1832,031,1362,82,432,293,1280,1362,1.0,0.06020558002936858,0.9397944199706314,637,0.31718061674008813,0.21512481644640236,0.46769456681350957
1833,031,3103,131,741,419,2972,3103,1.0,0.04221720915243313,0.9577827908475669,1943,0.23880116016757977,0.13503061553335483,0.6261682242990654
1834,031,269,16,89,40,253,269,1.0,0.05947955390334572,0.9405204460966543,140,0.3308550185873606,0.14869888475836432,0.5204460966542751
1835,031,1219,37,400,322,1182,1219,1.0,0.030352748154224774,0.9696472518457753,497,0.3281378178835111,0.2641509433962264,0.4077112387202625
1836,031,885,35,280,276,850,885,1.0,0.03954802259887006,0.96045197740113,329,0.3163841807909605,0.31186440677966104,0.37175141242937854
1837,031,684,36,252,222,648,684,1.0,0.05263157894736842,0.9473684210526315,210,0.3684210526315789,0.32456140350877194,0.30701754385964913
1838,031,2078,96,725,334,1982,2078,1.0,0.04619826756496631,0.9538017324350336,1019,0.348893166506256,0.16073147256977863,0.49037536092396533
1839,031,514,21,177,139,493,514,1.0,0.04085603112840467,0.9591439688715954,198,0.3443579766536965,0.2704280155642023,0.3852140077821012
1840,031,2036,76,633,255,1960,2036,1.0,0.03732809430255403,0.962671905697446,1148,0.31090373280943023,0.12524557956777996,0.5638506876227898
1841,031,1998,57,728,829,1941,1998,1.0,0.028528528528528527,0.9714714714714715,441,0.36436436436436437,0.4149149149149149,0.22072072072072071
1842,031,1044,34,342,170,1010,1044,1.0,0.032567049808429116,0.9674329501915708,532,0.3275862068965517,0.16283524904214558,0.5095785440613027
1843,031,1134,49,288,275,1085,1134,1.0,0.043209876543209874,0.9567901234567902,571,0.25396825396825395,0.24250440917107582,0.5035273368606702
1844,031,180,22,52,45,158,180,1.0,0.12222222222222222,0.8777777777777778,83,0.28888888888888886,0.25,0.46111111111111114
1845,031,29,6,7,8,23,29,1.0,0.20689655172413793,0.7931034482758621,14,0.2413793103448276,0.27586206896551724,0.4827586206896552
1846,031,1244,34,486,536,1210,1244,1.0,0.027331189710610933,0.9726688102893891,222,0.39067524115755625,0.43086816720257237,0.17845659163987138
1847,031,980,29,332,445,951,980,1.0,0.02959183673469388,0.9704081632653061,203,0.33877551020408164,0.45408163265306123,0.20714285714285716
1848,031,1239,57,383,313,1182,1239,1.0,0.04600484261501211,0.9539951573849879,543,0.30912025827280065,0.25262308313155774,0.43825665859564167
1849,031,1571,75,414,287,1496,1571,1.0,0.047740292807129214,0.9522597071928708,870,0.2635264162953533,0.18268618714194781,0.5537873965626989
1850,031,299,279,148,13,20,299,1.0,0.9331103678929766,0.06688963210702341,138,0.49498327759197325,0.043478260869565216,0.46153846153846156
1851,031,58,2,8,33,56,58,1.0,0.034482758620689655,0.9655172413793104,17,0.13793103448275862,0.5689655172413793,0.29310344827586204
1852,031,1658,87,409,287,1571,1658,1.0,0.05247285886610374,0.9475271411338962,962,0.24668275030156817,0.17310012062726177,0.5802171290711701
1853,031,2355,91,557,307,2264,2355,1.0,0.038641188959660296,0.9613588110403397,1491,0.23651804670912951,0.13036093418259023,0.6331210191082802
1854,031,148,12,15,14,136,148,1.0,0.08108108108108109,0.918918918918919,119,0.10135135135135136,0.0945945945945946,0.8040540540540541
1855,031,2109,119,621,243,1990,2109,1.0,0.056424845898530106,0.9435751541014699,1245,0.29445234708392604,0.11522048364153627,0.5903271692745377
1856,031,1887,55,691,457,1832,1887,1.0,0.029146793852676205,0.9708532061473238,739,0.3661897191308956,0.24218335983041867,0.39162692103868574
1857,031,1022,42,462,281,980,1022,1.0,0.0410958904109589,0.958904109589041,279,0.4520547945205479,0.27495107632093935,0.27299412915851273
1859,031,131,5,52,35,126,131,1.0,0.03816793893129771,0.9618320610687023,44,0.3969465648854962,0.26717557251908397,0.33587786259541985
1860,031,1478,74,379,211,1404,1478,1.0,0.05006765899864682,0.9499323410013532,888,0.2564276048714479,0.14276048714479025,0.6008119079837618
1861,031,2384,55,461,134,2329,2384,1.0,0.02307046979865772,0.9769295302013423,1789,0.19337248322147652,0.05620805369127517,0.7504194630872483
1862,031,12,1,0,0,11,12,1.0,0.08333333333333333,0.9166666666666666,12,0.0,0.0,1.0
1863,031,471,27,148,150,444,471,1.0,0.05732484076433121,0.9426751592356688,173,0.31422505307855625,0.3184713375796178,0.3673036093418259
1864,031,2526,40,1048,1085,2486,2526,1.0,0.01583531274742676,0.9841646872525732,393,0.41488519398258117,0.42953285827395093,0.15558194774346792
1865,031,1236,39,515,629,1197,1236,1.0,0.03155339805825243,0.9684466019417476,92,0.4166666666666667,0.5088996763754046,0.0744336569579288
1866,031,1404,65,559,379,1339,1404,1.0,0.046296296296296294,0.9537037037037037,466,0.39814814814814814,0.26994301994301995,0.3319088319088319
1867,031,2169,60,675,537,2109,2169,1.0,0.027662517289073305,0.9723374827109267,957,0.3112033195020747,0.2475795297372061,0.4412171507607192
1868,031,1662,38,613,434,1624,1662,1.0,0.02286401925391095,0.9771359807460891,615,0.36883273164861613,0.2611311672683514,0.3700361010830325
1869,031,2003,83,671,512,1920,2003,1.0,0.04143784323514728,0.9585621567648527,820,0.3349975037443834,0.2556165751372941,0.4093859211183225
1870,031,1454,55,768,306,1399,1454,1.0,0.03782668500687758,0.9621733149931224,380,0.5281980742778541,0.21045392022008252,0.2613480055020633
1871,031,1108,28,216,140,1080,1108,1.0,0.02527075812274368,0.9747292418772563,752,0.19494584837545126,0.1263537906137184,0.6787003610108303
1873,031,862,32,205,88,830,862,1.0,0.037122969837587005,0.962877030162413,569,0.23781902552204176,0.10208816705336426,0.660092807424594
1874,031,2026,50,705,307,1976,2026,1.0,0.024679170779861797,0.9753208292201382,1014,0.34797630799605134,0.15153010858835142,0.5004935834155972
1875,031,1214,43,457,514,1171,1214,1.0,0.03542009884678748,0.9645799011532126,243,0.37644151565074135,0.4233937397034596,0.200164744645799
1876,031,1526,48,664,375,1478,1526,1.0,0.03145478374836173,0.9685452162516383,487,0.4351245085190039,0.24574049803407602,0.31913499344692003
1877,031,971,27,376,182,944,971,1.0,0.027806385169927908,0.972193614830072,413,0.38722966014418125,0.1874356333676622,0.4253347064881565
1878,031,1084,69,300,184,1015,1084,1.0,0.06365313653136531,0.9363468634686347,600,0.2767527675276753,0.16974169741697417,0.5535055350553506
1879,031,316,14,52,19,302,316,1.0,0.04430379746835443,0.9556962025316456,245,0.16455696202531644,0.060126582278481014,0.7753164556962026
1880,031,960,33,218,162,927,960,1.0,0.034375,0.965625,580,0.22708333333333333,0.16875,0.6041666666666666
1881,031,1065,59,233,192,1006,1065,1.0,0.05539906103286385,0.9446009389671362,640,0.2187793427230047,0.18028169014084508,0.6009389671361502
1882,031,2626,95,761,377,2531,2626,1.0,0.036176694592536175,0.9638233054074639,1488,0.2897943640517898,0.14356435643564355,0.5666412795125666
1883,031,89,6,29,47,83,89,1.0,0.06741573033707865,0.9325842696629213,13,0.3258426966292135,0.5280898876404494,0.14606741573033707
1884,031,2745,57,1080,1107,2688,2745,1.0,0.020765027322404372,0.9792349726775956,558,0.39344262295081966,0.40327868852459015,0.20327868852459016
1885,031,2311,111,526,281,2200,2311,1.0,0.048031155344006926,0.9519688446559931,1504,0.2276070964950238,0.12159238424924275,0.6508005192557335
1886,031,315,31,78,107,284,315,1.0,0.09841269841269841,0.9015873015873016,130,0.24761904761904763,0.3396825396825397,0.4126984126984127
1887,031,2547,72,529,379,2475,2547,1.0,0.028268551236749116,0.9717314487632509,1639,0.20769532783667058,0.14880251276010995,0.6435021594032194
1888,031,1728,68,678,500,1660,1728,1.0,0.03935185185185185,0.9606481481481481,550,0.3923611111111111,0.28935185185185186,0.31828703703703703
1889,031,2260,64,732,821,2196,2260,1.0,0.02831858407079646,0.9716814159292035,707,0.3238938053097345,0.36327433628318584,0.31283185840707967
1890,031,937,22,349,308,915,937,1.0,0.023479188900747065,0.9765208110992529,280,0.37246531483457845,0.3287086446104589,0.29882604055496265
1891,031,741,28,264,168,713,741,1.0,0.037786774628879895,0.9622132253711201,309,0.3562753036437247,0.22672064777327935,0.41700404858299595
1892,031,1465,40,485,302,1425,1465,1.0,0.027303754266211604,0.9726962457337884,678,0.3310580204778157,0.20614334470989762,0.46279863481228667
1893,031,2760,92,846,469,2668,2760,1.0,0.03333333333333333,0.9666666666666667,1445,0.3065217391304348,0.16992753623188406,0.5235507246376812
1894,031,1200,38,211,77,1162,1200,1.0,0.03166666666666667,0.9683333333333334,912,0.17583333333333334,0.06416666666666666,0.76
1895,031,106,2,27,55,104,106,1.0,0.018867924528301886,0.9811320754716981,24,0.25471698113207547,0.5188679245283019,0.22641509433962265
1896,031,1104,34,375,228,1070,1104,1.0,0.030797101449275364,0.9692028985507246,501,0.33967391304347827,0.20652173913043478,0.453804347826087
1897,031,1071,35,393,273,1036,1071,1.0,0.032679738562091505,0.9673202614379085,405,0.36694677871148457,0.2549019607843137,0.37815126050420167
1898,031,1110,25,452,392,1085,1110,1.0,0.02252252252252252,0.9774774774774775,266,0.4072072072072072,0.35315315315315315,0.23963963963963963
1900,031,1665,80,604,639,1585,1665,1.0,0.04804804804804805,0.9519519519519519,422,0.36276276276276276,0.3837837837837838,0.25345345345345344
1901,031,773,26,390,286,747,773,1.0,0.03363518758085381,0.9663648124191462,97,0.5045278137128072,0.36998706338939197,0.12548512289780078
1902,031,2101,28,808,1028,2073,2101,1.0,0.013326987148976678,0.9866730128510233,265,0.38457877201332696,0.4892908138981437,0.12613041408852926
1903,031,56,0,26,28,56,56,1.0,0.0,1.0,2,0.4642857142857143,0.5,0.03571428571428571
1904,031,43,7,0,0,36,43,1.0,0.16279069767441862,0.8372093023255814,43,0.0,0.0,1.0
1905,031,1152,27,291,731,1125,1152,1.0,0.0234375,0.9765625,130,0.2526041666666667,0.6345486111111112,0.11284722222222222
1906,031,1693,53,537,816,1640,1693,1.0,0.03130537507383343,0.9686946249261665,340,0.31718842291789723,0.4819846426461902,0.20082693443591257
1907,031,561,18,211,265,543,561,1.0,0.03208556149732621,0.9679144385026738,85,0.3761140819964349,0.47237076648841353,0.15151515151515152
1908,031,50,6,14,16,44,50,1.0,0.12,0.88,20,0.28,0.32,0.4
1909,031,749,26,297,297,723,749,1.0,0.03471295060080107,0.965287049399199,155,0.3965287049399199,0.3965287049399199,0.20694259012016022
1910,031,1254,50,357,613,1204,1254,1.0,0.03987240829346093,0.960127591706539,284,0.284688995215311,0.48883572567783096,0.22647527910685805
1911,031,820,24,181,535,796,820,1.0,0.02926829268292683,0.9707317073170731,104,0.22073170731707317,0.6524390243902439,0.12682926829268293
1912,031,1487,47,472,698,1440,1487,1.0,0.03160726294552791,0.968392737054472,317,0.31741761936785473,0.4694014794889038,0.21318090114324142
1913,031,214,5,80,73,209,214,1.0,0.02336448598130841,0.9766355140186916,61,0.37383177570093457,0.3411214953271028,0.2850467289719626
1914,031,1922,76,698,594,1846,1922,1.0,0.03954214360041623,0.9604578563995838,630,0.3631633714880333,0.3090530697190427,0.32778355879292403
1915,031,1602,35,534,531,1567,1602,1.0,0.02184769038701623,0.9781523096129837,537,0.3333333333333333,0.33146067415730335,0.3352059925093633
1916,031,1698,68,462,906,1630,1698,1.0,0.04004711425206125,0.9599528857479388,330,0.27208480565371024,0.5335689045936396,0.19434628975265017
1917,031,145,0,45,91,145,145,1.0,0.0,1.0,9,0.3103448275862069,0.6275862068965518,0.06206896551724138
1918,031,430,6,245,184,424,430,1.0,0.013953488372093023,0.986046511627907,1,0.5697674418604651,0.42790697674418604,0.002325581395348837
1919,031,1455,64,380,843,1391,1455,1.0,0.04398625429553265,0.9560137457044674,232,0.2611683848797251,0.5793814432989691,0.15945017182130583
1920,031,1389,61,396,461,1328,1389,1.0,0.043916486681065514,0.9560835133189345,532,0.28509719222462204,0.33189344852411806,0.3830093592512599
1921,031,1179,36,338,212,1143,1179,1.0,0.030534351145038167,0.9694656488549618,629,0.2866836301950806,0.179813401187447,0.5335029686174725
1923,031,1559,82,553,393,1477,1559,1.0,0.05259781911481719,0.9474021808851828,613,0.35471456061577933,0.2520846696600385,0.39320076972418216
1924,031,1129,30,386,376,1099,1129,1.0,0.026572187776793623,0.9734278122232064,367,0.34189548272807796,0.3330380868024801,0.325066430469442
1925,031,1500,69,501,308,1431,1500,1.0,0.046,0.954,691,0.334,0.20533333333333334,0.46066666666666667
1926,031,878,30,393,431,848,878,1.0,0.03416856492027335,0.9658314350797267,54,0.44760820045558086,0.4908883826879271,0.06150341685649203
1927,031,193,2,53,139,191,193,1.0158730158730158,0.010362694300518135,0.9896373056994818,1,0.27461139896373055,0.7202072538860104,0.0051813471502590676
1928,031,1122,49,299,646,1073,1122,1.0,0.04367201426024955,0.9563279857397504,177,0.26648841354723707,0.5757575757575758,0.15775401069518716
1929,031,1806,43,578,824,1763,1806,1.0,0.023809523809523808,0.9761904761904762,404,0.32004429678848284,0.45625692137320045,0.22369878183831673
1931,031,1851,45,480,958,1806,1851,1.0,0.024311183144246355,0.9756888168557536,413,0.2593192868719611,0.5175580767152891,0.22312263641274988
1932,031,205,6,67,107,199,205,1.0,0.02926829268292683,0.9707317073170731,31,0.32682926829268294,0.5219512195121951,0.15121951219512195
1933,031,1510,52,632,655,1458,1510,1.0,0.03443708609271523,0.9655629139072848,223,0.4185430463576159,0.4337748344370861,0.147682119205298
1934,031,1772,55,621,766,1717,1772,1.0,0.031038374717832957,0.968961625282167,385,0.35045146726862303,0.4322799097065463,0.2172686230248307
1935,031,900,23,418,201,877,900,1.0,0.025555555555555557,0.9744444444444444,281,0.46444444444444444,0.22333333333333333,0.31222222222222223
1936,031,36,3,16,11,33,36,1.0,0.08333333333333333,0.9166666666666666,9,0.4444444444444444,0.3055555555555556,0.25
1937,031,7,0,0,0,7,7,1.0,0.0,1.0,7,0.0,0.0,1.0
1938,031,30,2,8,11,28,30,1.0,0.06666666666666667,0.9333333333333333,11,0.26666666666666666,0.36666666666666664,0.36666666666666664
1939,031,91,3,11,28,88,91,1.0,0.03296703296703297,0.967032967032967,52,0.12087912087912088,0.3076923076923077,0.5714285714285714
1940,031,237,10,89,61,227,237,1.0,0.04219409282700422,0.9578059071729957,87,0.3755274261603376,0.25738396624472576,0.3670886075949367
1942,031,1089,17,420,533,1072,1089,1.0,0.015610651974288337,0.9843893480257117,136,0.3856749311294766,0.48943985307621674,0.1248852157943067
1943,031,1101,28,454,313,1073,1101,1.0,0.025431425976385105,0.9745685740236149,334,0.4123524069028156,0.28428701180744775,0.3033605812897366
1944,031,1722,22,731,859,1700,1722,1.0,0.012775842044134728,0.9872241579558653,132,0.4245063879210221,0.4988385598141696,0.07665505226480836
1945,031,19,4,0,0,15,19,1.0,0.21052631578947367,0.7894736842105263,19,0.0,0.0,1.0
1946,031,1003,23,482,291,980,1003,1.0,0.022931206380857428,0.9770687936191426,230,0.48055832502492524,0.2901296111665005,0.22931206380857427
1947,031,4,2,0,0,2,4,1.0,0.5,0.5,4,0.0,0.0,1.0
1949,031,1459,42,402,947,1417,1459,1.0,0.02878684030157642,0.9712131596984236,110,0.27553118574366003,0.6490747087045922,0.07539410555174778
1950,031,296,4,111,130,292,296,1.0,0.013513513513513514,0.9864864864864865,55,0.375,0.4391891891891892,0.1858108108108108
1951,031,1301,30,472,631,1271,1301,1.0,0.023059185242121444,0.9769408147578785,198,0.3627978478093774,0.48501152959262106,0.15219062259800153
1952,031,1354,35,289,783,1319,1354,1.0,0.0258493353028065,0.9741506646971935,282,0.21344165435745938,0.5782865583456426,0.20827178729689808
1953,031,2700,65,823,1066,2635,2700,1.0,0.024074074074074074,0.975925925925926,811,0.3048148148148148,0.39481481481481484,0.30037037037037034
1954,031,38,0,11,15,38,38,1.0,0.0,1.0,12,0.2894736842105263,0.39473684210526316,0.3157894736842105
1955,031,477,11,198,254,466,477,1.0,0.023060796645702306,0.9769392033542977,25,0.41509433962264153,0.5324947589098532,0.05241090146750524
1956,031,791,17,413,377,774,791,1.00253807106599,0.021491782553729456,0.9785082174462706,1,0.5221238938053098,0.47661188369152974,0.0012642225031605564
1957,031,603,27,135,340,576,603,1.0,0.04477611940298507,0.9552238805970149,128,0.22388059701492538,0.5638474295190713,0.21227197346600332
1958,031,1305,52,309,188,1253,1305,1.0,0.03984674329501916,0.9601532567049809,808,0.2367816091954023,0.14406130268199233,0.6191570881226054
1959,031,2176,72,613,322,2104,2176,1.0,0.03308823529411765,0.9669117647058824,1241,0.28170955882352944,0.1479779411764706,0.5703125
1961,031,982,9,390,527,973,982,1.0,0.009164969450101833,0.9908350305498982,65,0.3971486761710794,0.5366598778004074,0.06619144602851323
1962,031,601,13,173,104,588,601,1.0,0.021630615640599003,0.978369384359401,324,0.2878535773710483,0.17304492512479203,0.5391014975041597
1963,031,1458,56,488,292,1402,1458,1.0,0.038408779149519894,0.9615912208504801,678,0.3347050754458162,0.20027434842249658,0.46502057613168724
1964,031,724,23,235,112,701,724,1.0,0.031767955801104975,0.9682320441988951,377,0.324585635359116,0.15469613259668508,0.5207182320441989
1965,031,5,2,0,0,3,5,1.0,0.4,0.6,5,0.0,0.0,1.0
1967,031,88,12,16,39,76,88,1.0,0.13636363636363635,0.8636363636363636,33,0.18181818181818182,0.4431818181818182,0.375
1968,031,86,12,17,47,74,86,1.0,0.13953488372093023,0.8604651162790697,22,0.19767441860465115,0.5465116279069767,0.2558139534883721
1969,031,39,0,4,22,39,39,1.0,0.0,1.0,13,0.10256410256410256,0.5641025641025641,0.3333333333333333
1970,031,116,1,43,44,115,116,1.0,0.008620689655172414,0.9913793103448276,29,0.3706896551724138,0.3793103448275862,0.25
1971,031,28,10,0,0,18,28,1.0,0.35714285714285715,0.6428571428571429,28,0.0,0.0,1.0
1973,031,16,3,5,10,13,16,1.1538461538461537,0.1875,0.8125,1,0.3125,0.625,0.0625
1976,031,8,2,0,0,6,8,1.0,0.25,0.75,8,0.0,0.0,1.0
1978,031,994,29,340,448,965,994,1.0,0.029175050301810865,0.9708249496981891,206,0.3420523138832998,0.4507042253521127,0.20724346076458752
1979,031,1067,38,350,406,1029,1067,1.0,0.03561387066541706,0.9643861293345829,311,0.3280224929709466,0.380506091846298,0.2914714151827554
1980,031,50,0,25,23,50,50,1.0,0.0,1.0,2,0.5,0.46,0.04
1981,031,537,6,284,146,531,537,1.0,0.0111731843575419,0.9888268156424581,107,0.5288640595903166,0.2718808193668529,0.19925512104283055
1982,031,10,1,0,0,9,10,1.0,0.1,0.9,10,0.0,0.0,1.0
1983,031,44,1,6,20,43,44,1.0,0.022727272727272728,0.9772727272727273,18,0.13636363636363635,0.45454545454545453,0.4090909090909091
1986,031,1006,11,323,598,995,1006,1.0,0.010934393638170975,0.989065606361829,85,0.3210735586481113,0.5944333996023857,0.08449304174950298
1987,031,2295,63,755,778,2232,2295,1.0,0.027450980392156862,0.9725490196078431,762,0.3289760348583878,0.3389978213507625,0.33202614379084966
1988,031,79,13,17,13,66,79,1.0,0.16455696202531644,0.8354430379746836,49,0.21518987341772153,0.16455696202531644,0.620253164556962
1989,031,1161,51,304,717,1110,1161,1.0,0.04392764857881137,0.9560723514211886,140,0.26184323858742464,0.6175710594315246,0.12058570198105081
1991,031,721,32,246,346,689,721,1.0,0.044382801664355064,0.955617198335645,129,0.34119278779472956,0.4798890429958391,0.17891816920943135
1992,031,228,5,81,139,223,228,1.0,0.021929824561403508,0.9780701754385965,8,0.35526315789473684,0.6096491228070176,0.03508771929824561
1993,031,15,2,0,0,13,15,1.0,0.13333333333333333,0.8666666666666667,15,0.0,0.0,1.0
1995,031,468,11,130,22,457,468,1.0,0.023504273504273504,0.9764957264957265,316,0.2777777777777778,0.04700854700854701,0.6752136752136753
1997,031,11,0,0,0,11,11,1.0,0.0,1.0,11,0.0,0.0,1.0
1998,031,45,0,13,24,45,45,1.0,0.0,1.0,8,0.28888888888888886,0.5333333333333333,0.17777777777777778
1999,031,9,2,0,0,7,9,1.0,0.2222222222222222,0.7777777777777778,9,0.0,0.0,1.0
2001,031,469,3,233,139,466,469,1.0,0.006396588486140725,0.9936034115138592,97,0.4968017057569296,0.29637526652452023,0.2068230277185501
2002,031,33,0,15,11,33,33,1.0,0.0,1.0,7,0.45454545454545453,0.3333333333333333,0.21212121212121213
2003,031,1,1,0,0,0,1,1.0,1.0,0.0,1,0.0,0.0,1.0
2004,031,1585,25,567,423,1560,1585,1.0,0.015772870662460567,0.9842271293375394,595,0.35772870662460565,0.2668769716088328,0.3753943217665615
2005,031,1246,20,457,452,1226,1246,1.0,0.016051364365971106,0.9839486356340289,337,0.3667736757624398,0.36276083467094705,0.27046548956661315
2006,031,839,9,428,376,830,839,1.0,0.010727056019070322,0.9892729439809297,35,0.5101311084624554,0.44815256257449343,0.041716328963051254
2007,031,651,10,307,281,641,651,1.0,0.015360983102918587,0.9846390168970814,63,0.4715821812596006,0.43164362519201227,0.0967741935483871
2008,031,866,7,446,394,859,866,1.0,0.008083140877598153,0.9919168591224018,26,0.5150115473441108,0.45496535796766746,0.03002309468822171
2009,031,740,19,376,333,721,740,1.0,0.025675675675675677,0.9743243243243244,31,0.5081081081081081,0.45,0.041891891891891894
2010,031,1173,16,499,561,1157,1173,1.0,0.013640238704177323,0.9863597612958227,113,0.4254049445865303,0.4782608695652174,0.09633418584825235
2011,031,910,15,420,378,895,910,1.0,0.016483516483516484,0.9835164835164835,112,0.46153846153846156,0.4153846153846154,0.12307692307692308
2012,031,10,3,0,0,7,10,1.0,0.3,0.7,10,0.0,0.0,1.0
2014,031,6,0,0,0,6,6,1.0,0.0,1.0,6,0.0,0.0,1.0
2015,031,314,7,160,136,307,314,1.0,0.022292993630573247,0.9777070063694268,18,0.5095541401273885,0.43312101910828027,0.05732484076433121
2016,031,346,3,86,222,343,346,1.0,0.008670520231213872,0.9913294797687862,38,0.24855491329479767,0.6416184971098265,0.10982658959537572
2017,031,330,7,95,139,323,330,1.0,0.021212121212121213,0.9787878787878788,96,0.2878787878787879,0.4212121212121212,0.2909090909090909
2018,031,1558,74,502,391,1484,1558,1.0,0.04749679075738126,0.9525032092426188,665,0.32220795892169446,0.25096277278562257,0.4268292682926829
2019,031,1215,59,426,210,1156,1215,1.0,0.048559670781893,0.951440329218107,579,0.3506172839506173,0.1728395061728395,0.4765432098765432
2020,031,2266,85,761,535,2181,2266,1.0,0.03751103265666372,0.9624889673433362,970,0.3358340688437776,0.23609885260370697,0.42806707855251547
2021,031,2255,101,488,1017,2154,2255,1.0,0.04478935698447894,0.955210643015521,750,0.2164079822616408,0.45099778270509977,0.3325942350332594
2022,031,589,34,125,117,555,589,1.0,0.057724957555178265,0.9422750424448217,347,0.21222410865874364,0.19864176570458403,0.5891341256366723
2023,031,2,0,0,0,2,2,1.0,0.0,1.0,2,0.0,0.0,1.0
2024,031,337,13,74,232,324,337,1.0,0.03857566765578635,0.9614243323442137,31,0.2195845697329377,0.6884272997032641,0.09198813056379822
2025,031,814,7,273,491,807,814,1.0,0.0085995085995086,0.9914004914004914,50,0.3353808353808354,0.6031941031941032,0.06142506142506143
2026,031,325,8,95,175,317,325,1.0,0.024615384615384615,0.9753846153846154,55,0.2923076923076923,0.5384615384615384,0.16923076923076924
2027,031,1382,68,315,528,1314,1382,1.0,0.049204052098408106,0.9507959479015919,539,0.22793053545586106,0.38205499276411,0.39001447178002896
2028,031,430,6,111,217,424,430,1.0,0.013953488372093023,0.986046511627907,102,0.25813953488372093,0.5046511627906977,0.2372093023255814
2030,031,8,1,0,0,7,8,1.0,0.125,0.875,8,0.0,0.0,1.0
2031,031,106,4,19,36,102,106,1.0,0.03773584905660377,0.9622641509433962,51,0.1792452830188679,0.33962264150943394,0.4811320754716981
2032,031,610,19,186,348,591,610,1.0,0.03114754098360656,0.9688524590163935,76,0.30491803278688523,0.5704918032786885,0.12459016393442623
2033,031,1107,48,311,582,1059,1107,1.0,0.04336043360433604,0.9566395663956639,214,0.2809394760614273,0.5257452574525745,0.1933152664859982
2034,031,2118,70,597,412,2048,2118,1.0,0.033050047214353166,0.9669499527856469,1109,0.2818696883852691,0.19452313503305005,0.5236071765816809
2035,031,23,0,0,0,23,23,1.0,0.0,1.0,23,0.0,0.0,1.0
2036,031,785,17,365,390,768,785,1.0,0.02165605095541401,0.978343949044586,30,0.46496815286624205,0.4968152866242038,0.03821656050955414
2037,031,1297,27,590,706,1270,1297,1.0109204368174727,0.02081727062451812,0.9791827293754819,1,0.4548959136468774,0.5443330763299923,0.0007710100231303007
2038,031,1175,20,408,710,1155,1175,1.0,0.01702127659574468,0.9829787234042553,57,0.3472340425531915,0.6042553191489362,0.04851063829787234
2039,031,14,5,6,7,9,14,1.4444444444444444,0.35714285714285715,0.6428571428571429,1,0.42857142857142855,0.5,0.07142857142857142
2040,031,2,1,0,0,1,2,1.0,0.5,0.5,2,0.0,0.0,1.0
2042,031,893,26,323,506,867,893,1.0,0.029115341545352745,0.9708846584546472,64,0.3617021276595745,0.5666293393057111,0.07166853303471445
2043,031,526,2,173,132,524,526,1.0,0.0038022813688212928,0.9961977186311787,221,0.3288973384030418,0.2509505703422053,0.42015209125475284
2044,031,48,5,13,28,43,48,1.0,0.10416666666666667,0.8958333333333334,7,0.2708333333333333,0.5833333333333334,0.14583333333333334
2045,031,1821,79,594,357,1742,1821,1.0,0.043382756727073035,0.956617243272927,870,0.3261943986820428,0.19604612850082373,0.47775947281713343
2046,031,1002,14,381,495,988,1002,1.0,0.013972055888223553,0.9860279441117764,126,0.38023952095808383,0.4940119760479042,0.12574850299401197
2047,031,1793,74,559,490,1719,1793,1.0,0.04127161182375906,0.958728388176241,744,0.31176798661461236,0.27328499721137756,0.41494701617401003
2048,031,205,13,55,24,192,205,1.0,0.06341463414634146,0.9365853658536586,126,0.2682926829268293,0.11707317073170732,0.6146341463414634
2049,031,712,33,194,123,679,712,1.0,0.046348314606741575,0.9536516853932584,395,0.27247191011235955,0.17275280898876405,0.5547752808988764
2053,031,4,0,0,0,4,4,1.0,0.0,1.0,4,0.0,0.0,1.0
2054,031,1513,32,564,749,1481,1513,1.0,0.021150033046926635,0.9788499669530734,200,0.37276933245208194,0.4950429610046266,0.13218770654329148
2057,031,407,16,178,167,391,407,1.0,0.03931203931203931,0.9606879606879607,62,0.43734643734643736,0.4103194103194103,0.15233415233415235
2058,031,103,1,39,19,102,103,1.0,0.009708737864077669,0.9902912621359223,45,0.3786407766990291,0.18446601941747573,0.4368932038834951
2059,031,422,5,165,213,417,422,1.0,0.011848341232227487,0.9881516587677726,44,0.3909952606635071,0.504739336492891,0.10426540284360189
2060,031,1135,54,297,125,1081,1135,1.0,0.04757709251101322,0.9524229074889868,713,0.2616740088105727,0.11013215859030837,0.628193832599119
2061,031,553,25,164,106,528,553,1.0,0.045207956600361664,0.9547920433996383,283,0.2965641952983725,0.19168173598553345,0.5117540687160941
2062,031,1107,38,338,154,1069,1107,1.0,0.03432700993676603,0.9656729900632339,615,0.3053297199638663,0.13911472448057813,0.5555555555555556
2063,031,5,2,0,0,3,5,1.0,0.4,0.6,5,0.0,0.0,1.0
2064,031,125,5,36,88,120,125,1.024793388429752,0.04,0.96,1,0.288,0.704,0.008
2065,031,28,0,11,15,28,28,1.0,0.0,1.0,2,0.39285714285714285,0.5357142857142857,0.07142857142857142
2066,031,831,22,354,278,809,831,1.0,0.026474127557160047,0.97352587244284,199,0.4259927797833935,0.3345367027677497,0.2394705174488568
2067,031,4,1,0,0,3,4,1.0,0.25,0.75,4,0.0,0.0,1.0
2068,031,862,43,320,219,819,862,1.0,0.04988399071925754,0.9501160092807425,323,0.37122969837587005,0.25406032482598606,0.37470997679814383
2070,031,5,0,0,0,5,5,1.0,0.0,1.0,5,0.0,0.0,1.0
2073,031,43,3,2,24,40,43,1.0,0.06976744186046512,0.9302325581395349,17,0.046511627906976744,0.5581395348837209,0.3953488372093023
2074,031,32,3,0,0,29,32,1.0,0.09375,0.90625,32,0.0,0.0,1.0
2075,031,154,0,42,79,154,154,1.0,0.0,1.0,33,0.2727272727272727,0.512987012987013,0.21428571428571427
2078,031,37,1,13,14,36,37,1.0,0.02702702702702703,0.972972972972973,10,0.35135135135135137,0.3783783783783784,0.2702702702702703
2079,017,700,14,49,576,686,700,1.0,0.02,0.98,75,0.07,0.8228571428571428,0.10714285714285714
2080,017,63,0,1,35,63,63,1.0,0.0,1.0,27,0.015873015873015872,0.5555555555555556,0.42857142857142855
2081,017,1066,27,110,505,1039,1066,1.0,0.025328330206378986,0.974671669793621,451,0.10318949343339587,0.47373358348968103,0.4230769230769231
2082,017,672,8,45,470,664,672,1.0,0.011904761904761904,0.9880952380952381,157,0.06696428571428571,0.6994047619047619,0.23363095238095238
