,COUNTY,VAP,APAMINVAP,PRES20D,PRES20R,OVAP,TOT_VOTES,factor,APAMINVAP_pct,OVAP_pct,PRES20None,PRES20D_pct,PRES20R_pct,PRES20None_pct
30,Appling,1433,27,116,870,1406,1433,1.0,0.01884159106769016,0.9811584089323099,447,0.08094905792044661,0.6071179344033496,0.31193300767620374
31,Appling,1192,10,44,594,1182,1192,1.0,0.008389261744966443,0.9916107382550335,554,0.03691275167785235,0.4983221476510067,0.46476510067114096
32,Appling,2639,23,908,531,2616,2639,1.0,0.008715422508525956,0.991284577491474,1200,0.3440697233800682,0.20121258052292534,0.45471769609700646
33,Appling,865,20,20,587,845,865,1.0,0.023121387283236993,0.976878612716763,258,0.023121387283236993,0.6786127167630058,0.29826589595375724
34,Appling,1920,43,288,843,1877,1920,1.0,0.022395833333333334,0.9776041666666667,789,0.15,0.4390625,0.4109375
35,Appling,990,8,23,647,982,990,1.0,0.00808080808080808,0.9919191919191919,320,0.023232323232323233,0.6535353535353535,0.32323232323232326
36,Appling,1880,15,130,1048,1865,1880,1.0,0.007978723404255319,0.9920212765957447,702,0.06914893617021277,0.5574468085106383,0.37340425531914895
37,Appling,1624,24,118,697,1600,1624,1.0,0.014778325123152709,0.9852216748768473,809,0.07266009852216748,0.4291871921182266,0.4981527093596059
38,Appling,1415,26,132,709,1389,1415,1.0,0.018374558303886925,0.9816254416961131,574,0.09328621908127209,0.5010600706713781,0.4056537102473498
39,Atkinson,973,25,45,479,948,973,1.0,0.025693730729701953,0.9743062692702981,449,0.046248715313463515,0.49229188078108943,0.4614594039054471
40,Atkinson,1316,23,329,229,1293,1316,1.0,0.017477203647416412,0.9825227963525835,758,0.25,0.17401215805471124,0.5759878419452887
41,Atkinson,2289,59,160,1026,2230,2289,1.0,0.025775447793796417,0.9742245522062036,1103,0.06989951944080385,0.44823066841415465,0.4818698121450415
42,Atkinson,1551,33,291,566,1518,1551,1.0,0.02127659574468085,0.9787234042553191,694,0.18762088974854932,0.3649258542875564,0.44745325596389424
43,Bacon,8310,106,625,4018,8204,8310,1.0,0.012755716004813478,0.9872442839951865,3667,0.07521058965102287,0.4835138387484958,0.44127557160048136
44,Baker,186,10,31,93,176,186,1.0,0.053763440860215055,0.946236559139785,62,0.16666666666666666,0.5,0.3333333333333333
45,Baker,388,4,148,141,384,388,1.0,0.010309278350515464,0.9896907216494846,99,0.38144329896907214,0.3634020618556701,0.2551546391752577
46,Baker,327,3,111,120,324,327,1.0,0.009174311926605505,0.9908256880733946,96,0.3394495412844037,0.3669724770642202,0.29357798165137616
47,Baker,286,2,69,137,284,286,1.0,0.006993006993006993,0.993006993006993,80,0.24125874125874125,0.479020979020979,0.27972027972027974
48,Baker,1088,10,293,406,1078,1088,1.0,0.009191176470588236,0.9908088235294118,389,0.2693014705882353,0.37316176470588236,0.35753676470588236
49,Baldwin,1325,17,547,134,1308,1325,1.0,0.012830188679245283,0.9871698113207548,644,0.41283018867924526,0.10113207547169811,0.48603773584905663
50,Baldwin,3295,9,331,153,3286,3295,1.0,0.002731411229135053,0.997268588770865,2811,0.10045523520485584,0.0464339908952959,0.8531107738998482
51,Baldwin,1682,14,320,784,1668,1682,1.0,0.008323424494649227,0.9916765755053508,578,0.1902497027348395,0.4661117717003567,0.3436385255648038
52,Baldwin,2953,34,169,113,2919,2953,1.0,0.011513714866237725,0.9884862851337622,2671,0.05722993565865222,0.038266169996613614,0.9045038943447342
53,Baldwin,4077,58,1159,1581,4019,4077,1.0,0.014226146676477803,0.9857738533235222,1337,0.2842776551385823,0.387785136129507,0.32793720873191073
54,Baldwin,1545,15,520,140,1530,1545,1.0,0.009708737864077669,0.9902912621359223,885,0.3365695792880259,0.09061488673139159,0.5728155339805825
55,Baldwin,1383,9,711,212,1374,1383,1.0,0.006507592190889371,0.9934924078091106,460,0.5140997830802603,0.15328994938539406,0.33261026753434564
56,Baldwin,2926,35,831,1366,2891,2926,1.0,0.011961722488038277,0.9880382775119617,729,0.28400546821599454,0.46684894053315107,0.24914559125085442
57,Baldwin,3929,41,810,1891,3888,3929,1.0,0.010435225248154746,0.9895647747518452,1228,0.2061593280733011,0.48129294986001525,0.31254772206668363
58,Baldwin,2567,18,859,793,2549,2567,1.0,0.007012076353720296,0.9929879236462797,915,0.3346318659914297,0.3089209193611219,0.3564472146474484
59,Baldwin,1354,17,275,426,1337,1354,1.0,0.012555391432791729,0.9874446085672083,653,0.20310192023633677,0.31462333825701627,0.48227474150664695
60,Baldwin,3058,37,583,179,3021,3058,1.0,0.01209941137998692,0.9879005886200131,2296,0.1906474820143885,0.05853499018966645,0.750817527795945
61,Baldwin,2208,16,604,731,2192,2208,1.0,0.007246376811594203,0.9927536231884058,873,0.27355072463768115,0.33106884057971014,0.3953804347826087
62,Baldwin,3420,39,1421,400,3381,3420,1.0,0.011403508771929825,0.9885964912280701,1599,0.4154970760233918,0.11695906432748537,0.4675438596491228
63,Banks,1628,35,100,901,1593,1628,1.0,0.0214987714987715,0.9785012285012284,627,0.06142506142506143,0.5534398034398035,0.38513513513513514
64,Banks,951,16,103,528,935,951,1.0,0.016824395373291272,0.9831756046267087,320,0.10830704521556257,0.555205047318612,0.33648790746582546
65,Banks,425,12,29,266,413,425,1.0,0.02823529411764706,0.971764705882353,130,0.06823529411764706,0.6258823529411764,0.3058823529411765
66,Banks,894,17,42,468,877,894,1.0,0.01901565995525727,0.9809843400447428,384,0.04697986577181208,0.5234899328859061,0.42953020134228187
67,Banks,399,15,20,258,384,399,1.0,0.03759398496240601,0.9624060150375939,121,0.05012531328320802,0.6466165413533834,0.3032581453634085
68,Banks,2052,68,166,1107,1984,2052,1.0,0.03313840155945419,0.9668615984405458,779,0.08089668615984405,0.5394736842105263,0.37962962962962965
69,Banks,1236,33,80,538,1203,1236,1.0,0.02669902912621359,0.9733009708737864,618,0.06472491909385113,0.43527508090614886,0.5
70,Banks,598,24,33,387,574,598,1.0,0.04013377926421405,0.959866220735786,178,0.05518394648829431,0.6471571906354515,0.2976588628762542
71,Banks,735,13,53,432,722,735,1.0,0.017687074829931974,0.9823129251700681,250,0.07210884353741497,0.5877551020408164,0.3401360544217687
72,Banks,1619,33,108,957,1586,1619,1.0,0.02038295243977764,0.9796170475602224,554,0.06670784434836319,0.5911056207535516,0.34218653489808526
73,Banks,1913,44,113,1121,1869,1913,1.0,0.02300052273915316,0.9769994772608468,679,0.05906952430737062,0.5859905906952431,0.3549398849973863
74,Banks,783,20,53,438,763,783,1.0,0.02554278416347382,0.9744572158365262,292,0.06768837803320563,0.5593869731800766,0.37292464878671777
75,Banks,654,6,32,394,648,654,1.0,0.009174311926605505,0.9908256880733946,228,0.04892966360856269,0.6024464831804281,0.3486238532110092
76,Barrow,3784,95,560,1728,3689,3784,1.0,0.02510570824524313,0.9748942917547568,1496,0.14799154334038056,0.45665961945031713,0.3953488372093023
77,Barrow,7641,190,966,4033,7451,7641,1.0,0.024865855254547833,0.9751341447454521,2642,0.12642324303101687,0.5278104960083758,0.34576626096060725
78,Barrow,6992,213,943,3098,6779,6992,1.0,0.030463386727688786,0.9695366132723112,2951,0.13486842105263158,0.4430778032036613,0.4220537757437071
79,Barrow,4582,106,624,1904,4476,4582,1.0,0.023134002618943692,0.9768659973810563,2054,0.13618507202095154,0.41553906591008294,0.4482758620689655
80,Barrow,9044,201,1743,4198,8843,9044,1.0,0.02222467934542238,0.9777753206545776,3103,0.19272445820433437,0.4641751437417072,0.3431003980539584
81,Barrow,7577,217,1114,3784,7360,7577,1.0,0.0286393031542827,0.9713606968457174,2679,0.1470238880823545,0.4994060974000264,0.3535700145176191
82,Barrow,10492,246,2036,3664,10246,10492,1.0,0.023446435379336637,0.9765535646206633,4792,0.19405261151353412,0.3492184521540221,0.45672893633244377
83,Barrow,12083,278,2467,4395,11805,12083,1.0,0.023007531242241166,0.9769924687577588,5221,0.20417114954895307,0.363734171977158,0.43209467847388894
84,Bartow,7759,225,908,3819,7534,7759,1.0,0.028998582291532415,0.9710014177084676,3032,0.11702538986982859,0.4922026034282768,0.39077200670189455
85,Bartow,5228,171,696,1997,5057,5228,1.0,0.03270849273144606,0.967291507268554,2535,0.1331293037490436,0.3819816373374139,0.48488905891354245
86,Bartow,9166,245,1527,2810,8921,9166,1.0,0.026729216670303296,0.9732707833296967,4829,0.16659393410429849,0.30656775038184597,0.5268383155138555
87,Bartow,8597,182,1776,4030,8415,8597,1.0,0.021170175642666045,0.9788298243573339,2791,0.20658369198557636,0.46876817494474815,0.3246481330696755
88,Bartow,12578,320,1940,5487,12258,12578,1.0,0.025441246621084435,0.9745587533789156,5151,0.15423755764032437,0.43623787565590716,0.40952456670376847
89,Bartow,4032,112,568,2312,3920,4032,1.0,0.027777777777777776,0.9722222222222222,1152,0.14087301587301587,0.5734126984126984,0.2857142857142857
90,Bartow,3599,167,414,1582,3432,3599,1.0,0.04640177827174215,0.9535982217282578,1603,0.11503195332036677,0.4395665462628508,0.44540150041678245
91,Bartow,5582,219,853,2859,5363,5582,1.0,0.03923324973127911,0.9607667502687209,1870,0.1528126119670369,0.5121820136151917,0.3350053744177714
92,Bartow,1609,45,113,897,1564,1609,1.0,0.027967681789931635,0.9720323182100684,599,0.07022995649471722,0.5574891236793039,0.3722809198259789
93,Bartow,3180,118,305,1550,3062,3180,1.0,0.03710691823899371,0.9628930817610063,1325,0.0959119496855346,0.48742138364779874,0.4166666666666667
94,Bartow,4452,139,711,2070,4313,4452,1.0,0.031221922731356693,0.9687780772686433,1671,0.1597035040431267,0.46495956873315364,0.3753369272237197
95,Bartow,2267,75,189,1369,2192,2267,1.0,0.033083370092633436,0.9669166299073666,709,0.08337009263343625,0.603881782090869,0.31274812527569473
96,Bartow,3058,87,206,1861,2971,3058,1.0,0.028449967298888164,0.9715500327011118,991,0.06736429038587312,0.6085676913015042,0.3240680183126226
97,Bartow,2752,104,275,1648,2648,2752,1.0,0.0377906976744186,0.9622093023255814,829,0.09992732558139535,0.5988372093023255,0.3012354651162791
98,Bartow,1985,63,297,961,1922,1985,1.0,0.03173803526448363,0.9682619647355164,727,0.14962216624685137,0.4841309823677582,0.3662468513853904
99,Bartow,7726,182,1314,2422,7544,7726,1.0,0.02355682112347916,0.9764431788765209,3990,0.1700750711881957,0.3134869272586073,0.516438001553197
100,Ben Hill,5226,110,1182,1249,5116,5226,1.0,0.02104860313815538,0.9789513968618446,2795,0.2261768082663605,0.23899732108687333,0.5348258706467661
101,Ben Hill,7939,122,1210,2861,7817,7939,1.0,0.015367174707141957,0.984632825292858,3868,0.1524121425872276,0.3603728429273208,0.48721501448545157
102,Berrien,1201,41,206,622,1160,1201,1.0,0.03413821815154038,0.9658617818484596,373,0.17152373022481265,0.517901748542881,0.3105745212323064
103,Berrien,1449,24,86,636,1425,1449,1.0,0.016563146997929608,0.9834368530020704,727,0.05935127674258109,0.4389233954451346,0.5017253278122843
104,Berrien,7532,144,694,3393,7388,7532,1.0,0.019118428040361127,0.9808815719596389,3445,0.09214020180562932,0.45047796070100904,0.45738183749336164
105,Berrien,2281,70,216,1062,2211,2281,1.0,0.030688294607628234,0.9693117053923718,1003,0.09469530907496712,0.4655852696185883,0.43971942130644454
106,Berrien,1227,22,67,706,1205,1227,1.0,0.017929910350448247,0.9820700896495518,454,0.05460472697636512,0.5753871230643847,0.3700081499592502
107,Bibb,2140,42,929,47,2098,2140,1.0,0.019626168224299065,0.9803738317757009,1164,0.43411214953271027,0.021962616822429906,0.5439252336448598
108,Bibb,3994,39,2169,157,3955,3994,1.0,0.009764646970455683,0.9902353530295444,1668,0.543064596895343,0.03930896344516775,0.41762643965948926
109,Bibb,3862,66,1563,570,3796,3862,1.0,0.017089590885551526,0.9829104091144485,1729,0.4047125841532884,0.14759192128430865,0.4476954945624029
110,Bibb,2586,14,1309,95,2572,2586,1.0,0.005413766434648105,0.9945862335653519,1182,0.5061871616395979,0.036736272235112145,0.45707656612529
111,Bibb,2629,43,1264,379,2586,2629,1.0,0.016356028908330163,0.9836439710916698,986,0.4807911753518448,0.14416127805249143,0.37504754659566375
112,Bibb,8865,84,2987,326,8781,8865,1.0,0.009475465313028765,0.9905245346869712,5552,0.3369430344049633,0.03677382966723068,0.6262831359278059
113,Bibb,2424,39,795,98,2385,2424,1.0,0.01608910891089109,0.9839108910891089,1531,0.327970297029703,0.040429042904290426,0.6316006600660066
114,Bibb,3314,40,1543,175,3274,3314,1.0,0.012070006035003017,0.987929993964997,1596,0.4656004828002414,0.0528062764031382,0.4815932407966204
115,Bibb,2561,28,826,139,2533,2561,1.0,0.010933229207340883,0.9890667707926591,1596,0.322530261616556,0.054275673565013664,0.6231940648184303
116,Bibb,4809,33,2328,301,4776,4809,1.0,0.006862133499688085,0.9931378665003119,2180,0.4840923268870867,0.06259097525473072,0.45331669785818257
117,Bibb,3702,31,1676,232,3671,3702,1.0,0.008373851971907077,0.9916261480280929,1794,0.45272825499729874,0.06266882766072393,0.4846029173419773
118,Bibb,4632,68,1606,1215,4564,4632,1.0,0.01468048359240069,0.9853195164075993,1811,0.34671848013816925,0.2623056994818653,0.3909758203799655
119,Bibb,7711,88,3284,1201,7623,7711,1.0,0.011412268188302425,0.9885877318116976,3226,0.4258850992089223,0.15575152379717286,0.4183633769939048
120,Bibb,3731,48,1618,2112,3683,3731,1.6548358473824312,0.012865183596890914,0.9871348164031091,1,0.4336638970785312,0.5660680782632003,0.0002680246582685607
121,Bibb,4850,61,992,1727,4789,4850,1.0,0.012577319587628866,0.9874226804123711,2131,0.2045360824742268,0.3560824742268041,0.43938144329896905
122,Bibb,4427,56,929,1734,4371,4427,1.0,0.012649649875762368,0.9873503501242377,1764,0.2098486559747007,0.39168737293878475,0.39846397108651455
123,Bibb,9877,115,2233,2397,9762,9877,1.0,0.011643211501468057,0.9883567884985319,5247,0.22608079376328843,0.24268502581755594,0.5312341804191556
124,Bibb,1902,30,625,577,1872,1902,1.0,0.015772870662460567,0.9842271293375394,700,0.3286014721345952,0.30336487907465826,0.36803364879074657
125,Bibb,1735,26,917,535,1709,1735,1.0,0.014985590778097982,0.985014409221902,283,0.5285302593659942,0.30835734870317005,0.16311239193083574
126,Bibb,2315,28,736,878,2287,2315,1.0,0.012095032397408207,0.9879049676025918,701,0.31792656587473,0.3792656587473002,0.30280777537796977
127,Bibb,2519,39,851,1421,2480,2519,1.0,0.015482334259626836,0.9845176657403731,247,0.33783247320365223,0.5641127431520445,0.0980547836443033
128,Bibb,6343,104,1784,2559,6239,6343,1.0,0.016396027116506385,0.9836039728834937,2000,0.2812549266908403,0.40343685953019076,0.31530821377896895
129,Bibb,3698,60,863,1590,3638,3698,1.0,0.016224986479177934,0.9837750135208221,1245,0.23336938885884262,0.42996214169821523,0.33666846944294215
130,Bibb,4995,92,1509,670,4903,4995,1.0,0.018418418418418417,0.9815815815815816,2816,0.3021021021021021,0.13413413413413414,0.5637637637637638
131,Bibb,2293,24,939,291,2269,2293,1.0,0.010466637592673354,0.9895333624073267,1063,0.40950719581334494,0.12690798081116442,0.4635848233754906
132,Bibb,3293,31,1601,153,3262,3293,1.0,0.009413908290312785,0.9905860917096873,1539,0.48618281202550867,0.04646219252960826,0.46735499544488307
133,Bibb,4185,39,2042,283,4146,4185,1.0,0.00931899641577061,0.9906810035842294,1860,0.4879330943847073,0.06762246117084826,0.4444444444444444
134,Bibb,2418,25,818,913,2393,2418,1.0,0.01033912324234905,0.9896608767576509,687,0.33829611248966085,0.3775847808105873,0.2841191066997519
135,Bibb,3398,65,1180,937,3333,3398,1.0,0.01912889935256033,0.9808711006474397,1281,0.3472630959387875,0.2757504414361389,0.37698646262507357
136,Bibb,2717,49,675,1300,2668,2717,1.0,0.0180345969819654,0.9819654030180346,742,0.24843577475156423,0.4784688995215311,0.27309532572690465
137,Bibb,4437,39,877,1573,4398,4437,1.0,0.00878972278566599,0.991210277214334,1987,0.1976560739238224,0.3545188190218616,0.447825107054316
138,Bleckley,9613,86,1311,4328,9527,9613,1.0,0.008946218662228233,0.9910537813377718,3974,0.13637782169978155,0.4502236554665557,0.41339852283366274
139,Brantley,3852,73,164,2210,3779,3852,1.0,0.018951194184839044,0.981048805815161,1478,0.04257528556593977,0.5737279335410177,0.3836967808930426
140,Brantley,4787,133,268,2522,4654,4787,1.0,0.02778358053060372,0.9722164194693963,1997,0.055984959264675165,0.5268435345728013,0.4171715061625235
141,Brantley,5053,171,267,2259,4882,5053,1.0,0.033841282406491195,0.9661587175935088,2527,0.052839897090837126,0.44706115179101524,0.5000989511181476
142,Brooks,396,10,67,181,386,396,1.0,0.025252525252525252,0.9747474747474747,148,0.1691919191919192,0.45707070707070707,0.37373737373737376
143,Brooks,2726,41,315,1148,2685,2726,1.0,0.01504035216434336,0.9849596478356566,1263,0.11555392516507704,0.42112986060161406,0.4633162142333089
144,Brooks,1170,24,395,363,1146,1170,1.0,0.020512820512820513,0.9794871794871794,412,0.33760683760683763,0.31025641025641026,0.35213675213675216
145,Brooks,2255,38,399,925,2217,2255,1.0,0.016851441241685146,0.9831485587583149,931,0.17694013303769401,0.41019955654101997,0.412860310421286
146,Brooks,868,9,86,421,859,868,1.0,0.010368663594470046,0.9896313364055299,361,0.09907834101382489,0.48502304147465436,0.41589861751152074
147,Brooks,693,17,122,314,676,693,1.0,0.024531024531024532,0.9754689754689755,257,0.17604617604617603,0.4531024531024531,0.3708513708513709
148,Brooks,4639,71,1406,908,4568,4639,1.0,0.015305022634188403,0.9846949773658116,2325,0.303082560896745,0.1957318387583531,0.5011856003449019
149,Bryan,3117,96,393,1442,3021,3117,1.0,0.030798845043310877,0.9692011549566891,1282,0.1260827718960539,0.4626243182547321,0.41129290984921396
150,Bryan,2208,48,435,1213,2160,2208,1.0,0.021739130434782608,0.9782608695652174,560,0.19701086956521738,0.5493659420289855,0.2536231884057971
151,Bryan,2351,68,302,1300,2283,2351,1.0,0.0289238621863037,0.9710761378136963,749,0.1284559761803488,0.552956188855806,0.3185878349638452
152,Bryan,6186,170,1393,2528,6016,6186,1.0,0.027481409634658907,0.972518590365341,2265,0.22518590365341093,0.40866472680245713,0.3661493695441319
153,Bryan,2818,46,573,1654,2772,2818,1.0,0.016323633782824698,0.9836763662171752,591,0.20333569907735982,0.5869410929737402,0.20972320794889993
154,Bryan,3881,87,1017,2205,3794,3881,1.0,0.022416902860087608,0.9775830971399124,659,0.26204586446792066,0.5681525380056687,0.16980159752641072
155,Bryan,2844,55,567,1111,2789,2844,1.0,0.019338959212376935,0.9806610407876231,1166,0.19936708860759494,0.3906469760900141,0.409985935302391
156,Bryan,2616,75,635,937,2541,2616,1.0,0.028669724770642203,0.9713302752293578,1044,0.24273700305810397,0.3581804281345566,0.39908256880733944
157,Bryan,3660,85,888,1137,3575,3660,1.0,0.023224043715846996,0.976775956284153,1635,0.24262295081967214,0.31065573770491806,0.44672131147540983
158,Bryan,2147,62,536,717,2085,2147,1.0,0.02887750349324639,0.9711224965067536,894,0.2496506753609688,0.33395435491383324,0.41639496972519796
159,Bulloch,1795,33,203,987,1762,1795,1.0,0.01838440111420613,0.9816155988857939,605,0.11309192200557103,0.5498607242339832,0.3370473537604457
160,Bulloch,1946,30,398,1129,1916,1946,1.0,0.015416238437821172,0.9845837615621789,419,0.20452209660842754,0.5801644398766701,0.21531346351490235
161,Bulloch,3545,46,565,1880,3499,3545,1.0,0.012976022566995768,0.9870239774330042,1100,0.15937940761636107,0.5303244005641748,0.31029619181946405
162,Bulloch,7185,87,1988,1737,7098,7185,1.0,0.012108559498956159,0.9878914405010438,3460,0.27668754349338903,0.24175365344467642,0.4815588030619346
163,Bulloch,4276,101,757,1620,4175,4276,1.0,0.02362020579981291,0.9763797942001871,1899,0.17703461178671656,0.37885874649204865,0.4441066417212348
164,Bulloch,10397,160,1705,2559,10237,10397,1.0,0.015389054534962008,0.984610945465038,6133,0.1639896123881889,0.2461286909685486,0.5898816966432625
165,Bulloch,2646,56,575,1079,2590,2646,1.0,0.021164021164021163,0.9788359788359788,992,0.21730914588057446,0.40778533635676495,0.3749055177626606
166,Bulloch,1084,28,112,630,1056,1084,1.0,0.025830258302583026,0.974169741697417,342,0.1033210332103321,0.5811808118081181,0.3154981549815498
167,Bulloch,767,5,150,385,762,767,1.0,0.00651890482398957,0.9934810951760105,232,0.19556714471968709,0.5019556714471969,0.30247718383311606
168,Bulloch,1395,33,169,740,1362,1395,1.0,0.023655913978494623,0.9763440860215054,486,0.12114695340501792,0.5304659498207885,0.34838709677419355
169,Bulloch,14780,160,1725,992,14620,14780,1.0,0.010825439783491205,0.9891745602165088,12063,0.11671177266576455,0.06711772665764547,0.81617050067659
170,Bulloch,2018,53,309,839,1965,2018,1.0,0.02626362735381566,0.9737363726461843,870,0.1531219028741328,0.4157581764122894,0.4311199207135778
171,Bulloch,1101,41,217,411,1060,1101,1.0,0.03723887375113533,0.9627611262488647,473,0.19709355131698456,0.37329700272479566,0.4296094459582198
172,Bulloch,543,9,60,298,534,543,1.0,0.016574585635359115,0.9834254143646409,185,0.11049723756906077,0.5488029465930019,0.3406998158379374
173,Bulloch,8543,98,2074,1907,8445,8543,1.0,0.011471380077256232,0.9885286199227438,4562,0.2427718600023411,0.22322369191150648,0.5340044480861524
174,Bulloch,2473,84,236,1193,2389,2473,1.0,0.033966841892438336,0.9660331581075616,1044,0.09543065103113627,0.48241002830570157,0.42215932066316214
175,Burke,475,13,113,158,462,475,1.0,0.02736842105263158,0.9726315789473684,204,0.23789473684210527,0.33263157894736844,0.42947368421052634
176,Burke,694,9,237,165,685,694,1.0,0.012968299711815562,0.9870317002881844,292,0.3414985590778098,0.2377521613832853,0.4207492795389049
177,Burke,2809,55,503,1086,2754,2809,1.0,0.019579921680313278,0.9804200783196867,1220,0.17906728373086508,0.3866144535421858,0.43431826272694907
178,Burke,828,10,242,232,818,828,1.0,0.012077294685990338,0.9879227053140096,354,0.2922705314009662,0.28019323671497587,0.427536231884058
179,Burke,453,0,189,116,453,453,1.0,0.0,1.0,148,0.41721854304635764,0.2560706401766004,0.32671081677704195
180,Burke,1216,9,271,412,1207,1216,1.0,0.007401315789473684,0.9925986842105263,533,0.22286184210526316,0.33881578947368424,0.43832236842105265
181,Burke,597,15,141,119,582,597,1.0,0.02512562814070352,0.9748743718592965,337,0.23618090452261306,0.19932998324958123,0.5644891122278057
182,Burke,530,4,181,122,526,530,1.0,0.007547169811320755,0.9924528301886792,227,0.34150943396226413,0.23018867924528302,0.42830188679245285
183,Burke,243,7,81,116,236,243,1.0,0.02880658436213992,0.9711934156378601,46,0.3333333333333333,0.4773662551440329,0.18930041152263374
184,Burke,3297,33,1296,482,3264,3297,1.0,0.010009099181073703,0.9899909008189263,1519,0.39308462238398545,0.1461935092508341,0.4607218683651805
185,Burke,1262,21,257,392,1241,1262,1.0,0.01664025356576862,0.9833597464342314,613,0.20364500792393028,0.31061806656101426,0.4857369255150555
186,Burke,251,4,128,63,247,251,1.0,0.01593625498007968,0.9840637450199203,60,0.5099601593625498,0.250996015936255,0.23904382470119523
187,Burke,3804,46,1007,1281,3758,3804,1.0,0.012092534174553101,0.9879074658254469,1516,0.2647213459516299,0.33675078864353314,0.39852786540483703
188,Burke,460,9,143,173,451,460,1.0,0.01956521739130435,0.9804347826086957,144,0.3108695652173913,0.3760869565217391,0.3130434782608696
189,Burke,1492,27,315,378,1465,1492,1.0,0.018096514745308313,0.9819034852546917,799,0.2111260053619303,0.25335120643431636,0.5355227882037533
190,Burke,367,4,105,105,363,367,1.0,0.010899182561307902,0.989100817438692,157,0.28610354223433243,0.28610354223433243,0.42779291553133514
191,Butts,20360,400,3274,8406,19960,20360,1.0,0.019646365422396856,0.9803536345776032,8680,0.16080550098231827,0.41286836935166993,0.4263261296660118
192,Calhoun,607,7,348,121,600,607,1.0,0.011532125205930808,0.9884678747940692,138,0.5733113673805601,0.19934102141680396,0.2273476112026359
193,Calhoun,804,2,243,64,802,804,1.0,0.0024875621890547263,0.9975124378109452,497,0.30223880597014924,0.07960199004975124,0.6181592039800995
194,Calhoun,630,4,234,161,626,630,1.0,0.006349206349206349,0.9936507936507937,235,0.37142857142857144,0.25555555555555554,0.373015873015873
195,Calhoun,581,6,291,227,575,581,1.0,0.010327022375215147,0.9896729776247849,63,0.5008605851979346,0.39070567986230637,0.10843373493975904
196,Calhoun,2065,10,144,350,2055,2065,1.0,0.004842615012106538,0.9951573849878934,1571,0.06973365617433414,0.1694915254237288,0.7607748184019371
197,Camden,938,31,74,384,907,938,1.0,0.03304904051172708,0.9669509594882729,480,0.07889125799573561,0.4093816631130064,0.511727078891258
198,Camden,7567,193,1604,2825,7374,7567,1.0,0.02550548433989692,0.974494515660103,3138,0.2119730408352055,0.37333157129641864,0.41469538786837584
199,Camden,2038,64,299,1075,1974,2038,1.0,0.03140333660451423,0.9685966633954858,664,0.1467124631992149,0.52747791952895,0.3258096172718351
200,Camden,2512,80,485,763,2432,2512,1.0,0.03184713375796178,0.9681528662420382,1264,0.1930732484076433,0.3037420382165605,0.5031847133757962
201,Camden,4247,116,845,1222,4131,4247,1.0,0.027313397692488816,0.9726866023075111,2180,0.19896397457028492,0.28773251707087355,0.5133035083588415
202,Camden,3214,101,639,1308,3113,3214,1.0,0.03142501555693839,0.9685749844430616,1267,0.19881767268201617,0.40696950840074675,0.3942128189172371
203,Camden,2770,84,804,747,2686,2770,1.0,0.03032490974729242,0.9696750902527076,1219,0.29025270758122745,0.2696750902527076,0.44007220216606496
204,Camden,5094,111,387,555,4983,5094,1.0,0.021790341578327443,0.9782096584216725,4152,0.07597173144876325,0.10895170789163722,0.8150765606595995
205,Camden,2352,48,546,1013,2304,2352,1.0,0.02040816326530612,0.9795918367346939,793,0.23214285714285715,0.4306972789115646,0.33715986394557823
206,Camden,1099,27,192,490,1072,1099,1.0,0.02456778889899909,0.9754322111010009,417,0.17470427661510465,0.445859872611465,0.3794358507734304
207,Camden,1531,37,347,886,1494,1531,1.0,0.024167210973220117,0.9758327890267798,298,0.22664924885695623,0.5787067276290007,0.1946440235140431
208,Camden,3084,88,497,1355,2996,3084,1.0,0.028534370946822308,0.9714656290531777,1232,0.1611543450064851,0.4393644617380026,0.39948119325551235
209,Camden,3356,74,708,1786,3282,3356,1.0,0.02205005959475566,0.9779499404052443,862,0.21096543504171633,0.5321811680572109,0.25685339690107273
210,Camden,2006,58,540,842,1948,2006,1.0,0.028913260219341975,0.9710867397806581,624,0.2691924227318046,0.419740777666999,0.31106679960119643
211,Candler,8241,134,1269,3133,8107,8241,1.0,0.016260162601626018,0.983739837398374,3839,0.15398616672733892,0.38017230918577843,0.4658415240868827
212,Carroll,4838,107,1066,1585,4731,4838,1.0,0.02211657709797437,0.9778834229020257,2187,0.22033898305084745,0.3276147168251344,0.4520463001240182
213,Carroll,4432,96,1035,1327,4336,4432,1.0,0.021660649819494584,0.9783393501805054,2070,0.23352888086642598,0.299413357400722,0.46705776173285196
214,Carroll,3461,70,493,1483,3391,3461,1.0,0.020225368390638543,0.9797746316093614,1485,0.14244438023692574,0.42848887604738517,0.4290667437156891
215,Carroll,1510,43,227,738,1467,1510,1.0,0.02847682119205298,0.971523178807947,545,0.15033112582781458,0.48874172185430464,0.3609271523178808
216,Carroll,1698,59,337,638,1639,1698,1.0,0.034746760895170786,0.9652532391048292,723,0.19846878680800942,0.375736160188457,0.42579505300353354
217,Carroll,1569,38,188,886,1531,1569,1.0,0.024219247928616953,0.975780752071383,495,0.11982154238368388,0.5646908859145953,0.3154875717017208
218,Carroll,1839,64,163,1188,1775,1839,1.0,0.034801522566612286,0.9651984774333877,488,0.08863512778684067,0.6460032626427407,0.2653616095704187
219,Carroll,3704,68,617,2095,3636,3704,1.0,0.0183585313174946,0.9816414686825053,992,0.1665766738660907,0.5656047516198704,0.2678185745140389
220,Carroll,2951,69,739,994,2882,2951,1.0,0.02338190443917316,0.9766180955608268,1218,0.25042358522534736,0.3368349711962047,0.412741443578448
221,Carroll,3514,83,782,2151,3431,3514,1.0,0.023619806488332385,0.9763801935116676,581,0.22253841775754127,0.612122936824132,0.16533864541832669
222,Carroll,2442,54,309,1401,2388,2442,1.0,0.022113022113022112,0.9778869778869779,732,0.12653562653562653,0.5737100737100738,0.29975429975429974
223,Carroll,1215,37,68,787,1178,1215,1.0,0.030452674897119343,0.9695473251028807,360,0.05596707818930041,0.6477366255144033,0.2962962962962963
224,Carroll,1851,46,440,590,1805,1851,1.0,0.02485143165856294,0.975148568341437,821,0.23770934629929769,0.3187466234467855,0.4435440302539168
225,Carroll,2812,52,293,1452,2760,2812,1.0,0.01849217638691323,0.9815078236130867,1067,0.10419630156472262,0.5163584637268848,0.3794452347083926
226,Carroll,1792,36,254,847,1756,1792,1.0,0.020089285714285716,0.9799107142857143,691,0.14174107142857142,0.47265625,0.38560267857142855
227,Carroll,2262,49,437,1216,2213,2262,1.0,0.021662245800176835,0.9783377541998232,609,0.1931918656056587,0.537577365163572,0.2692307692307692
228,Carroll,3240,63,334,1865,3177,3240,1.0,0.019444444444444445,0.9805555555555555,1041,0.10308641975308643,0.5756172839506173,0.3212962962962963
229,Carroll,4791,161,765,2053,4630,4791,1.0,0.033604675433103734,0.9663953245668963,1973,0.1596743894802755,0.4285117929451054,0.4118138175746191
230,Carroll,1790,30,407,708,1760,1790,1.0,0.01675977653631285,0.9832402234636871,675,0.22737430167597766,0.39553072625698327,0.3770949720670391
231,Carroll,3625,129,774,1527,3496,3625,1.0,0.035586206896551724,0.9644137931034483,1324,0.21351724137931036,0.42124137931034483,0.36524137931034484
232,Carroll,4552,128,506,2154,4424,4552,1.0,0.028119507908611598,0.9718804920913884,1892,0.11115992970123023,0.47319859402460457,0.4156414762741652
233,Carroll,1932,45,188,1168,1887,1932,1.0,0.023291925465838508,0.9767080745341615,576,0.09730848861283643,0.6045548654244306,0.2981366459627329
234,Carroll,4607,42,596,667,4565,4607,1.0,0.009116561753852833,0.9908834382461472,3344,0.12936835250705447,0.14477968309094855,0.725851964401997
235,Carroll,5684,169,1030,2358,5515,5684,1.0,0.029732582688247713,0.9702674173117523,2296,0.181210415200563,0.41484869809992964,0.4039408866995074
236,Carroll,3056,108,417,1490,2948,3056,1.0,0.03534031413612566,0.9646596858638743,1149,0.13645287958115182,0.487565445026178,0.37598167539267013
237,Carroll,7020,149,2140,2067,6871,7020,1.0,0.021225071225071224,0.9787749287749288,2813,0.30484330484330485,0.29444444444444445,0.4007122507122507
238,Carroll,6571,110,1429,802,6461,6571,1.0,0.01674022218840359,0.9832597778115965,4340,0.2174707046111703,0.12205143813726982,0.6604778572515598
239,Carroll,2259,66,204,1239,2193,2259,1.0,0.029216467463479414,0.9707835325365206,816,0.0903054448871182,0.548472775564409,0.3612217795484728
240,Catoosa,2500,89,208,1088,2411,2500,1.0,0.0356,0.9644,1204,0.0832,0.4352,0.4816
241,Catoosa,6331,173,996,3501,6158,6331,1.0,0.027325856894645395,0.9726741431053546,1834,0.15732111830674458,0.5529932080240089,0.2896856736692466
242,Catoosa,2978,88,329,1532,2890,2978,1.0,0.029550033579583614,0.9704499664204164,1117,0.11047683008730692,0.5144392209536601,0.3750839489590329
243,Catoosa,2602,57,351,1641,2545,2602,1.0,0.021906225980015372,0.9780937740199847,610,0.13489623366641046,0.6306687163720215,0.23443504996156803
244,Catoosa,5141,138,701,1989,5003,5141,1.0,0.026843026648511962,0.973156973351488,2451,0.1363547947870064,0.3868897101731181,0.4767554950398755
245,Catoosa,5067,143,658,2439,4924,5067,1.0,0.028221827511347938,0.9717781724886521,1970,0.12985987763962897,0.48134991119005327,0.38879021117031776
246,Catoosa,4676,172,485,1654,4504,4676,1.0,0.036783575705731396,0.9632164242942686,2537,0.10372112917023096,0.35372112917023096,0.5425577416595381
247,Catoosa,4428,115,582,2433,4313,4428,1.0,0.025971093044263777,0.9740289069557362,1413,0.13143631436314362,0.5494579945799458,0.31910569105691056
248,Catoosa,8267,236,1327,4080,8031,8267,1.0,0.028547235998548446,0.9714527640014515,2860,0.1605177210596347,0.49352848675456634,0.34595379218579897
249,Catoosa,7328,216,902,2958,7112,7328,1.0,0.02947598253275109,0.9705240174672489,3468,0.12308951965065502,0.4036572052401747,0.4732532751091703
250,Catoosa,3130,113,393,1852,3017,3130,1.0,0.03610223642172524,0.9638977635782747,885,0.1255591054313099,0.5916932907348242,0.2827476038338658
251,Charlton,829,23,54,535,806,829,1.0,0.027744270205066344,0.9722557297949337,240,0.06513872135102533,0.6453558504221955,0.28950542822677927
252,Charlton,5094,54,844,711,5040,5094,1.0,0.01060070671378092,0.9893992932862191,3539,0.165685119748724,0.13957597173144876,0.6947389085198272
253,Charlton,899,25,60,486,874,899,1.0,0.027808676307007785,0.9721913236929922,353,0.06674082313681869,0.5406006674082313,0.39265850945494996
254,Charlton,846,15,21,332,831,846,1.0,0.01773049645390071,0.9822695035460993,493,0.024822695035460994,0.39243498817966904,0.58274231678487
255,Charlton,960,28,64,538,932,960,1.0,0.029166666666666667,0.9708333333333333,358,0.06666666666666667,0.5604166666666667,0.3729166666666667
256,Charlton,307,11,20,194,296,307,1.0,0.035830618892508145,0.9641693811074918,93,0.06514657980456026,0.6319218241042345,0.30293159609120524
257,Charlton,873,27,22,418,846,873,1.0,0.030927835051546393,0.9690721649484536,433,0.025200458190148912,0.47880870561282934,0.4959908361970218
258,Charlton,327,4,18,205,323,327,1.0,0.012232415902140673,0.9877675840978594,104,0.05504587155963303,0.6269113149847095,0.3180428134556575
259,Chatham,3155,67,1597,952,3088,3155,1.0,0.021236133122028527,0.9787638668779715,606,0.5061806656101426,0.301743264659271,0.19207606973058636
260,Chatham,2530,43,949,595,2487,2530,1.0,0.01699604743083004,0.98300395256917,986,0.375098814229249,0.23517786561264822,0.3897233201581028
261,Chatham,2017,28,704,854,1989,2017,1.0,0.013882002974714923,0.9861179970252851,459,0.3490332176499752,0.42340109072880516,0.22756569162121965
262,Chatham,1930,31,587,628,1899,1930,1.0,0.01606217616580311,0.9839378238341969,715,0.30414507772020727,0.32538860103626943,0.3704663212435233
263,Chatham,870,16,265,181,854,870,1.0,0.01839080459770115,0.9816091954022989,424,0.3045977011494253,0.20804597701149424,0.48735632183908045
264,Chatham,1049,4,300,626,1045,1049,1.0,0.0038131553860819827,0.996186844613918,123,0.2859866539561487,0.5967588179218303,0.11725452812202097
265,Chatham,1780,14,544,1080,1766,1780,1.0,0.007865168539325843,0.9921348314606742,156,0.3056179775280899,0.6067415730337079,0.08764044943820225
266,Chatham,1477,24,414,589,1453,1477,1.0,0.016249153689911984,0.983750846310088,474,0.28029790115098174,0.3987813134732566,0.3209207853757617
267,Chatham,1858,39,488,785,1819,1858,1.0,0.02099031216361679,0.9790096878363832,585,0.26264800861141013,0.422497308934338,0.3148546824542519
268,Chatham,3425,104,589,1497,3321,3425,1.0,0.030364963503649634,0.9696350364963504,1339,0.17197080291970804,0.4370802919708029,0.39094890510948904
269,Chatham,3314,56,860,1666,3258,3314,1.0,0.016898008449004225,0.9831019915509958,788,0.2595051297525649,0.5027157513578757,0.23777911888955944
270,Chatham,2045,41,713,161,2004,2045,1.0,0.020048899755501223,0.9799511002444988,1171,0.3486552567237164,0.07872860635696821,0.5726161369193155
271,Chatham,1936,31,707,115,1905,1936,1.0,0.016012396694214875,0.9839876033057852,1114,0.36518595041322316,0.059400826446280995,0.5754132231404959
272,Chatham,3262,56,1647,129,3206,3262,1.0,0.017167381974248927,0.9828326180257511,1486,0.5049049662783568,0.039546290619251995,0.4555487431023912
273,Chatham,2006,33,1123,135,1973,2006,1.0,0.016450648055832504,0.9835493519441675,748,0.5598205383848455,0.06729810568295115,0.3728813559322034
274,Chatham,680,15,335,65,665,680,1.0,0.022058823529411766,0.9779411764705882,280,0.49264705882352944,0.09558823529411764,0.4117647058823529
275,Chatham,2933,46,1347,220,2887,2933,1.0,0.015683600409137403,0.9843163995908626,1366,0.4592567337197409,0.07500852369587453,0.4657347425843846
276,Chatham,3391,44,1742,256,3347,3391,1.0,0.012975523444411679,0.9870244765555883,1393,0.5137127690946623,0.07549395458566795,0.4107932763196697
277,Chatham,1943,33,839,163,1910,1943,1.0,0.016984045290787442,0.9830159547092125,941,0.43180648481729283,0.08389089037570767,0.4843026248069995
278,Chatham,2115,35,823,123,2080,2115,1.0,0.016548463356973995,0.983451536643026,1169,0.38912529550827424,0.05815602836879433,0.5527186761229315
279,Chatham,822,6,176,122,816,822,1.0,0.0072992700729927005,0.9927007299270073,524,0.2141119221411192,0.14841849148418493,0.6374695863746959
280,Chatham,2148,28,709,410,2120,2148,1.0,0.01303538175046555,0.9869646182495344,1029,0.330074487895717,0.1908752327746741,0.4790502793296089
281,Chatham,1291,13,537,64,1278,1291,1.0,0.010069713400464756,0.9899302865995352,690,0.4159566227730441,0.049573973663826494,0.5344694035631293
282,Chatham,1455,21,798,63,1434,1455,1.0,0.01443298969072165,0.9855670103092784,594,0.5484536082474227,0.04329896907216495,0.40824742268041236
283,Chatham,2227,40,884,300,2187,2227,1.0,0.01796138302649304,0.9820386169735069,1043,0.3969465648854962,0.1347103726986978,0.46834306241580603
284,Chatham,1235,26,565,217,1209,1235,1.0,0.021052631578947368,0.9789473684210527,453,0.4574898785425101,0.1757085020242915,0.3668016194331984
285,Chatham,686,12,222,296,674,686,1.0,0.01749271137026239,0.9825072886297376,168,0.3236151603498542,0.4314868804664723,0.24489795918367346
286,Chatham,3589,30,1369,220,3559,3589,1.0,0.008358874338255782,0.9916411256617442,2000,0.38144329896907214,0.061298411813875735,0.5572582892170521
287,Chatham,1505,29,707,162,1476,1505,1.0,0.019269102990033222,0.9807308970099667,636,0.4697674418604651,0.10764119601328903,0.4225913621262459
288,Chatham,2724,38,629,528,2686,2724,1.0,0.013950073421439061,0.9860499265785609,1567,0.23091042584434654,0.19383259911894274,0.5752569750367107
289,Chatham,2296,30,845,525,2266,2296,1.0,0.013066202090592335,0.9869337979094077,926,0.3680313588850174,0.22865853658536586,0.40331010452961674
290,Chatham,2370,18,1186,344,2352,2370,1.0,0.007594936708860759,0.9924050632911392,840,0.5004219409282701,0.1451476793248945,0.35443037974683544
291,Chatham,1388,6,361,278,1382,1388,1.0,0.004322766570605188,0.9956772334293948,749,0.2600864553314121,0.20028818443804033,0.5396253602305475
292,Chatham,2640,58,647,1044,2582,2640,1.0,0.02196969696969697,0.978030303030303,949,0.24507575757575759,0.39545454545454545,0.359469696969697
293,Chatham,2333,40,608,1222,2293,2333,1.0,0.017145306472353194,0.9828546935276468,503,0.26060865837976854,0.5237891127303901,0.2156022288898414
294,Chatham,2345,29,601,1125,2316,2345,1.0,0.012366737739872069,0.9876332622601279,619,0.2562899786780384,0.47974413646055436,0.26396588486140726
295,Chatham,2135,42,531,1226,2093,2135,1.0,0.019672131147540985,0.980327868852459,378,0.248711943793911,0.5742388758782201,0.17704918032786884
296,Chatham,3802,90,907,1568,3712,3802,1.0,0.02367175170962651,0.9763282482903735,1327,0.23855865334034718,0.4124145186743819,0.3490268279852709
297,Chatham,2475,17,669,1497,2458,2475,1.0,0.006868686868686869,0.9931313131313131,309,0.2703030303030303,0.6048484848484849,0.12484848484848485
298,Chatham,1536,32,471,674,1504,1536,1.0,0.020833333333333332,0.9791666666666666,391,0.306640625,0.4388020833333333,0.2545572916666667
299,Chatham,1588,34,489,772,1554,1588,1.0,0.021410579345088162,0.9785894206549118,327,0.3079345088161209,0.48614609571788414,0.20591939546599497
300,Chatham,2137,11,618,1353,2126,2137,1.0,0.005147402901263453,0.9948525970987365,166,0.28919045390734677,0.6331305568554048,0.07767898923724847
301,Chatham,2338,11,739,1375,2327,2338,1.0,0.004704875962360992,0.995295124037639,224,0.316082121471343,0.588109495295124,0.09580838323353294
302,Chatham,1719,18,554,948,1701,1719,1.0,0.010471204188481676,0.9895287958115183,217,0.3222803955788249,0.5514834205933682,0.12623618382780685
303,Chatham,1816,13,572,992,1803,1816,1.0,0.007158590308370044,0.9928414096916299,252,0.31497797356828194,0.5462555066079295,0.13876651982378854
304,Chatham,1182,23,456,155,1159,1182,1.0,0.0194585448392555,0.9805414551607445,571,0.38578680203045684,0.1311336717428088,0.48307952622673433
305,Chatham,1474,30,350,51,1444,1474,1.0,0.0203527815468114,0.9796472184531886,1073,0.23744911804613297,0.03459972862957938,0.7279511533242876
306,Chatham,1508,15,550,22,1493,1508,1.0,0.009946949602122016,0.9900530503978779,936,0.3647214854111406,0.014588859416445624,0.6206896551724138
307,Chatham,2290,18,1593,54,2272,2290,1.0,0.007860262008733625,0.9921397379912664,643,0.6956331877729257,0.023580786026200874,0.28078602620087334
308,Chatham,3496,78,1054,197,3418,3496,1.0,0.02231121281464531,0.9776887871853547,2245,0.301487414187643,0.05635011441647597,0.642162471395881
309,Chatham,2562,37,791,261,2525,2562,1.0,0.01444184231069477,0.9855581576893052,1510,0.3087431693989071,0.10187353629976581,0.5893832943013271
310,Chatham,2191,41,817,304,2150,2191,1.0,0.018712916476494753,0.9812870835235052,1070,0.372889091738932,0.13874942948425376,0.48836147877681424
311,Chatham,3349,20,1910,102,3329,3349,1.0,0.005971931919976112,0.9940280680800239,1337,0.5703194983577187,0.030456852791878174,0.3992236488504031
312,Chatham,3659,43,1332,398,3616,3659,1.0,0.011751844766329598,0.9882481552336704,1929,0.3640338890407215,0.10877288876742279,0.5271932221918557
313,Chatham,2209,46,754,402,2163,2209,1.0,0.02082390221819828,0.9791760977818017,1053,0.3413309189678588,0.18198279764599365,0.4766862833861476
314,Chatham,2224,37,771,996,2187,2224,1.0,0.016636690647482015,0.983363309352518,457,0.3466726618705036,0.447841726618705,0.20548561151079137
315,Chatham,2896,64,1170,772,2832,2896,1.0,0.022099447513812154,0.9779005524861878,954,0.40400552486187846,0.26657458563535913,0.3294198895027624
316,Chatham,2191,31,790,436,2160,2191,1.0,0.014148790506617983,0.985851209493382,965,0.3605659516202647,0.19899589228662712,0.44043815609310816
317,Chatham,1781,32,474,442,1749,1781,1.0,0.017967434025828188,0.9820325659741718,865,0.26614261650758003,0.24817518248175183,0.48568220101066817
318,Chatham,2814,59,912,334,2755,2814,1.0,0.020966595593461264,0.9790334044065387,1568,0.32409381663113007,0.11869225302061123,0.5572139303482587
319,Chatham,4299,41,1261,977,4258,4299,1.0,0.009537101651546871,0.9904628983484531,2061,0.2933240288439172,0.22726215398929983,0.479413817166783
320,Chatham,4493,101,1557,1367,4392,4493,1.0,0.02247941241931894,0.977520587580681,1569,0.34653906076118407,0.30425105720008905,0.3492098820387269
321,Chatham,6294,148,2091,994,6146,6294,1.0,0.023514458214172227,0.9764855417858278,3209,0.33222116301239274,0.1579281855735621,0.5098506514140452
322,Chatham,1891,46,408,496,1845,1891,1.0,0.024325753569539928,0.9756742464304601,987,0.2157588577472237,0.26229508196721313,0.5219460602855632
323,Chatham,1622,47,244,510,1575,1622,1.0,0.028976572133168926,0.971023427866831,868,0.1504315659679408,0.31442663378545005,0.5351418002466092
324,Chatham,5000,118,1464,441,4882,5000,1.0,0.0236,0.9764,3095,0.2928,0.0882,0.619
325,Chatham,1802,44,433,311,1758,1802,1.0,0.0244173140954495,0.9755826859045506,1058,0.24028856825749167,0.17258601553829078,0.5871254162042175
326,Chatham,4030,102,1087,1030,3928,4030,1.0,0.025310173697270472,0.9746898263027295,1913,0.269727047146402,0.2555831265508685,0.47468982630272955
327,Chatham,8052,176,2187,2581,7876,8052,1.0,0.02185792349726776,0.9781420765027322,3284,0.2716095380029806,0.32054148037754593,0.4078489816194734
328,Chatham,3793,113,366,1387,3680,3793,1.0,0.029791721592407065,0.9702082784075929,2040,0.09649354073292908,0.3656736092802531,0.5378328499868178
329,Chatham,4316,126,979,705,4190,4316,1.0,0.029193697868396665,0.9708063021316033,2632,0.2268303985171455,0.1633456904541242,0.6098239110287303
330,Chatham,4934,116,1652,900,4818,4934,1.0,0.023510336441021483,0.9764896635589785,2382,0.3348196189704094,0.18240778273206323,0.4827725982975274
331,Chatham,9448,136,2508,1464,9312,9448,1.0,0.014394580863674851,0.9856054191363252,5476,0.26545300592718035,0.15495342929720576,0.5795935647756139
332,Chatham,7658,107,2600,2370,7551,7658,1.0,0.013972316531731522,0.9860276834682685,2688,0.3395142334813267,0.30948028205797856,0.3510054844606947
333,Chatham,2343,36,775,1289,2307,2343,1.0,0.015364916773367477,0.9846350832266325,279,0.3307725138711054,0.5501493811352967,0.11907810499359796
334,Chatham,8229,146,3374,1629,8083,8229,1.0,0.017742131486207315,0.9822578685137927,3226,0.4100133673593389,0.1979584396646008,0.3920281929760603
335,Chatham,1521,32,974,546,1489,1521,1.1377245508982037,0.0210387902695595,0.9789612097304405,1,0.6403681788297173,0.358974358974359,0.0006574621959237344
336,Chatham,4751,51,267,64,4700,4751,1.0,0.01073458219322248,0.9892654178067776,4420,0.05619869501157651,0.013470848242475268,0.9303304567459483
337,Chatham,2351,22,827,172,2329,2351,1.0,0.009357720119098255,0.9906422798809017,1352,0.35176520629519353,0.07316035729476818,0.5750744364100383
338,Chatham,1253,35,164,304,1218,1253,1.0,0.027932960893854747,0.9720670391061452,785,0.13088587390263368,0.24261771747805266,0.6264964086193137
339,Chatham,1604,22,639,36,1582,1604,1.0,0.01371571072319202,0.986284289276808,929,0.3983790523690773,0.022443890274314215,0.5791770573566085
340,Chatham,1122,22,509,26,1100,1122,1.0,0.0196078431372549,0.9803921568627451,587,0.4536541889483066,0.023172905525846704,0.5231729055258467
341,Chatham,611,3,320,17,608,611,1.0,0.004909983633387889,0.9950900163666121,274,0.5237315875613748,0.027823240589198037,0.44844517184942717
342,Chatham,1611,23,867,36,1588,1611,1.0,0.014276846679081317,0.9857231533209186,708,0.5381750465549349,0.0223463687150838,0.43947858472998136
343,Chatham,1250,12,672,23,1238,1250,1.0,0.0096,0.9904,555,0.5376,0.0184,0.444
344,Chatham,1685,12,989,14,1673,1685,1.0,0.007121661721068249,0.9928783382789318,682,0.5869436201780416,0.00830860534124629,0.40474777448071214
345,Chatham,1204,5,938,17,1199,1204,1.0,0.004152823920265781,0.9958471760797342,249,0.7790697674418605,0.014119601328903655,0.20681063122923588
346,Chatham,3581,41,526,114,3540,3581,1.0,0.011449315833566042,0.988550684166434,2941,0.14688634459648142,0.031834683049427534,0.8212789723540911
347,Chatham,2027,72,140,268,1955,2027,1.0,0.03552047360631475,0.9644795263936853,1619,0.06906758756783424,0.1322150962012827,0.798717316230883
348,Chatham,1983,41,745,78,1942,1983,1.0,0.020675743822491176,0.9793242561775088,1160,0.3756933938477055,0.039334341906202726,0.5849722642460918
349,Chattahoochee,1957,50,667,880,1907,1957,1.0,0.025549310168625446,0.9744506898313745,410,0.34082779764946347,0.44966785896780787,0.20950434338272866
350,Chattooga,952,8,109,551,944,952,1.0,0.008403361344537815,0.9915966386554622,292,0.11449579831932773,0.5787815126050421,0.3067226890756303
351,Chattooga,1194,16,116,637,1178,1194,1.0,0.01340033500837521,0.9865996649916248,441,0.09715242881072027,0.533500837520938,0.3693467336683417
352,Chattooga,325,14,62,131,311,325,1.0,0.043076923076923075,0.9569230769230769,132,0.19076923076923077,0.40307692307692305,0.40615384615384614
353,Chattooga,185,3,19,113,182,185,1.0,0.016216216216216217,0.9837837837837838,53,0.10270270270270271,0.6108108108108108,0.2864864864864865
354,Chattooga,1014,17,114,598,997,1014,1.0,0.016765285996055226,0.9832347140039448,302,0.11242603550295859,0.5897435897435898,0.2978303747534517
355,Chattooga,190,11,15,100,179,190,1.0,0.05789473684210526,0.9421052631578948,75,0.07894736842105263,0.5263157894736842,0.39473684210526316
356,Chattooga,1124,37,108,537,1087,1124,1.0,0.03291814946619217,0.9670818505338078,479,0.09608540925266904,0.4777580071174377,0.4261565836298932
357,Chattooga,1648,21,51,305,1627,1648,1.0,0.012742718446601941,0.9872572815533981,1292,0.030946601941747573,0.18507281553398058,0.7839805825242718
358,Chattooga,202,0,10,94,202,202,1.0,0.0,1.0,98,0.04950495049504951,0.46534653465346537,0.48514851485148514
359,Chattooga,560,20,37,348,540,560,1.0,0.03571428571428571,0.9642857142857143,175,0.06607142857142857,0.6214285714285714,0.3125
360,Chattooga,7115,153,845,2643,6962,7115,1.0,0.02150386507378777,0.9784961349262122,3627,0.11876317638791287,0.3714687280393535,0.5097680955727336
361,Chattooga,4907,146,368,2007,4761,4907,1.0,0.029753413490931323,0.9702465865090687,2532,0.07499490523741593,0.4090075402486244,0.5159975545139597
362,Cherokee,3218,88,943,1512,3130,3218,1.0,0.027346177750155375,0.9726538222498446,763,0.2930391547545059,0.4698570540708515,0.23710379117464264
363,Cherokee,4968,139,1099,2796,4829,4968,1.0,0.027979066022544283,0.9720209339774557,1073,0.2212157809983897,0.5628019323671497,0.21598228663446054
364,Cherokee,3341,67,580,2302,3274,3341,1.0,0.02005387608500449,0.9799461239149955,459,0.17360071834780005,0.6890152648907513,0.13738401676144868
365,Cherokee,3958,103,489,2549,3855,3958,1.0,0.026023244062657908,0.9739767559373421,920,0.12354724608388075,0.6440121273370389,0.23244062657908035
366,Cherokee,4158,107,981,2158,4051,4158,1.0,0.025733525733525733,0.9742664742664743,1019,0.23593073593073594,0.518999518999519,0.24506974506974508
367,Cherokee,6538,202,1816,2262,6336,6538,1.0,0.030896298562251453,0.9691037014377486,2460,0.2777607831141022,0.3459773631079841,0.3762618537779137
368,Cherokee,4189,78,1009,2049,4111,4189,1.0,0.01862019575077584,0.9813798042492241,1131,0.24086894246836954,0.48913821914538075,0.2699928383862497
369,Cherokee,4279,89,958,2674,4190,4279,1.0,0.020799252161720027,0.9792007478382799,647,0.22388408506660434,0.6249123627015658,0.15120355223182988
370,Cherokee,4750,73,1123,2996,4677,4750,1.0,0.015368421052631578,0.9846315789473684,631,0.23642105263157895,0.6307368421052632,0.1328421052631579
371,Cherokee,10111,358,1894,3814,9753,10111,1.0,0.03540698249431312,0.9645930175056868,4403,0.18732073978834932,0.3772129364058946,0.4354663238057561
372,Cherokee,5346,116,1316,1723,5230,5346,1.0,0.021698466142910586,0.9783015338570894,2307,0.24616535727646838,0.3222970445192667,0.43153759820426485
373,Cherokee,4928,109,790,2864,4819,4928,1.0,0.022118506493506492,0.9778814935064936,1274,0.16030844155844157,0.5811688311688312,0.2585227272727273
374,Cherokee,1046,28,64,616,1018,1046,1.0,0.02676864244741874,0.9732313575525813,366,0.06118546845124283,0.5889101338432122,0.34990439770554493
375,Cherokee,3194,67,836,1488,3127,3194,1.0,0.020976831559173452,0.9790231684408266,870,0.2617407639323732,0.4658735128365686,0.27238572323105825
376,Cherokee,6683,193,1607,2313,6490,6683,1.0,0.0288792458476732,0.9711207541523268,2763,0.24046087086637738,0.346102049977555,0.41343707915606764
377,Cherokee,5580,127,1016,3596,5453,5580,1.0,0.022759856630824374,0.9772401433691756,968,0.182078853046595,0.6444444444444445,0.17347670250896058
378,Cherokee,7100,146,1813,4012,6954,7100,1.0,0.02056338028169014,0.9794366197183099,1275,0.25535211267605634,0.5650704225352112,0.1795774647887324
379,Cherokee,3442,84,438,2308,3358,3442,1.0,0.02440441603718768,0.9755955839628123,696,0.1272515979081929,0.6705403834979663,0.2022080185938408
380,Cherokee,2849,49,735,1799,2800,2849,1.0,0.0171990171990172,0.9828009828009828,315,0.257985257985258,0.6314496314496314,0.11056511056511056
381,Cherokee,3798,113,579,1579,3685,3798,1.0,0.02975250131648236,0.9702474986835177,1640,0.1524486571879937,0.4157451290152712,0.4318062137967351
382,Cherokee,6495,207,1268,2380,6288,6495,1.0,0.03187066974595843,0.9681293302540416,2847,0.19522709776751349,0.36643571978444955,0.43833718244803693
383,Cherokee,8908,253,1996,3870,8655,8908,1.0,0.02840143691064212,0.9715985630893579,3042,0.22406825325550067,0.4344409519533004,0.3414907947911989
384,Cherokee,7774,110,2310,3584,7664,7774,1.0,0.014149729868793414,0.9858502701312066,1880,0.29714432724466167,0.461023925906869,0.24183174684846925
385,Cherokee,4685,97,889,3016,4588,4685,1.0,0.020704375667022414,0.9792956243329776,780,0.18975453575240128,0.6437566702241195,0.1664887940234792
386,Cherokee,3229,88,653,1755,3141,3229,1.0,0.02725301951068442,0.9727469804893156,821,0.20222979250541964,0.5435119231960359,0.25425828429854447
387,Cherokee,8649,165,2179,3295,8484,8649,1.0,0.019077349982656956,0.980922650017343,3175,0.251936640073997,0.38096889813851315,0.3670944617874899
388,Cherokee,3971,121,770,1847,3850,3971,1.0,0.030470914127423823,0.9695290858725761,1354,0.19390581717451524,0.4651221354822463,0.3409720473432385
389,Cherokee,3970,94,332,2237,3876,3970,1.0,0.02367758186397985,0.9763224181360202,1401,0.0836272040302267,0.5634760705289672,0.352896725440806
390,Cherokee,3685,141,513,1021,3544,3685,1.0,0.03826322930800543,0.9617367706919946,2151,0.13921302578018996,0.27706919945725916,0.5837177747625509
391,Cherokee,3601,59,922,1971,3542,3601,1.0,0.016384337683976673,0.9836156623160234,708,0.25603998889197443,0.5473479589003055,0.19661205220772007
392,Cherokee,705,19,69,454,686,705,1.0,0.02695035460992908,0.9730496453900709,182,0.09787234042553192,0.6439716312056738,0.2581560283687943
393,Cherokee,3015,43,708,1787,2972,3015,1.0,0.014262023217247097,0.9857379767827529,520,0.23482587064676616,0.5927031509121061,0.1724709784411277
394,Cherokee,2563,71,324,1696,2492,2563,1.0,0.027701911822083494,0.9722980881779165,543,0.12641435817401483,0.6617245415528678,0.21186110027311744
395,Cherokee,9173,316,1663,4326,8857,9173,1.0,0.03444892619644609,0.9655510738035539,3184,0.18129292488825902,0.47160143900577783,0.3471056361059632
396,Cherokee,6906,153,1599,3429,6753,6906,1.0,0.022154648132059078,0.977845351867941,1878,0.2315377932232841,0.4965247610773241,0.2719374456993918
397,Cherokee,4109,73,712,2693,4036,4109,1.0,0.01776587977610124,0.9822341202238988,704,0.17327816987101485,0.6553906059868582,0.17133122414212704
398,Cherokee,6225,153,863,3167,6072,6225,1.0,0.02457831325301205,0.9754216867469879,2195,0.13863453815261045,0.5087550200803213,0.3526104417670683
399,Cherokee,2930,129,599,1677,2801,2930,1.0,0.04402730375426621,0.9559726962457338,654,0.2044368600682594,0.5723549488054608,0.22320819112627988
400,Cherokee,3057,66,524,1709,2991,3057,1.0,0.021589793915603533,0.9784102060843964,824,0.17140987896630683,0.5590448151782793,0.2695453058554138
401,Cherokee,3511,116,613,1756,3395,3511,1.0,0.03303902022215893,0.9669609797778411,1142,0.17459413272571916,0.5001424095699231,0.3252634577043577
402,Cherokee,3798,37,1078,1553,3761,3798,1.0,0.009741969457609268,0.9902580305423907,1167,0.2838335966298052,0.408899420747762,0.30726698262243285
403,Cherokee,8493,141,2124,2954,8352,8493,1.0,0.01660190745319675,0.9833980925468032,3415,0.25008830801836807,0.34781584834569645,0.4020958436359355
404,Clarke,3813,97,1202,714,3716,3813,1.0,0.025439286650931026,0.974560713349069,1897,0.3152373459218463,0.1872541306058222,0.4975085234723315
405,Clarke,4132,71,1689,807,4061,4132,1.0,0.01718296224588577,0.9828170377541142,1636,0.40876089060987414,0.19530493707647628,0.3959341723136496
406,Clarke,2530,31,1244,561,2499,2530,1.0,0.01225296442687747,0.9877470355731225,725,0.491699604743083,0.2217391304347826,0.2865612648221344
407,Clarke,2803,56,1464,811,2747,2803,1.0,0.019978594363182306,0.9800214056368177,528,0.522297538351766,0.28933285765251515,0.18836960399571887
408,Clarke,5428,83,1864,460,5345,5428,1.0,0.015291083271923361,0.9847089167280766,3104,0.34340456890198967,0.0847457627118644,0.5718496683861459
409,Clarke,6968,72,2334,327,6896,6968,1.0,0.010332950631458095,0.9896670493685419,4307,0.3349598163030999,0.04692881745120551,0.6181113662456946
410,Clarke,3517,56,1309,178,3461,3517,1.0,0.01592266135911288,0.9840773386408871,2030,0.37219220926926355,0.05061131646289451,0.5771964742678419
411,Clarke,8933,122,1842,430,8811,8933,1.0,0.013657226015896116,0.9863427739841039,6661,0.2062017239449233,0.0481361244822568,0.7456621515728199
412,Clarke,3879,56,967,319,3823,3879,1.0,0.014436710492394948,0.9855632895076051,2593,0.24929105439546276,0.08223769012632122,0.6684712554782161
413,Clarke,11684,107,1972,735,11577,11684,1.0,0.009157822663471414,0.9908421773365286,8977,0.1687778158165012,0.06290653885655598,0.7683156453269429
414,Clarke,3458,86,1654,665,3372,3458,1.0,0.024869866975130134,0.9751301330248698,1139,0.4783111625216888,0.19230769230769232,0.32938114517061884
415,Clarke,3193,82,1538,600,3111,3193,1.0,0.025681177575947386,0.9743188224240527,1055,0.48167867209520826,0.18791105543376135,0.3304102724710304
416,Clarke,2157,36,1422,157,2121,2157,1.0,0.016689847009735744,0.9833101529902643,578,0.6592489568845619,0.0727862772369031,0.267964765878535
417,Clarke,3972,61,1427,430,3911,3972,1.0,0.015357502517623363,0.9846424974823766,2115,0.3592648539778449,0.10825780463242698,0.5324773413897281
418,Clarke,3935,78,1453,1211,3857,3935,1.0,0.019822109275730623,0.9801778907242694,1271,0.3692503176620076,0.3077509529860229,0.3229987293519695
419,Clarke,4434,80,1760,921,4354,4434,1.0,0.018042399639152006,0.981957600360848,1753,0.3969327920613442,0.20771312584573748,0.39535408209291834
420,Clarke,4325,86,1367,882,4239,4325,1.0,0.019884393063583816,0.9801156069364162,2076,0.3160693641618497,0.2039306358381503,0.48
421,Clarke,2360,27,979,311,2333,2360,1.0,0.011440677966101695,0.9885593220338983,1070,0.41483050847457625,0.13177966101694916,0.4533898305084746
422,Clarke,3942,62,1374,782,3880,3942,1.0,0.015728056823947234,0.9842719431760527,1786,0.3485540334855403,0.19837645865043124,0.4530695078640284
423,Clarke,4551,43,1397,773,4508,4551,1.0,0.009448472863107009,0.990551527136893,2381,0.3069655020874533,0.16985277960887718,0.5231817183036696
424,Clarke,4400,68,1344,665,4332,4400,1.0,0.015454545454545455,0.9845454545454545,2391,0.3054545454545455,0.15113636363636362,0.543409090909091
425,Clarke,3943,71,1543,601,3872,3943,1.0,0.018006593963986812,0.9819934060360132,1799,0.3913264012173472,0.15242201369515598,0.4562515850874968
426,Clarke,2531,59,1098,431,2472,2531,1.0,0.023310944290794153,0.9766890557092058,1002,0.4338206242591861,0.17028842354800475,0.3958909521928092
427,Clarke,5942,130,1805,675,5812,5942,1.0,0.021878155503197577,0.9781218444968024,3462,0.30376977448670484,0.11359811511275665,0.5826321104005385
428,Clay,403,8,91,173,395,403,1.0,0.019851116625310174,0.9801488833746899,139,0.22580645161290322,0.4292803970223325,0.34491315136476425
429,Clay,392,6,199,53,386,392,1.0,0.015306122448979591,0.9846938775510204,140,0.5076530612244898,0.13520408163265307,0.35714285714285715
430,Clay,462,1,150,200,461,462,1.0,0.0021645021645021645,0.9978354978354979,112,0.3246753246753247,0.4329004329004329,0.24242424242424243
431,Clay,521,9,179,130,512,521,1.0,0.01727447216890595,0.982725527831094,212,0.3435700575815739,0.2495201535508637,0.4069097888675624
432,Clay,468,4,171,81,464,468,1.0,0.008547008547008548,0.9914529914529915,216,0.36538461538461536,0.17307692307692307,0.46153846153846156
433,Clayton,6744,119,4173,288,6625,6744,1.0,0.017645314353499406,0.9823546856465006,2283,0.6187722419928826,0.042704626334519574,0.33852313167259784
434,Clayton,5278,134,1227,314,5144,5278,1.0,0.025388404698749527,0.9746115953012505,3737,0.23247442212959454,0.05949223190602501,0.7080333459643805
435,Clayton,3932,134,1195,271,3798,3932,1.0,0.0340793489318413,0.9659206510681587,2466,0.30391658189216686,0.06892166836215666,0.6271617497456765
436,Clayton,3786,80,1069,275,3706,3786,1.0,0.021130480718436345,0.9788695192815636,2442,0.28235604860010566,0.07263602746962493,0.6450079239302694
437,Clayton,2462,65,655,347,2397,2462,1.0,0.026401299756295696,0.9735987002437043,1460,0.2660438667749797,0.14094232331437856,0.5930138099106418
438,Clayton,6080,164,1507,383,5916,6080,1.0,0.026973684210526316,0.9730263157894737,4190,0.24786184210526316,0.06299342105263157,0.6891447368421053
439,Clayton,1955,50,519,303,1905,1955,1.0,0.02557544757033248,0.9744245524296675,1133,0.26547314578005116,0.15498721227621484,0.579539641943734
440,Clayton,10023,147,5031,500,9876,10023,1.0,0.014666267584555522,0.9853337324154445,4492,0.5019455252918288,0.049885263893046,0.44816921081512523
441,Clayton,3773,68,1397,209,3705,3773,1.0,0.018022793532997614,0.9819772064670024,2167,0.37026239067055394,0.05539358600583091,0.5743440233236151
442,Clayton,4008,76,2059,524,3932,4008,1.0,0.018962075848303395,0.9810379241516967,1425,0.5137225548902196,0.13073852295409183,0.3555389221556886
443,Clayton,3258,58,1575,142,3200,3258,1.0,0.01780233271945979,0.9821976672805403,1541,0.48342541436464087,0.04358502148557397,0.47298956414978516
444,Clayton,2122,17,1219,216,2105,2122,1.0,0.008011310084825637,0.9919886899151744,687,0.5744580584354383,0.10179076343072573,0.323751178133836
445,Clayton,4146,60,2149,829,4086,4146,1.0,0.01447178002894356,0.9855282199710564,1168,0.5183309213699951,0.19995176073323687,0.28171731789676796
446,Clayton,3297,90,1154,144,3207,3297,1.0,0.0272975432211101,0.9727024567788899,1999,0.3500151653017895,0.04367606915377616,0.6063087655444344
447,Clayton,2731,54,1133,203,2677,2731,1.0,0.019772976931526912,0.9802270230684731,1395,0.4148663493225925,0.07433174661296228,0.5108019040644453
448,Clayton,3885,64,1621,253,3821,3885,1.0,0.016473616473616472,0.9835263835263836,2011,0.4172458172458172,0.06512226512226513,0.5176319176319176
449,Clayton,4440,62,2385,155,4378,4440,1.0,0.013963963963963964,0.9860360360360361,1900,0.5371621621621622,0.03490990990990991,0.42792792792792794
450,Clayton,4710,88,2178,460,4622,4710,1.0,0.018683651804670912,0.9813163481953291,2072,0.4624203821656051,0.09766454352441614,0.4399150743099788
451,Clayton,2925,55,974,208,2870,2925,1.0,0.018803418803418803,0.9811965811965812,1743,0.332991452991453,0.07111111111111111,0.5958974358974359
452,Clayton,2123,44,1023,306,2079,2123,1.0,0.02072538860103627,0.9792746113989638,794,0.48186528497409326,0.14413565708902495,0.37399905793688176
453,Clayton,2696,55,1101,874,2641,2696,1.0,0.02040059347181009,0.9795994065281899,721,0.40838278931750743,0.3241839762611276,0.26743323442136496
454,Clayton,3598,57,1618,379,3541,3598,1.0,0.01584213451917732,0.9841578654808226,1601,0.44969427459699834,0.10533629794330183,0.4449694274596998
455,Clayton,5015,68,1761,178,4947,5015,1.0,0.013559322033898305,0.9864406779661017,3076,0.35114656031904284,0.035493519441674976,0.6133599202392822
456,Clayton,2567,71,622,154,2496,2567,1.0,0.02765874561745228,0.9723412543825477,1791,0.24230619400077913,0.05999220880405142,0.6977015971951694
457,Clayton,4306,65,1443,248,4241,4306,1.0,0.015095215977705528,0.9849047840222944,2615,0.3351137947050627,0.057594054807245706,0.6072921504876916
458,Clayton,4256,73,2249,352,4183,4256,1.0,0.017152255639097745,0.9828477443609023,1655,0.5284304511278195,0.08270676691729323,0.3888627819548872
459,Clayton,3864,86,1771,266,3778,3864,1.0,0.022256728778467908,0.977743271221532,1827,0.4583333333333333,0.06884057971014493,0.47282608695652173
460,Clayton,9824,119,4352,700,9705,9824,1.0,0.012113192182410424,0.9878868078175895,4772,0.44299674267100975,0.07125407166123779,0.48574918566775244
461,Clayton,3907,69,2429,253,3838,3907,1.0,0.017660609163040696,0.9823393908369593,1225,0.6217046327105196,0.06475556693114921,0.3135398003583312
462,Clayton,3712,53,1800,179,3659,3712,1.0,0.014278017241379311,0.9857219827586207,1733,0.4849137931034483,0.04822198275862069,0.46686422413793105
463,Clayton,4004,114,1478,202,3890,4004,1.0,0.028471528471528472,0.9715284715284715,2324,0.3691308691308691,0.05044955044955045,0.5804195804195804
464,Clayton,2876,73,789,468,2803,2876,1.0,0.025382475660639777,0.9746175243393602,1619,0.2743393602225313,0.1627260083449235,0.5629346314325452
465,Clayton,5605,94,2243,557,5511,5605,1.0,0.016770740410347904,0.9832292595896521,2805,0.400178412132025,0.09937555753791258,0.5004460303300624
466,Clayton,2421,51,892,260,2370,2421,1.0,0.021065675340768277,0.9789343246592317,1269,0.3684427922346138,0.107393638992152,0.5241635687732342
467,Clayton,5723,84,3089,488,5639,5723,1.0,0.014677616634632186,0.9853223833653678,2146,0.5397518783854621,0.08526996330595842,0.3749781583085794
468,Clayton,3461,94,1597,335,3367,3461,1.0,0.027159780410286046,0.972840219589714,1529,0.46142733314071077,0.09679283444091304,0.4417798324183762
469,Clayton,2463,48,928,218,2415,2463,1.0,0.0194884287454324,0.9805115712545676,1317,0.37677628907835975,0.08850994721883881,0.5347137637028014
470,Clayton,3763,56,1888,173,3707,3763,1.0,0.01488174328992825,0.9851182567100718,1702,0.5017273452032952,0.045973956949242625,0.45229869784746213
471,Clayton,1587,21,718,139,1566,1587,1.0,0.013232514177693762,0.9867674858223062,730,0.4524259609325772,0.08758664146187775,0.4599873976055451
472,Clayton,3026,35,1332,76,2991,3026,1.0,0.011566424322538004,0.988433575677462,1618,0.4401850627891606,0.02511566424322538,0.534699272967614
473,Clayton,2130,24,885,78,2106,2130,1.0,0.011267605633802818,0.9887323943661972,1167,0.4154929577464789,0.036619718309859155,0.547887323943662
474,Clayton,5407,59,2021,118,5348,5407,1.0,0.010911781024597743,0.9890882189754022,3268,0.37377473645274645,0.021823562049195486,0.604401701498058
475,Clayton,4326,38,2031,137,4288,4326,1.0,0.00878409616273694,0.9912159038372631,2158,0.4694868238557559,0.031668978270920016,0.49884419787332407
476,Clayton,2793,33,1817,228,2760,2793,1.0,0.011815252416756176,0.9881847475832438,748,0.6505549588256355,0.08163265306122448,0.26781238811314
477,Clayton,3494,55,1852,490,3439,3494,1.0,0.015741270749856897,0.9842587292501431,1152,0.5300515168860904,0.14024041213508873,0.3297080709788208
478,Clayton,2397,20,1440,124,2377,2397,1.0,0.008343763037129746,0.9916562369628703,833,0.6007509386733417,0.051731330830204425,0.3475177304964539
479,Clayton,3999,43,1321,59,3956,3999,1.0,0.010752688172043012,0.989247311827957,2619,0.33033258314578645,0.014753688422105527,0.654913728432108
480,Clayton,1933,25,1101,71,1908,1933,1.0,0.012933264355923435,0.9870667356440765,761,0.5695809622348681,0.03673047077082255,0.3936885669943094
481,Clayton,3200,59,1694,175,3141,3200,1.0,0.0184375,0.9815625,1331,0.529375,0.0546875,0.4159375
482,Clayton,3995,46,1772,124,3949,3995,1.0,0.01151439299123905,0.988485607008761,2099,0.44355444305381725,0.031038798498122654,0.5254067584480601
483,Clayton,3537,47,2033,145,3490,3537,1.0,0.013288097257562907,0.9867119027424371,1359,0.574780887757987,0.04099519366694939,0.3842239185750636
484,Clayton,4995,81,2058,225,4914,4995,1.0,0.016216216216216217,0.9837837837837838,2712,0.412012012012012,0.04504504504504504,0.542942942942943
485,Clayton,3192,57,1552,163,3135,3192,1.0,0.017857142857142856,0.9821428571428571,1477,0.48621553884711777,0.05106516290726817,0.46271929824561403
486,Clayton,4618,74,1357,235,4544,4618,1.0,0.01602425292334344,0.9839757470766566,3026,0.2938501515807709,0.05088783022953659,0.6552620181896925
487,Clayton,4166,86,1122,213,4080,4166,1.0,0.020643302928468554,0.9793566970715314,2831,0.26932309169467117,0.05112818050888142,0.6795487277964475
488,Clayton,3009,58,1722,205,2951,3009,1.0,0.01927550681289465,0.9807244931871053,1082,0.5722831505483549,0.06812894649385177,0.3595879029577933
489,Clayton,2944,45,1355,194,2899,2944,1.0,0.015285326086956522,0.9847146739130435,1395,0.460258152173913,0.06589673913043478,0.47384510869565216
490,Clinch,152,2,12,68,150,152,1.0,0.013157894736842105,0.9868421052631579,72,0.07894736842105263,0.4473684210526316,0.47368421052631576
491,Clinch,529,22,39,220,507,529,1.0,0.04158790170132325,0.9584120982986768,270,0.07372400756143667,0.4158790170132325,0.5103969754253308
492,Clinch,398,10,54,184,388,398,1.0,0.02512562814070352,0.9748743718592965,160,0.135678391959799,0.4623115577889447,0.4020100502512563
493,Clinch,282,6,22,169,276,282,1.0,0.02127659574468085,0.9787234042553191,91,0.07801418439716312,0.599290780141844,0.32269503546099293
494,Clinch,3673,47,620,1464,3626,3673,1.0,0.0127960794990471,0.9872039205009528,1589,0.16879934658317453,0.39858426354478627,0.4326163898720392
495,Cobb,5781,141,2037,1919,5640,5781,1.0,0.024390243902439025,0.975609756097561,1825,0.35236118318629994,0.331949489707663,0.31568932710603703
496,Cobb,5925,135,1682,1941,5790,5925,1.0,0.02278481012658228,0.9772151898734177,2302,0.2838818565400844,0.32759493670886075,0.38852320675105484
497,Cobb,5343,97,2249,1183,5246,5343,1.0,0.018154594796930563,0.9818454052030694,1911,0.4209245742092457,0.22141119221411193,0.35766423357664234
498,Cobb,2532,49,990,930,2483,2532,1.0,0.019352290679304898,0.9806477093206951,612,0.3909952606635071,0.36729857819905215,0.24170616113744076
499,Cobb,5764,135,2683,638,5629,5764,1.0,0.023421235253296323,0.9765787647467037,2443,0.46547536433032616,0.11068702290076336,0.42383761276891047
500,Cobb,5535,80,1984,1319,5455,5535,1.0,0.014453477868112014,0.985546522131888,2232,0.35844625112917794,0.23830171635049685,0.4032520325203252
501,Cobb,3246,67,1127,1127,3179,3246,1.0,0.020640788662969808,0.9793592113370302,992,0.3471965495995071,0.3471965495995071,0.30560690080098585
502,Cobb,6654,201,2051,2214,6453,6654,1.0,0.030207394048692517,0.9697926059513075,2389,0.3082356477306883,0.3327321911632101,0.3590321611061016
503,Cobb,3135,62,747,827,3073,3135,1.0,0.019776714513556618,0.9802232854864433,1561,0.23827751196172248,0.2637958532695375,0.49792663476874005
504,Cobb,3301,66,1229,1231,3235,3301,1.0,0.019993941229930322,0.9800060587700696,841,0.37231142078158136,0.37291729778854893,0.2547712814298697
505,Cobb,3211,99,1152,641,3112,3211,1.0,0.030831516661476176,0.9691684833385238,1418,0.358766739333541,0.19962628464652757,0.4416069760199315
506,Cobb,4107,70,1970,929,4037,4107,1.0,0.01704407109812515,0.9829559289018749,1208,0.4796688580472364,0.2261991721451181,0.2941319698076455
507,Cobb,2918,61,1113,908,2857,2918,1.0,0.020904729266620972,0.979095270733379,897,0.3814256339958876,0.3111720356408499,0.30740233036326253
508,Cobb,2267,59,1377,101,2208,2267,1.0,0.026025584472871635,0.9739744155271284,789,0.6074106749007498,0.04455227172474636,0.34803705337450375
509,Cobb,7946,126,2816,244,7820,7946,1.0,0.015857034986156558,0.9841429650138435,4886,0.35439214699219734,0.03070727410017619,0.6149005789076265
510,Cobb,9930,169,2467,1349,9761,9930,1.0,0.01701913393756294,0.9829808660624371,6114,0.2484390735146022,0.13585095669687813,0.6157099697885197
511,Cobb,9086,114,2860,986,8972,9086,1.0,0.012546775258639665,0.9874532247413603,5240,0.31476997578692495,0.10851860004402378,0.5767114241690513
512,Cobb,2956,46,1062,1408,2910,2956,1.0,0.015561569688768605,0.9844384303112313,486,0.35926928281461434,0.476319350473613,0.16441136671177267
513,Cobb,3869,53,1645,1599,3816,3869,1.0,0.0136986301369863,0.9863013698630136,625,0.4251744636857069,0.413285086585681,0.16154044972861203
514,Cobb,2889,25,1215,1446,2864,2889,1.0,0.008653513326410523,0.9913464866735895,228,0.4205607476635514,0.5005192107995846,0.07892004153686397
515,Cobb,2133,74,764,478,2059,2133,1.0,0.034692920768870136,0.9653070792311299,891,0.35818096577590247,0.22409751523675575,0.4177215189873418
516,Cobb,5383,108,2596,1030,5275,5383,1.0,0.020063161805684564,0.9799368381943154,1757,0.4822589634033067,0.19134311722088054,0.32639791937581275
517,Cobb,6482,108,2611,694,6374,6482,1.0,0.01666152422091947,0.9833384757790805,3177,0.40280777537796975,0.10706572045664918,0.49012650416538106
518,Cobb,2055,52,807,857,2003,2055,1.0,0.025304136253041364,0.9746958637469586,391,0.3927007299270073,0.4170316301703163,0.1902676399026764
519,Cobb,2791,51,1149,1209,2740,2791,1.0,0.01827302042278753,0.9817269795772124,433,0.4116804012898603,0.43317807237549266,0.1551415263346471
520,Cobb,10186,204,2839,977,9982,10186,1.0,0.020027488709994108,0.9799725112900058,6370,0.278715884547418,0.09591596308658944,0.6253681523659925
521,Cobb,2025,15,810,921,2010,2025,1.0,0.007407407407407408,0.9925925925925926,294,0.4,0.45481481481481484,0.1451851851851852
522,Cobb,3254,98,1385,1071,3156,3254,1.0,0.03011677934849416,0.9698832206515058,798,0.4256299938537185,0.32913337430854334,0.24523663183773817
523,Cobb,3877,57,1179,2283,3820,3877,1.0,0.014702089244261026,0.985297910755739,415,0.30410110910497806,0.5888573639411916,0.10704152695383028
524,Cobb,3186,65,1077,782,3121,3186,1.0,0.020401757689893284,0.9795982423101067,1327,0.3380414312617702,0.24544883866917766,0.4165097300690521
525,Cobb,2918,36,1200,1335,2882,2918,1.0,0.01233721727210418,0.9876627827278959,383,0.41124057573680606,0.4575051405071967,0.13125428375599726
526,Cobb,3990,54,1601,1698,3936,3990,1.0,0.013533834586466165,0.9864661654135338,691,0.4012531328320802,0.4255639097744361,0.17318295739348372
527,Cobb,4674,101,1721,722,4573,4674,1.0,0.02160890029952931,0.9783910997004707,2231,0.36820710312366284,0.15447154471544716,0.47732135216089006
528,Cobb,2606,56,864,1022,2550,2606,1.0,0.021488871834228703,0.9785111281657713,720,0.33154259401381425,0.39217191097467385,0.2762854950115119
529,Cobb,2898,54,1014,1226,2844,2898,1.0,0.018633540372670808,0.9813664596273292,658,0.3498964803312629,0.4230503795721187,0.22705314009661837
530,Cobb,3443,72,1317,715,3371,3443,1.0,0.02091199535288992,0.9790880046471101,1411,0.3825152483299448,0.20766773162939298,0.4098170200406622
531,Cobb,3023,63,1168,1103,2960,3023,1.0,0.020840224942110488,0.9791597750578895,752,0.38637115448230236,0.3648693350975852,0.24875951042011246
532,Cobb,7119,195,2551,956,6924,7119,1.0,0.027391487568478718,0.9726085124315212,3612,0.3583368450625088,0.13428852366905464,0.5073746312684366
533,Cobb,8891,261,1825,856,8630,8891,1.0,0.029355528062085256,0.9706444719379147,6210,0.2052637498594084,0.09627713418063209,0.6984591159599595
534,Cobb,2866,36,866,1664,2830,2866,1.0,0.01256106071179344,0.9874389392882066,336,0.30216329378925333,0.5806001395673412,0.11723656664340544
535,Cobb,2454,38,732,1287,2416,2454,1.0,0.015484922575387123,0.9845150774246129,435,0.2982885085574572,0.5244498777506112,0.17726161369193155
536,Cobb,3502,30,1374,1436,3472,3502,1.0,0.008566533409480296,0.9914334665905197,692,0.3923472301541976,0.41005139920045686,0.19760137064534553
537,Cobb,2706,36,1105,1211,2670,2706,1.0,0.013303769401330377,0.9866962305986696,390,0.40835181079083516,0.4475240206947524,0.14412416851441243
538,Cobb,4281,134,1359,1578,4147,4281,1.0,0.03130109787432843,0.9686989021256716,1344,0.3174491941135249,0.3686054660126139,0.31394533987386125
539,Cobb,7217,151,3817,705,7066,7217,1.0,0.020922821116807537,0.9790771788831925,2695,0.5288901205487044,0.09768601912151864,0.3734238603297769
540,Cobb,2993,72,816,1665,2921,2993,1.0,0.024056130972268625,0.9759438690277313,512,0.2726361510190444,0.556298028733712,0.17106582024724357
541,Cobb,3977,74,1216,2014,3903,3977,1.0,0.018606990193613275,0.9813930098063868,747,0.305758109127483,0.5064118682423938,0.18783002263012322
542,Cobb,4012,45,1640,1858,3967,4012,1.0,0.011216350947158525,0.9887836490528414,514,0.4087736789631107,0.46311066799601197,0.12811565304087738
543,Cobb,2005,53,690,853,1952,2005,1.0,0.026433915211970076,0.97356608478803,462,0.34413965087281795,0.42543640897755614,0.23042394014962594
544,Cobb,1793,16,546,1023,1777,1793,1.0,0.008923591745677636,0.9910764082543224,224,0.3045175683212493,0.5705521472392638,0.1249302844394869
545,Cobb,4060,73,1429,1765,3987,4060,1.0,0.017980295566502463,0.9820197044334975,866,0.3519704433497537,0.43472906403940886,0.21330049261083744
546,Cobb,3612,58,1005,2187,3554,3612,1.0,0.016057585825027684,0.9839424141749723,420,0.2782392026578073,0.6054817275747508,0.11627906976744186
547,Cobb,3770,87,876,750,3683,3770,1.0,0.023076923076923078,0.9769230769230769,2144,0.2323607427055703,0.1989389920424403,0.5687002652519894
548,Cobb,4385,128,1379,1329,4257,4385,1.0,0.02919042189281642,0.9708095781071836,1677,0.3144811858608894,0.303078677309008,0.38244013683010264
549,Cobb,7654,173,2665,1554,7481,7654,1.0,0.022602560752547688,0.9773974392474523,3435,0.3481839561013849,0.20303109485236479,0.4487849490462503
550,Cobb,4280,94,1396,1251,4186,4280,1.0,0.021962616822429906,0.97803738317757,1633,0.32616822429906545,0.29228971962616823,0.3815420560747664
551,Cobb,5933,102,2509,1936,5831,5933,1.0,0.017191977077363897,0.9828080229226361,1488,0.42288892634417663,0.3263104668801618,0.25080060677566157
552,Cobb,3457,41,1316,1613,3416,3457,1.0,0.011859994214636968,0.988140005785363,528,0.38067688747468903,0.4665895284929129,0.15273358403239803
553,Cobb,5429,81,2942,769,5348,5429,1.0,0.01491987474673052,0.9850801252532695,1718,0.5419045864800147,0.14164671210167618,0.3164487014183091
554,Cobb,3385,68,1259,1711,3317,3385,1.0,0.020088626292466764,0.9799113737075332,415,0.3719350073855244,0.5054652880354505,0.12259970457902511
555,Cobb,3793,66,1227,2305,3727,3793,1.0,0.017400474558397046,0.982599525441603,261,0.32349064065383604,0.6076983917743212,0.06881096757184287
556,Cobb,5086,100,1735,2588,4986,5086,1.0,0.019661816751867872,0.9803381832481322,763,0.34113252064490757,0.5088478175383405,0.15001966181675186
557,Cobb,2463,41,794,1313,2422,2463,1.0,0.01664636622005684,0.9833536337799431,356,0.3223710921640276,0.5330897279740154,0.14453917986195697
558,Cobb,5589,126,2498,1045,5463,5589,1.0,0.02254428341384863,0.9774557165861514,2046,0.44694936482376096,0.18697441402755413,0.36607622114868493
559,Cobb,4202,82,1416,534,4120,4202,1.0,0.01951451689671585,0.9804854831032842,2252,0.3369823893384103,0.1270823417420276,0.5359352689195621
560,Cobb,3192,88,1247,890,3104,3192,1.0,0.02756892230576441,0.9724310776942355,1055,0.3906641604010025,0.27882205513784464,0.33051378446115287
561,Cobb,1585,28,710,549,1557,1585,1.0,0.017665615141955835,0.9823343848580441,326,0.4479495268138801,0.3463722397476341,0.2056782334384858
562,Cobb,1492,20,538,833,1472,1492,1.0,0.013404825737265416,0.9865951742627346,121,0.3605898123324397,0.5583109919571045,0.08109919571045576
563,Cobb,4219,107,2183,759,4112,4219,1.0,0.025361460061625977,0.974638539938374,1277,0.517421189855416,0.17990045034368335,0.3026783598009007
564,Cobb,8168,294,1624,706,7874,8168,1.0,0.03599412340842312,0.9640058765915769,5838,0.19882468168462292,0.08643486777668952,0.7147404505386875
565,Cobb,1963,20,755,943,1943,1963,1.0,0.010188487009679063,0.9898115129903209,265,0.38461538461538464,0.4803871625063678,0.13499745287824758
566,Cobb,4572,97,1921,1145,4475,4572,1.0,0.02121609798775153,0.9787839020122485,1506,0.42016622922134733,0.2504374453193351,0.3293963254593176
567,Cobb,7037,146,2854,1696,6891,7037,1.0,0.020747477618303253,0.9792525223816968,2487,0.40557055563450334,0.24101179479892,0.3534176495665767
568,Cobb,2155,22,568,1080,2133,2155,1.0,0.010208816705336427,0.9897911832946635,507,0.2635730858468677,0.5011600928074246,0.23526682134570764
569,Cobb,2672,57,831,683,2615,2672,1.0,0.02133233532934132,0.9786676646706587,1158,0.31100299401197606,0.2556137724550898,0.4333832335329341
570,Cobb,2562,27,950,1294,2535,2562,1.0,0.01053864168618267,0.9894613583138173,318,0.3708040593286495,0.5050741608118657,0.12412177985948478
571,Cobb,3505,81,1479,589,3424,3505,1.0,0.02310984308131241,0.9768901569186876,1437,0.42196861626248217,0.1680456490727532,0.4099857346647646
572,Cobb,3855,77,1240,385,3778,3855,1.0,0.019974059662775615,0.9800259403372243,2230,0.3216601815823606,0.09987029831387809,0.5784695201037614
573,Cobb,3599,107,1184,374,3492,3599,1.0,0.0297304806890803,0.9702695193109196,2041,0.32898027229786053,0.10391775493192554,0.5671019727702139
574,Cobb,3037,39,1283,970,2998,3037,1.0,0.012841620019756339,0.9871583799802437,784,0.42245637141916365,0.3193941389529141,0.2581494896279223
575,Cobb,5304,238,1461,359,5066,5304,1.0,0.04487179487179487,0.9551282051282052,3484,0.2754524886877828,0.06768476621417797,0.6568627450980392
576,Cobb,3907,103,743,1983,3804,3907,1.0,0.026362938315843357,0.9736370616841566,1181,0.1901714870744817,0.5075505502943435,0.3022779626311748
577,Cobb,3118,81,943,1119,3037,3118,1.0,0.025978191148171906,0.9740218088518281,1056,0.3024374599101988,0.35888389993585634,0.33867864015394483
578,Cobb,1764,30,609,810,1734,1764,1.0,0.017006802721088437,0.9829931972789115,345,0.34523809523809523,0.45918367346938777,0.195578231292517
579,Cobb,3130,80,991,1593,3050,3130,1.0,0.025559105431309903,0.9744408945686901,546,0.31661341853035146,0.5089456869009584,0.1744408945686901
580,Cobb,3512,76,1636,1053,3436,3512,1.0,0.02164009111617312,0.9783599088838268,823,0.46583143507972663,0.29982915717539865,0.23433940774487472
581,Cobb,3888,53,1626,1760,3835,3888,1.0,0.013631687242798354,0.9863683127572016,502,0.4182098765432099,0.45267489711934156,0.12911522633744857
582,Cobb,3432,47,1344,1299,3385,3432,1.0,0.013694638694638694,0.9863053613053613,789,0.3916083916083916,0.3784965034965035,0.2298951048951049
583,Cobb,2808,20,1094,1305,2788,2808,1.0,0.007122507122507123,0.9928774928774928,409,0.3896011396011396,0.46474358974358976,0.14565527065527065
584,Cobb,3897,60,1598,1722,3837,3897,1.0,0.015396458814472672,0.9846035411855273,577,0.41005901975878883,0.44187836797536567,0.14806261226584552
585,Cobb,2515,61,843,969,2454,2515,1.0,0.024254473161033796,0.9757455268389662,703,0.3351888667992048,0.3852882703777336,0.27952286282306166
586,Cobb,5108,86,2706,781,5022,5108,1.0,0.016836335160532498,0.9831636648394675,1621,0.5297572435395458,0.1528974158183242,0.31734534064213
587,Cobb,2520,55,864,796,2465,2520,1.0,0.021825396825396824,0.9781746031746031,860,0.34285714285714286,0.31587301587301586,0.3412698412698413
588,Cobb,5811,130,1980,1142,5681,5811,1.0,0.02237136465324385,0.9776286353467561,2689,0.34073309241094474,0.19652383410772672,0.46274307348132854
589,Cobb,3729,52,1891,1130,3677,3729,1.0,0.013944757307589166,0.9860552426924108,708,0.5071064628586752,0.30303030303030304,0.1898632341110217
590,Cobb,1489,24,567,767,1465,1489,1.0,0.016118200134318333,0.9838817998656817,155,0.38079247817327067,0.5151108126259234,0.10409670920080591
591,Cobb,6312,185,2812,989,6127,6312,1.0,0.029309252217997465,0.9706907477820025,2511,0.44550063371356147,0.15668567807351078,0.39781368821292773
592,Cobb,9841,257,2274,868,9584,9841,1.0,0.026115232191850423,0.9738847678081496,6699,0.23107407783761813,0.0882024184534092,0.6807235037089726
593,Cobb,5057,140,2325,895,4917,5057,1.0,0.02768439786434645,0.9723156021356536,1837,0.4597587502471821,0.17698240063278622,0.36325884912003165
594,Cobb,3602,80,1835,1217,3522,3602,1.0,0.02220988339811216,0.9777901166018879,550,0.5094392004441977,0.3378678511937812,0.1526929483620211
595,Cobb,2903,54,859,1138,2849,2903,1.0,0.018601446779193936,0.981398553220806,906,0.2959007922838443,0.39200826730967964,0.31209094040647606
596,Cobb,6080,158,2673,629,5922,6080,1.0,0.02598684210526316,0.9740131578947369,2778,0.43963815789473687,0.10345394736842105,0.4569078947368421
597,Cobb,3255,46,1041,1779,3209,3255,1.0,0.0141321044546851,0.985867895545315,435,0.31981566820276497,0.5465437788018433,0.1336405529953917
598,Cobb,3003,27,859,1750,2976,3003,1.0,0.008991008991008992,0.991008991008991,394,0.286047286047286,0.5827505827505828,0.1312021312021312
599,Cobb,2840,65,966,1111,2775,2840,1.0,0.022887323943661973,0.977112676056338,763,0.3401408450704225,0.3911971830985915,0.2686619718309859
600,Cobb,3034,35,1173,1349,2999,3034,1.0,0.011535926170072512,0.9884640738299275,512,0.38661832564271587,0.4446275543836519,0.16875411997363216
601,Cobb,3475,66,1289,1680,3409,3475,1.0,0.018992805755395685,0.9810071942446044,506,0.3709352517985611,0.48345323741007196,0.14561151079136692
602,Cobb,4833,101,2592,987,4732,4833,1.0,0.020897992965032072,0.979102007034968,1254,0.5363128491620112,0.2042209807572936,0.2594661700806952
603,Cobb,3795,62,1806,463,3733,3795,1.0,0.016337285902503294,0.9836627140974967,1526,0.4758893280632411,0.1220026350461133,0.40210803689064556
604,Cobb,4104,84,1972,731,4020,4104,1.0,0.02046783625730994,0.97953216374269,1401,0.48050682261208577,0.1781189083820663,0.34137426900584794
605,Cobb,4300,127,1287,1213,4173,4300,1.0,0.029534883720930234,0.9704651162790697,1800,0.29930232558139536,0.282093023255814,0.4186046511627907
606,Cobb,2716,72,997,119,2644,2716,1.0,0.026509572901325478,0.9734904270986745,1600,0.36708394698085417,0.04381443298969072,0.5891016200294551
607,Cobb,3374,80,1234,1441,3294,3374,1.0,0.023710729104919975,0.97628927089508,699,0.3657379964433906,0.42708950800237105,0.2071724955542383
608,Cobb,4982,58,2141,2387,4924,4982,1.0,0.011641910879164994,0.988358089120835,454,0.4297470895222802,0.47912484945804895,0.09112806101967082
609,Cobb,3427,29,1518,1545,3398,3427,1.0,0.008462211847096586,0.9915377881529034,364,0.4429530201342282,0.45083163116428365,0.10621534870148819
610,Cobb,2937,60,1192,1117,2877,2937,1.0,0.020429009193054137,0.9795709908069459,628,0.4058563159686755,0.38032005447735784,0.21382362955396664
611,Cobb,3572,71,1481,1334,3501,3572,1.0,0.019876819708846586,0.9801231802911534,757,0.41461366181410975,0.3734602463605823,0.21192609182530794
612,Cobb,5564,95,1859,1249,5469,5564,1.0,0.017074047447879225,0.9829259525521208,2456,0.3341121495327103,0.22447879223580158,0.4414090582314881
613,Cobb,3215,51,1294,1487,3164,3215,1.0,0.015863141524105753,0.9841368584758943,434,0.40248833592534994,0.4625194401244168,0.13499222395023328
614,Cobb,1788,8,756,738,1780,1788,1.0,0.0044742729306487695,0.9955257270693513,294,0.4228187919463087,0.412751677852349,0.1644295302013423
615,Cobb,5765,105,1931,554,5660,5765,1.0,0.01821335646140503,0.981786643538595,3280,0.33495229835212487,0.09609713790112749,0.5689505637467476
616,Cobb,6669,120,2791,849,6549,6669,1.0,0.01799370220422852,0.9820062977957715,3029,0.41850352376668165,0.1273054430949168,0.45419103313840153
617,Cobb,7586,142,3374,1675,7444,7586,1.0,0.01871869232797258,0.9812813076720274,2537,0.44476667545478515,0.22080147640390194,0.33443184814131294
618,Cobb,6098,94,2815,1853,6004,6098,1.0,0.01541489012791079,0.9845851098720892,1430,0.46162676287307314,0.30387012135126273,0.23450311577566416
619,Cobb,5380,139,2006,811,5241,5380,1.0,0.0258364312267658,0.9741635687732342,2563,0.3728624535315985,0.1507434944237918,0.47639405204460966
620,Cobb,6250,113,2808,1706,6137,6250,1.0,0.01808,0.98192,1736,0.44928,0.27296,0.27776
621,Cobb,5814,81,3785,1367,5733,5814,1.0,0.01393188854489164,0.9860681114551083,662,0.651014791881665,0.2351221190230478,0.11386308909528724
622,Cobb,2027,30,835,970,1997,2027,1.0,0.01480019733596448,0.9851998026640355,222,0.4119388258510113,0.4785397138628515,0.10952146028613714
623,Cobb,4863,77,1963,1632,4786,4863,1.0,0.015833847419288505,0.9841661525807115,1268,0.40366029200082254,0.33559531153608885,0.2607443964630886
624,Cobb,3213,59,1089,1213,3154,3213,1.0,0.01836290071584189,0.9816370992841581,911,0.3389355742296919,0.37752878929349515,0.28353563647681296
625,Cobb,3255,67,1439,867,3188,3255,1.0,0.020583717357910907,0.9794162826420891,949,0.44208909370199695,0.2663594470046083,0.29155145929339477
626,Cobb,4065,60,1517,444,4005,4065,1.0,0.014760147601476014,0.985239852398524,2104,0.37318573185731857,0.10922509225092251,0.5175891758917589
627,Cobb,7645,120,2477,1030,7525,7645,1.0,0.015696533682145193,0.9843034663178548,4138,0.32400261608894704,0.13472858077174624,0.5412688031393067
628,Cobb,2224,22,1016,1025,2202,2224,1.0,0.009892086330935251,0.9901079136690647,183,0.4568345323741007,0.4608812949640288,0.0822841726618705
629,Cobb,2944,81,877,1630,2863,2944,1.0,0.02751358695652174,0.9724864130434783,437,0.29789402173913043,0.5536684782608695,0.1484375
630,Cobb,4067,53,1598,700,4014,4067,1.0,0.013031718711581017,0.986968281288419,1769,0.3929186132284239,0.1721170395869191,0.434964347184657
631,Cobb,8295,108,2962,1441,8187,8295,1.0,0.013019891500904159,0.9869801084990958,3892,0.35708257986739,0.17371910789632308,0.46919831223628694
632,Cobb,4839,54,2236,1002,4785,4839,1.0,0.011159330440173589,0.9888406695598264,1601,0.46207894193015087,0.20706757594544328,0.33085348212440585
633,Cobb,3479,37,1350,1296,3442,3479,1.0,0.010635240011497557,0.9893647599885025,833,0.388042540960046,0.37252083932164415,0.23943661971830985
634,Cobb,4982,102,1859,1605,4880,4982,1.0,0.020473705339221198,0.9795262946607788,1518,0.37314331593737454,0.32215977519068645,0.30469690887193895
635,Cobb,2601,44,1079,1270,2557,2601,1.0,0.016916570549788543,0.9830834294502114,252,0.4148404459823145,0.4882737408688966,0.09688581314878893
636,Coffee,2415,29,264,1104,2386,2415,1.0,0.012008281573498964,0.987991718426501,1047,0.1093167701863354,0.45714285714285713,0.4335403726708075
637,Coffee,339,5,60,190,334,339,1.0,0.014749262536873156,0.9852507374631269,89,0.17699115044247787,0.56047197640118,0.26253687315634217
638,Coffee,2698,93,378,1200,2605,2698,1.0,0.03446997776130467,0.9655300222386953,1120,0.14010378057820608,0.4447739065974796,0.41512231282431433
639,Coffee,20978,371,3485,6510,20607,20978,1.0,0.01768519401277529,0.9823148059872248,10983,0.16612641815235007,0.3103251024883211,0.5235484793593288
640,Coffee,4852,50,288,963,4802,4852,1.0,0.010305028854080791,0.9896949711459192,3601,0.05935696619950536,0.19847485572959606,0.7421681780708986
641,Coffee,1137,27,36,611,1110,1137,1.0,0.023746701846965697,0.9762532981530343,490,0.0316622691292876,0.5373790677220757,0.4309586631486368
642,Colquitt,2501,62,202,746,2439,2501,1.0,0.024790083966413436,0.9752099160335865,1553,0.08076769292283087,0.29828068772491,0.6209516193522591
643,Colquitt,1622,16,99,795,1606,1622,1.0,0.009864364981504316,0.9901356350184957,728,0.06103575832305795,0.49013563501849566,0.44882860665844637
644,Colquitt,397,6,51,137,391,397,1.0,0.015113350125944584,0.9848866498740554,209,0.12846347607052896,0.345088161209068,0.5264483627204031
645,Colquitt,759,13,140,294,746,759,1.0,0.017127799736495388,0.9828722002635046,325,0.1844532279314888,0.38735177865612647,0.4281949934123847
646,Colquitt,1318,13,107,613,1305,1318,1.0,0.009863429438543247,0.9901365705614568,598,0.08118361153262518,0.4650986342943854,0.4537177541729894
647,Colquitt,884,21,55,512,863,884,1.0,0.023755656108597284,0.9762443438914027,317,0.06221719457013575,0.579185520361991,0.3585972850678733
648,Colquitt,448,9,27,291,439,448,1.0,0.020089285714285716,0.9799107142857143,130,0.060267857142857144,0.6495535714285714,0.29017857142857145
649,Colquitt,2138,32,187,971,2106,2138,1.0,0.014967259120673527,0.9850327408793265,980,0.08746492048643592,0.45416276894293733,0.4583723105706268
650,Colquitt,1787,40,108,558,1747,1787,1.0,0.02238388360380526,0.9776161163961947,1121,0.0604364857302742,0.31225517627308336,0.6273083379966424
651,Colquitt,537,6,27,281,531,537,1.0,0.0111731843575419,0.9888268156424581,229,0.05027932960893855,0.5232774674115456,0.4264432029795158
652,Colquitt,2019,28,170,888,1991,2019,1.0,0.013868251609707775,0.9861317483902923,961,0.08420009905894008,0.4398216939078752,0.4759782070331847
653,Colquitt,6656,119,1169,1799,6537,6656,1.0,0.017878605769230768,0.9821213942307693,3688,0.1756310096153846,0.2702824519230769,0.5540865384615384
654,Colquitt,1148,21,96,676,1127,1148,1.0,0.018292682926829267,0.9817073170731707,376,0.08362369337979095,0.5888501742160279,0.32752613240418116
655,Colquitt,3331,84,372,1226,3247,3331,1.0,0.025217652356649654,0.9747823476433504,1733,0.11167817472230561,0.3680576403482438,0.5202641849294506
656,Colquitt,1302,27,93,480,1275,1302,1.0,0.020737327188940093,0.9792626728110599,729,0.07142857142857142,0.3686635944700461,0.5599078341013825
657,Colquitt,4648,82,1152,429,4566,4648,1.0,0.017641996557659207,0.9823580034423408,3067,0.24784853700516352,0.09229776247848537,0.6598537005163512
658,Colquitt,283,5,17,159,278,283,1.0,0.0176678445229682,0.9823321554770318,107,0.06007067137809187,0.5618374558303887,0.37809187279151946
659,Colquitt,932,19,31,328,913,932,1.0,0.0203862660944206,0.9796137339055794,573,0.033261802575107295,0.351931330472103,0.6148068669527897
660,Colquitt,1483,34,84,594,1449,1483,1.0,0.022926500337154418,0.9770734996628456,805,0.056641942009440324,0.4005394470667566,0.5428186109238031
661,Columbia,2197,43,464,963,2154,2197,1.0,0.01957214383249886,0.9804278561675012,770,0.21119708693673192,0.4383249886208466,0.3504779244424215
662,Columbia,2347,51,605,1003,2296,2347,1.0,0.021729867916489135,0.9782701320835109,739,0.2577758841073711,0.4273540690242863,0.3148700468683426
663,Columbia,2476,60,677,1109,2416,2476,1.0,0.024232633279483037,0.975767366720517,690,0.2734248788368336,0.44789983844911146,0.27867528271405495
664,Columbia,2237,47,88,531,2190,2237,1.0,0.02101028162717926,0.9789897183728208,1618,0.03933839964237819,0.2373714796602593,0.7232901206973625
665,Columbia,4212,111,596,796,4101,4212,1.0,0.026353276353276354,0.9736467236467237,2820,0.14150047483380818,0.1889838556505223,0.6695156695156695
666,Columbia,2380,54,618,1018,2326,2380,1.0,0.0226890756302521,0.9773109243697479,744,0.2596638655462185,0.42773109243697477,0.3126050420168067
667,Columbia,2031,38,499,1138,1993,2031,1.0,0.018709995076317085,0.9812900049236829,394,0.24569177744953224,0.5603151157065485,0.19399310684391924
668,Columbia,2702,60,570,1268,2642,2702,1.0,0.02220577350111029,0.9777942264988897,864,0.21095484826054775,0.4692820133234641,0.31976313841598814
669,Columbia,2168,36,565,1186,2132,2168,1.0,0.016605166051660517,0.9833948339483395,417,0.2606088560885609,0.5470479704797048,0.19234317343173432
670,Columbia,2606,49,649,984,2557,2606,1.0,0.018802762854950115,0.9811972371450499,973,0.24904067536454336,0.3775901765157329,0.3733691481197237
671,Columbia,2351,43,570,1068,2308,2351,1.0,0.018290089323692044,0.981709910676308,713,0.24245002126754572,0.4542747766907699,0.3032752020416844
672,Columbia,2078,28,559,1003,2050,2078,1.0,0.013474494706448507,0.9865255052935515,516,0.26900866217516844,0.48267564966313764,0.24831568816169394
673,Columbia,1100,19,99,720,1081,1100,1.0,0.017272727272727273,0.9827272727272728,281,0.09,0.6545454545454545,0.25545454545454543
674,Columbia,1601,46,277,947,1555,1601,1.0,0.02873204247345409,0.9712679575265459,377,0.17301686445971268,0.5915053091817614,0.23547782635852593
675,Columbia,1866,74,471,737,1792,1866,1.0,0.03965702036441586,0.9603429796355841,658,0.25241157556270094,0.394962486602358,0.35262593783494106
676,Columbia,1841,48,478,937,1793,1841,1.0,0.026072786529060293,0.9739272134709397,426,0.25964149918522544,0.5089625203693645,0.2313959804454101
677,Columbia,2465,42,378,1007,2423,2465,1.0,0.017038539553752535,0.9829614604462474,1080,0.15334685598377282,0.40851926977687625,0.4381338742393509
678,Columbia,2097,35,654,1012,2062,2097,1.0,0.016690510252742013,0.983309489747258,431,0.31187410586552217,0.4825941821649976,0.2055317119694802
679,Columbia,3262,76,1171,1526,3186,3262,1.0,0.023298589822194973,0.976701410177805,565,0.35898221949724096,0.4678111587982833,0.1732066217044758
680,Columbia,3407,56,793,1871,3351,3407,1.0,0.016436747872028177,0.9835632521279718,743,0.23275609040211329,0.5491634869386557,0.218080422659231
681,Columbia,3546,113,1051,607,3433,3546,1.0,0.03186689227298364,0.9681331077270163,1888,0.29639029892837,0.17117879300620417,0.5324309080654258
682,Columbia,4298,104,1423,1021,4194,4298,1.0,0.02419730107026524,0.9758026989297348,1854,0.33108422522103303,0.23755234993020008,0.4313634248487669
683,Columbia,4458,123,1159,2855,4335,4458,1.0,0.02759084791386272,0.9724091520861373,444,0.2599820547330641,0.6404217137729924,0.09959623149394348
684,Columbia,1198,35,238,808,1163,1198,1.0,0.02921535893155259,0.9707846410684474,152,0.1986644407345576,0.674457429048414,0.12687813021702837
685,Columbia,2778,109,295,1782,2669,2778,1.0,0.03923686105111591,0.9607631389488841,701,0.10619150467962563,0.6414686825053996,0.2523398128149748
686,Columbia,1936,51,512,825,1885,1936,1.0,0.02634297520661157,0.9736570247933884,599,0.2644628099173554,0.42613636363636365,0.309400826446281
687,Columbia,3877,55,1116,1721,3822,3877,1.0,0.014186226463760639,0.9858137735362393,1040,0.2878514315192159,0.4438999226205829,0.2682486458602012
688,Columbia,3952,113,1149,1064,3839,3952,1.0,0.028593117408906882,0.9714068825910931,1739,0.2907388663967611,0.2692307692307692,0.4400303643724696
689,Columbia,2133,57,528,767,2076,2133,1.0,0.026722925457102673,0.9732770745428974,838,0.24753867791842477,0.3595874355368026,0.3928738865447726
690,Columbia,2165,50,532,832,2115,2165,1.0,0.023094688221709007,0.976905311778291,801,0.24572748267898384,0.3842956120092379,0.3699769053117783
691,Columbia,1503,38,321,507,1465,1503,1.0,0.025282767797737856,0.9747172322022621,675,0.21357285429141717,0.3373253493013972,0.4491017964071856
692,Columbia,4818,118,1692,1433,4700,4818,1.0,0.024491490244914902,0.9755085097550851,1693,0.35118306351183065,0.29742631797426317,0.3513906185139062
693,Columbia,4268,100,1148,1834,4168,4268,1.0,0.023430178069353328,0.9765698219306467,1286,0.2689784442361762,0.42970946579194,0.3013120899718838
694,Columbia,2979,56,739,935,2923,2979,1.0,0.018798254447801276,0.9812017455521987,1305,0.24806982208794898,0.3138637126552534,0.4380664652567976
695,Columbia,4715,79,1269,2324,4636,4715,1.0,0.016755037115588546,0.9832449628844114,1122,0.2691410392364793,0.49289501590668083,0.23796394485683986
696,Columbia,1220,17,378,683,1203,1220,1.0,0.013934426229508197,0.9860655737704918,159,0.30983606557377047,0.5598360655737705,0.130327868852459
697,Columbia,701,14,284,268,687,701,1.0,0.019971469329529243,0.9800285306704708,149,0.4051355206847361,0.38231098430813126,0.21255349500713266
698,Columbia,2617,24,736,1543,2593,2617,1.0,0.009170806266717615,0.9908291937332824,338,0.2812380588460069,0.5896064195643868,0.12915552158960641
699,Columbia,1611,20,380,998,1591,1611,1.0,0.012414649286157667,0.9875853507138423,233,0.23587833643699566,0.6194909993792675,0.1446306641837368
700,Columbia,2057,49,573,1483,2008,2057,1.7161936560934892,0.023821098687408847,0.9761789013125911,1,0.27856101118133203,0.7209528439474964,0.0004861448711716091
701,Columbia,3552,94,1163,782,3458,3552,1.0,0.026463963963963964,0.973536036036036,1607,0.32742117117117114,0.22015765765765766,0.45242117117117114
702,Columbia,2519,36,578,1304,2483,2519,1.0,0.014291385470424772,0.9857086145295753,637,0.2294561333862644,0.5176657403731639,0.25287812624057165
703,Columbia,2568,47,570,1232,2521,2568,1.0,0.018302180685358254,0.9816978193146417,766,0.2219626168224299,0.4797507788161994,0.2982866043613707
704,Columbia,1478,62,346,855,1416,1478,1.0,0.04194857916102842,0.9580514208389715,277,0.23410013531799728,0.5784844384303113,0.18741542625169147
705,Columbia,1311,34,275,726,1277,1311,1.0,0.02593440122044241,0.9740655987795576,310,0.20976353928299007,0.5537757437070938,0.23646071700991608
706,Cook,2364,54,514,637,2310,2364,1.0,0.02284263959390863,0.9771573604060914,1213,0.21742808798646363,0.2694585448392555,0.5131133671742809
707,Cook,3065,59,404,1249,3006,3065,1.0,0.019249592169657423,0.9807504078303426,1412,0.13181076672104405,0.4075040783034258,0.4606851549755302
708,Cook,661,9,260,17,652,661,1.0,0.01361573373676248,0.9863842662632375,384,0.39334341906202724,0.025718608169440244,0.5809379727685325
709,Cook,1494,29,180,702,1465,1494,1.0,0.019410977242302542,0.9805890227576974,612,0.12048192771084337,0.46987951807228917,0.40963855421686746
710,Cook,1062,16,119,521,1046,1062,1.0,0.015065913370998116,0.9849340866290018,422,0.1120527306967985,0.4905838041431262,0.3973634651600753
711,Cook,1447,28,113,761,1419,1447,1.0,0.019350380096751902,0.9806496199032481,573,0.07809260539046303,0.5259156876295784,0.39599170697995856
712,Cook,1455,23,127,799,1432,1455,1.0,0.015807560137457044,0.9841924398625429,529,0.08728522336769759,0.5491408934707904,0.363573883161512
713,Cook,1390,12,342,214,1378,1390,1.0,0.008633093525179856,0.9913669064748202,834,0.2460431654676259,0.1539568345323741,0.6
714,Coweta,3700,85,689,2188,3615,3700,1.0,0.022972972972972974,0.977027027027027,823,0.18621621621621623,0.5913513513513513,0.22243243243243244
715,Coweta,5196,144,1025,3258,5052,5196,1.0,0.02771362586605081,0.9722863741339491,913,0.1972671285604311,0.6270207852193995,0.17571208622016937
716,Coweta,5861,105,1559,868,5756,5861,1.0,0.017915031564579423,0.9820849684354206,3434,0.2659955638969459,0.1480975942671899,0.5859068418358642
717,Coweta,1715,52,327,1038,1663,1715,1.0,0.030320699708454812,0.9696793002915451,350,0.19067055393586005,0.6052478134110787,0.20408163265306123
718,Coweta,962,33,119,513,929,962,1.0,0.034303534303534305,0.9656964656964657,330,0.12370062370062371,0.5332640332640333,0.34303534303534305
719,Coweta,2476,44,478,1028,2432,2476,1.0,0.017770597738287562,0.9822294022617124,970,0.19305331179321486,0.41518578352180935,0.39176090468497576
720,Coweta,4464,112,951,2423,4352,4464,1.0,0.025089605734767026,0.974910394265233,1090,0.21303763440860216,0.5427867383512545,0.24417562724014336
721,Coweta,2905,59,524,1219,2846,2905,1.0,0.020309810671256454,0.9796901893287435,1162,0.18037865748709123,0.4196213425129088,0.4
722,Coweta,3955,79,795,1227,3876,3955,1.0,0.019974715549936788,0.9800252844500632,1933,0.20101137800252844,0.3102402022756005,0.48874841972187105
723,Coweta,2348,64,322,1465,2284,2348,1.0,0.027257240204429302,0.9727427597955707,561,0.13713798977853492,0.6239352640545145,0.2389267461669506
724,Coweta,4518,83,1225,2282,4435,4518,1.0,0.018370960602036298,0.9816290393979638,1011,0.27113767153607793,0.5050907481186365,0.22377158034528552
725,Coweta,2823,63,420,1768,2760,2823,1.0,0.022316684378320937,0.9776833156216791,635,0.1487778958554729,0.6262840949344669,0.2249380092100602
726,Coweta,4087,90,1317,846,3997,4087,1.0,0.022021042329336923,0.9779789576706631,1924,0.32224125275263027,0.20699779789576706,0.4707609493516026
727,Coweta,23239,457,6428,8479,22782,23239,1.0,0.019665217952579715,0.9803347820474203,8332,0.2766039846809243,0.3648607943543182,0.35853522096475754
728,Coweta,2377,47,602,1119,2330,2377,1.0,0.019772822885990745,0.9802271771140093,656,0.2532604122843921,0.4707614640302903,0.2759781236853176
729,Coweta,3524,75,516,1644,3449,3524,1.0,0.021282633371169125,0.9787173666288309,1364,0.14642451759364358,0.46651532349602726,0.3870601589103292
730,Coweta,2342,53,263,1276,2289,2342,1.0,0.022630230572160546,0.9773697694278395,803,0.11229718189581554,0.5448334756618275,0.34286934244235695
731,Coweta,2685,75,394,1524,2610,2685,1.0,0.027932960893854747,0.9720670391061452,767,0.14674115456238362,0.5675977653631284,0.28566108007448787
732,Coweta,6144,109,1183,3423,6035,6144,1.0,0.017740885416666668,0.9822591145833334,1538,0.19254557291666666,0.55712890625,0.2503255208333333
733,Coweta,4470,109,713,2795,4361,4470,1.0,0.024384787472035794,0.9756152125279642,962,0.15950782997762863,0.6252796420581656,0.2152125279642058
734,Coweta,2774,89,769,949,2685,2774,1.0,0.03208363374188897,0.9679163662581111,1056,0.2772170151405912,0.34210526315789475,0.38067772170151404
735,Coweta,4897,100,904,2945,4797,4897,1.0,0.020420665713702265,0.9795793342862977,1048,0.18460281805186848,0.6013886052685318,0.21400857667959974
736,Coweta,4559,95,764,2807,4464,4559,1.0,0.020837903048914235,0.9791620969510858,988,0.1675806097828471,0.6157051985084449,0.21671419170870804
737,Coweta,3529,89,494,1849,3440,3529,1.0,0.02521960895437801,0.974780391045622,1186,0.13998299801643524,0.5239444601870218,0.33607254179654295
738,Coweta,981,22,343,189,959,981,1.0,0.022426095820591234,0.9775739041794088,449,0.34964322120285424,0.1926605504587156,0.45769622833843016
739,Coweta,4624,125,1086,2379,4499,4624,1.0,0.02703287197231834,0.9729671280276817,1159,0.23486159169550172,0.5144896193771626,0.25064878892733566
740,Crawford,645,35,138,190,610,645,1.0,0.05426356589147287,0.9457364341085271,317,0.21395348837209302,0.29457364341085274,0.49147286821705427
741,Crawford,1214,23,411,308,1191,1214,1.0,0.018945634266886325,0.9810543657331137,495,0.3385502471169687,0.25370675453047775,0.40774299835255357
742,Crawford,1788,39,535,691,1749,1788,1.0,0.02181208053691275,0.9781879194630873,562,0.2992170022371365,0.3864653243847875,0.3143176733780761
743,Crawford,1922,52,184,1043,1870,1922,1.0,0.027055150884495317,0.9729448491155047,695,0.09573361082206035,0.5426638917793964,0.36160249739854317
744,Crawford,2014,35,161,1125,1979,2014,1.0,0.01737835153922542,0.9826216484607746,728,0.07994041708043693,0.5585898709036743,0.3614697120158888
745,Crawford,2023,53,186,1071,1970,2023,1.0,0.02619871478002966,0.9738012852199703,766,0.09194265941670786,0.5294117647058824,0.37864557587740977
746,Crisp,1058,21,112,459,1037,1058,1.0,0.01984877126654064,0.9801512287334594,487,0.10586011342155009,0.43383742911153117,0.4603024574669187
747,Crisp,884,15,88,624,869,884,1.0,0.016968325791855202,0.9830316742081447,172,0.09954751131221719,0.7058823529411765,0.19457013574660634
748,Crisp,11251,95,2649,2488,11156,11251,1.0,0.0084436938938761,0.9915563061061239,6114,0.2354457381566083,0.22113589903119724,0.5434183628121945
749,Crisp,1325,11,108,832,1314,1325,1.0,0.00830188679245283,0.9916981132075472,385,0.08150943396226415,0.6279245283018868,0.29056603773584905
750,Crisp,1052,21,29,584,1031,1052,1.0,0.019961977186311788,0.9800380228136882,439,0.027566539923954372,0.5551330798479087,0.41730038022813687
751,Dade,2492,113,108,1216,2379,2492,1.0,0.04534510433386838,0.9546548956661316,1168,0.04333868378812199,0.48796147672552165,0.46869983948635635
752,Dade,810,38,60,414,772,810,1.0,0.04691358024691358,0.9530864197530864,336,0.07407407407407407,0.5111111111111111,0.4148148148148148
753,Dade,1247,40,198,729,1207,1247,1.0,0.03207698476343224,0.9679230152365678,320,0.15878107457898957,0.5846030473135525,0.2566158781074579
754,Dade,2220,118,283,946,2102,2220,1.0,0.05315315315315315,0.9468468468468468,991,0.12747747747747748,0.4261261261261261,0.4463963963963964
755,Dade,1062,24,121,533,1038,1062,1.0,0.022598870056497175,0.9774011299435028,408,0.11393596986817325,0.5018832391713748,0.384180790960452
756,Dade,3250,103,300,1599,3147,3250,1.0,0.03169230769230769,0.9683076923076923,1351,0.09230769230769231,0.492,0.4156923076923077
757,Dade,1906,37,191,629,1869,1906,1.0,0.019412381951731374,0.9805876180482687,1086,0.10020986358866736,0.3300104931794334,0.5697796432318992
758,Dawson,9963,317,849,6203,9646,9963,1.0,0.03181772558466325,0.9681822744153368,2911,0.08521529659741042,0.6226036334437418,0.29218106995884774
759,Dawson,9312,244,1133,5561,9068,9312,1.0,0.02620274914089347,0.9737972508591065,2618,0.12167096219931271,0.5971864261168385,0.2811426116838488
760,Dawson,2166,37,504,1634,2129,2166,1.0,0.017082179132040628,0.9829178208679594,28,0.23268698060941828,0.7543859649122807,0.012927054478301015
761,Decatur,2133,33,795,462,2100,2133,1.0,0.015471167369901548,0.9845288326300985,876,0.3727144866385373,0.21659634317862167,0.41068917018284107
762,Decatur,7742,103,1601,2345,7639,7742,1.0,0.013304055799535005,0.986695944200465,3796,0.20679411004908294,0.30289330922242313,0.49031258072849393
763,Decatur,4394,42,1099,1009,4352,4394,1.0,0.009558488848429678,0.9904415111515703,2286,0.2501137915339099,0.229631315430132,0.5202548930359582
764,Decatur,1500,20,122,492,1480,1500,1.0,0.013333333333333334,0.9866666666666667,886,0.08133333333333333,0.328,0.5906666666666667
765,Decatur,1228,18,200,558,1210,1228,1.0,0.014657980456026058,0.9853420195439739,470,0.16286644951140064,0.4543973941368078,0.38273615635179153
766,Decatur,769,7,98,315,762,769,1.0,0.009102730819245773,0.9908972691807543,356,0.12743823146944083,0.4096228868660598,0.46293888166449937
767,Decatur,628,22,55,392,606,628,1.0,0.03503184713375796,0.964968152866242,181,0.0875796178343949,0.6242038216560509,0.28821656050955413
768,Decatur,938,21,115,388,917,938,1.0,0.022388059701492536,0.9776119402985075,435,0.12260127931769722,0.4136460554371002,0.46375266524520253
769,Decatur,3111,33,695,797,3078,3111,1.0,0.010607521697203472,0.9893924783027965,1619,0.22340083574413372,0.25618772099003534,0.5204114432658309
770,DeKalb,2844,31,1718,201,2813,2844,1.0,0.01090014064697609,0.9890998593530239,925,0.6040787623066104,0.07067510548523206,0.3252461322081575
771,DeKalb,2827,22,1469,987,2805,2827,1.0,0.007782101167315175,0.9922178988326849,371,0.5196321188539087,0.3491333569154581,0.13123452423063317
772,DeKalb,2371,33,1075,890,2338,2371,1.0,0.013918177983973008,0.986081822016027,406,0.453395191902151,0.37536904259805987,0.1712357654997891
773,DeKalb,4041,61,1715,1048,3980,4041,1.0,0.015095273447166543,0.9849047265528335,1278,0.42439990101460034,0.2593417470923039,0.31625835189309576
774,DeKalb,2358,20,1077,1104,2338,2358,1.0,0.008481764206955046,0.991518235793045,177,0.45674300254452926,0.4681933842239186,0.07506361323155217
775,DeKalb,2335,44,1280,97,2291,2335,1.0,0.018843683083511777,0.9811563169164882,958,0.5481798715203426,0.041541755888650965,0.4102783725910064
776,DeKalb,2799,35,1970,538,2764,2799,1.0,0.012504465880671669,0.9874955341193283,291,0.7038227938549482,0.1922115041086102,0.10396570203644159
777,DeKalb,3314,50,2197,278,3264,3314,1.0,0.015087507543753771,0.9849124924562462,839,0.6629450814725407,0.08388654194327097,0.2531683765841883
778,DeKalb,4593,71,2698,138,4522,4593,1.0,0.01545830611800566,0.9845416938819943,1757,0.5874156324842151,0.030045721750489876,0.382538645765295
779,DeKalb,2009,17,1289,57,1992,2009,1.0,0.008461921353907416,0.9915380786460926,663,0.6416127426580388,0.028372324539571926,0.33001493280238925
780,DeKalb,4273,63,3341,256,4210,4273,1.0,0.014743739761291832,0.9852562602387082,676,0.7818862625789843,0.05991106950620173,0.15820266791481394
781,DeKalb,3522,61,1784,447,3461,3522,1.0,0.017319704713231118,0.9826802952867689,1291,0.5065303804656445,0.12691652470187392,0.36655309483248155
782,DeKalb,3380,64,1573,745,3316,3380,1.0,0.01893491124260355,0.9810650887573964,1062,0.4653846153846154,0.22041420118343194,0.31420118343195264
783,DeKalb,1752,17,994,476,1735,1752,1.0,0.009703196347031963,0.990296803652968,282,0.567351598173516,0.271689497716895,0.16095890410958905
784,DeKalb,4300,161,1160,615,4139,4300,1.0,0.03744186046511628,0.9625581395348837,2525,0.26976744186046514,0.14302325581395348,0.5872093023255814
785,DeKalb,3035,73,1361,565,2962,3035,1.0,0.024052718286655683,0.9759472817133443,1109,0.4484349258649094,0.18616144975288304,0.3654036243822076
786,DeKalb,3404,62,1387,549,3342,3404,1.0,0.018213866039952998,0.981786133960047,1468,0.4074618096357227,0.16128084606345475,0.4312573443008226
787,DeKalb,4390,56,1631,1112,4334,4390,1.0,0.01275626423690205,0.987243735763098,1647,0.3715261958997722,0.2533029612756264,0.3751708428246014
788,DeKalb,3684,54,2660,107,3630,3684,1.0,0.014657980456026058,0.9853420195439739,917,0.7220412595005429,0.029044516829533115,0.248914223669924
789,DeKalb,3002,47,2432,180,2955,3002,1.0,0.0156562291805463,0.9843437708194537,390,0.810126582278481,0.05996002664890073,0.12991339107261826
790,DeKalb,1848,29,1191,64,1819,1848,1.0,0.015692640692640692,0.9843073593073594,593,0.6444805194805194,0.03463203463203463,0.3208874458874459
791,DeKalb,3306,53,1845,136,3253,3306,1.0,0.01603145795523291,0.9839685420447671,1325,0.558076225045372,0.0411373260738052,0.40078644888082277
792,DeKalb,3848,48,2320,181,3800,3848,1.0,0.012474012474012475,0.9875259875259875,1347,0.6029106029106029,0.04703742203742204,0.35005197505197505
793,DeKalb,4036,52,2532,96,3984,4036,1.0,0.01288404360753221,0.9871159563924677,1408,0.6273538156590683,0.023785926660059464,0.34886025768087214
794,DeKalb,1898,36,884,51,1862,1898,1.0,0.018967334035827187,0.9810326659641728,963,0.4657534246575342,0.026870389884088516,0.5073761854583773
795,DeKalb,3790,33,2586,105,3757,3790,1.0,0.008707124010554089,0.9912928759894459,1099,0.6823218997361478,0.027704485488126648,0.2899736147757256
796,DeKalb,5520,301,1124,495,5219,5520,1.0,0.05452898550724638,0.9454710144927536,3901,0.2036231884057971,0.08967391304347826,0.7067028985507247
797,DeKalb,3476,66,1652,831,3410,3476,1.0,0.0189873417721519,0.9810126582278481,993,0.475258918296893,0.23906789413118526,0.2856731875719217
798,DeKalb,3113,38,2161,79,3075,3113,1.0,0.012206874397687119,0.9877931256023129,873,0.6941856729842596,0.025377449405717956,0.2804368776100225
799,DeKalb,2911,26,1262,420,2885,2911,1.0,0.008931638612160769,0.9910683613878393,1229,0.4335279972518035,0.14428031604259706,0.4221916867055994
800,DeKalb,3228,42,2370,332,3186,3228,1.0,0.013011152416356878,0.9869888475836431,526,0.7342007434944238,0.10285006195786865,0.16294919454770757
801,DeKalb,3178,50,2404,363,3128,3178,1.0,0.015733165512901194,0.9842668344870988,411,0.7564505978602895,0.11422278162366269,0.12932662051604782
802,DeKalb,4062,37,1918,455,4025,4062,1.0,0.009108813392417528,0.9908911866075825,1689,0.47218119153126537,0.1120137863121615,0.4158050221565731
803,DeKalb,9770,116,2952,408,9654,9770,1.0,0.01187308085977482,0.9881269191402252,6410,0.3021494370522006,0.041760491299897645,0.6560900716479018
804,DeKalb,1815,12,1000,48,1803,1815,1.0,0.006611570247933884,0.9933884297520661,767,0.5509641873278237,0.026446280991735537,0.4225895316804408
805,DeKalb,4123,37,2680,236,4086,4123,1.0,0.008974048023284017,0.991025951976716,1207,0.6500121270919234,0.057239873878243995,0.2927479990298327
806,DeKalb,2514,26,1280,61,2488,2514,1.0,0.010342084327764518,0.9896579156722355,1173,0.5091487669053302,0.02426412092283214,0.4665871121718377
807,DeKalb,1572,15,730,28,1557,1572,1.0,0.009541984732824428,0.9904580152671756,814,0.4643765903307888,0.017811704834605598,0.5178117048346056
808,DeKalb,1997,30,1102,57,1967,1997,1.0,0.015022533800701052,0.9849774661992989,838,0.5518277416124187,0.028542814221331998,0.41962944416624937
809,DeKalb,3043,38,1961,699,3005,3043,1.0,0.01248767663489977,0.9875123233651002,383,0.6444298389746961,0.22970752546828788,0.1258626355570161
810,DeKalb,2284,44,1157,143,2240,2284,1.0,0.01926444833625219,0.9807355516637478,984,0.5065674255691769,0.06260945709281962,0.4308231173380035
811,DeKalb,583,14,220,12,569,583,1.0,0.024013722126929673,0.9759862778730704,351,0.37735849056603776,0.02058319039451115,0.6020583190394511
812,DeKalb,3764,112,1107,479,3652,3764,1.0,0.02975557917109458,0.9702444208289054,2178,0.29410201912858663,0.12725823591923485,0.5786397449521785
813,DeKalb,2674,50,1738,91,2624,2674,1.0,0.018698578908002993,0.981301421091997,845,0.649962602842184,0.034031413612565446,0.31600598354525056
814,DeKalb,5819,328,1398,473,5491,5819,1.0,0.056367073380305895,0.9436329266196941,3948,0.24024746520020623,0.08128544423440454,0.6784670905653892
815,DeKalb,2004,101,589,240,1903,2004,1.0,0.05039920159680639,0.9496007984031936,1175,0.2939121756487026,0.11976047904191617,0.5863273453093812
816,DeKalb,9950,310,2466,866,9640,9950,1.0,0.031155778894472363,0.9688442211055276,6618,0.2478391959798995,0.08703517587939698,0.6651256281407035
817,DeKalb,4658,21,1431,285,4637,4658,1.0,0.004508372692142551,0.9954916273078575,2942,0.30721339630742805,0.061185057964791754,0.6316015457277802
818,DeKalb,2314,42,1215,178,2272,2314,1.0,0.018150388936905792,0.9818496110630942,921,0.5250648228176318,0.07692307692307693,0.3980121002592913
819,DeKalb,5644,46,1497,705,5598,5644,1.0,0.00815024805102764,0.9918497519489724,3442,0.2652374202693125,0.12491141034727143,0.609851169383416
820,DeKalb,2004,30,936,794,1974,2004,1.0,0.014970059880239521,0.9850299401197605,274,0.46706586826347307,0.3962075848303393,0.13672654690618763
821,DeKalb,2407,24,1129,1071,2383,2407,1.0,0.009970918155380142,0.9900290818446199,207,0.46904860822600747,0.4449522226838388,0.08599916909015372
822,DeKalb,3632,50,2679,260,3582,3632,1.0,0.013766519823788546,0.9862334801762115,693,0.7376101321585903,0.07158590308370044,0.19080396475770925
823,DeKalb,2527,133,917,434,2394,2527,1.0,0.05263157894736842,0.9473684210526315,1176,0.3628808864265928,0.17174515235457063,0.46537396121883656
824,DeKalb,4157,29,1206,148,4128,4157,1.0,0.006976184748616791,0.9930238152513832,2803,0.29011306230454653,0.035602598027423625,0.6742843396680298
825,DeKalb,3928,34,2031,436,3894,3928,1.0,0.008655804480651732,0.9913441955193483,1461,0.5170570264765784,0.1109979633401222,0.3719450101832994
826,DeKalb,3763,51,3123,300,3712,3763,1.0,0.01355301621047037,0.9864469837895297,340,0.8299229338293914,0.07972362476747276,0.0903534414031358
827,DeKalb,4175,81,1723,759,4094,4175,1.0,0.019401197604790418,0.9805988023952096,1693,0.4126946107784431,0.18179640718562876,0.40550898203592817
828,DeKalb,5513,68,2692,103,5445,5513,1.0,0.01233448213313985,0.9876655178668602,2718,0.48830038091783057,0.018683112642844186,0.4930165064393252
829,DeKalb,2001,17,1523,340,1984,2001,1.0,0.00849575212393803,0.991504247876062,138,0.7611194402798601,0.16991504247876063,0.06896551724137931
830,DeKalb,2062,27,1292,71,2035,2062,1.0,0.013094083414161009,0.986905916585839,699,0.6265761396702231,0.03443258971871969,0.3389912706110572
831,DeKalb,3048,26,2098,95,3022,3048,1.0,0.00853018372703412,0.9914698162729659,855,0.6883202099737533,0.031167979002624673,0.28051181102362205
832,DeKalb,2418,16,1300,56,2402,2418,1.0,0.006617038875103391,0.9933829611248967,1062,0.5376344086021505,0.02315963606286187,0.4392059553349876
833,DeKalb,2542,12,1276,45,2530,2542,1.0,0.004720692368214005,0.995279307631786,1221,0.5019669551534225,0.01770259638080252,0.480330448465775
834,DeKalb,2719,27,1391,55,2692,2719,1.0,0.009930121368150056,0.9900698786318499,1273,0.5115851415961751,0.02022802500919456,0.46818683339463035
835,DeKalb,3368,46,2283,77,3322,3368,1.0,0.013657957244655582,0.9863420427553444,1008,0.6778503562945368,0.022862232779097387,0.2992874109263658
836,DeKalb,3110,61,1683,193,3049,3110,1.0,0.019614147909967846,0.9803858520900322,1234,0.5411575562700964,0.06205787781350482,0.3967845659163987
837,DeKalb,5104,55,1939,893,5049,5104,1.0,0.010775862068965518,0.9892241379310345,2272,0.37989811912225707,0.17496081504702193,0.445141065830721
838,DeKalb,1885,36,999,123,1849,1885,1.0,0.01909814323607427,0.9809018567639257,763,0.529973474801061,0.06525198938992043,0.40477453580901857
839,DeKalb,2598,43,1764,227,2555,2598,1.0,0.016551193225558123,0.9834488067744419,607,0.6789838337182448,0.0873749037721324,0.23364126250962278
840,DeKalb,2179,20,1122,101,2159,2179,1.0,0.009178522257916476,0.9908214777420835,956,0.5149150986691142,0.0463515374024782,0.4387333639284075
841,DeKalb,3465,45,2181,115,3420,3465,1.0,0.012987012987012988,0.987012987012987,1169,0.6294372294372295,0.03318903318903319,0.3373737373737374
842,DeKalb,4431,56,1947,374,4375,4431,1.0,0.01263823064770932,0.9873617693522907,2110,0.43940419769803657,0.08440532611148725,0.47619047619047616
843,DeKalb,2338,43,896,168,2295,2338,1.0,0.018391787852865698,0.9816082121471343,1274,0.38323353293413176,0.0718562874251497,0.5449101796407185
844,DeKalb,3833,62,2537,91,3771,3833,1.0,0.016175319593008088,0.9838246804069919,1205,0.661883642055831,0.02374119488651187,0.31437516305765717
845,DeKalb,5580,93,2034,624,5487,5580,1.0,0.016666666666666666,0.9833333333333333,2922,0.36451612903225805,0.11182795698924732,0.5236559139784946
846,DeKalb,3602,39,1671,687,3563,3602,1.0,0.010827318156579679,0.9891726818434203,1244,0.4639089394780677,0.19072737368128817,0.3453636868406441
847,DeKalb,1701,30,910,516,1671,1701,1.0,0.01763668430335097,0.982363315696649,275,0.5349794238683128,0.30335097001763667,0.16166960611405057
848,DeKalb,4350,103,1819,595,4247,4350,1.0,0.02367816091954023,0.9763218390804598,1936,0.4181609195402299,0.1367816091954023,0.44505747126436784
849,DeKalb,2889,38,1307,332,2851,2889,1.0,0.013153340256143994,0.986846659743856,1250,0.45240567670474213,0.11491865697473175,0.4326756663205261
850,DeKalb,4436,38,1005,215,4398,4436,1.0,0.008566275924256087,0.9914337240757439,3216,0.22655545536519386,0.048467087466185756,0.7249774571686204
851,DeKalb,1392,15,1122,269,1377,1392,1.1505376344086022,0.010775862068965518,0.9892241379310345,1,0.8060344827586207,0.1932471264367816,0.0007183908045977011
852,DeKalb,4710,49,1753,427,4661,4710,1.0,0.010403397027600849,0.9895966029723992,2530,0.3721868365180467,0.09065817409766454,0.5371549893842887
853,DeKalb,1161,19,897,41,1142,1161,1.0,0.01636520241171404,0.983634797588286,223,0.772609819121447,0.03531438415159346,0.1920757967269595
854,DeKalb,2684,27,1627,78,2657,2684,1.0,0.010059612518628911,0.9899403874813711,979,0.6061847988077497,0.029061102831594635,0.36475409836065575
855,DeKalb,4688,39,3499,116,4649,4688,1.0,0.008319112627986349,0.9916808873720137,1073,0.7463737201365188,0.024744027303754267,0.22888225255972697
856,DeKalb,2363,23,1043,1067,2340,2363,1.0,0.00973338975878121,0.9902666102412188,253,0.44138806601777403,0.45154464663563265,0.1070672873465933
857,DeKalb,2036,14,1079,734,2022,2036,1.0,0.0068762278978389,0.9931237721021611,223,0.5299607072691552,0.3605108055009823,0.10952848722986247
858,DeKalb,2210,37,1387,105,2173,2210,1.0,0.0167420814479638,0.9832579185520361,718,0.6276018099547511,0.04751131221719457,0.3248868778280543
859,DeKalb,2718,40,1765,819,2678,2718,1.0,0.014716703458425313,0.9852832965415746,134,0.6493745401030169,0.30132450331125826,0.049300956585724795
860,DeKalb,4089,73,1626,514,4016,4089,1.0,0.01785277573978968,0.9821472242602103,1949,0.3976522377109318,0.12570310589386158,0.47664465639520665
861,DeKalb,2731,38,1275,432,2693,2731,1.0,0.013914317099963384,0.9860856829000366,1024,0.4668619553277188,0.1581838154522153,0.3749542292200659
862,DeKalb,2974,35,2100,310,2939,2974,1.0,0.011768661735036988,0.988231338264963,564,0.7061197041022192,0.10423671822461332,0.18964357767316745
863,DeKalb,1887,13,828,74,1874,1887,1.0,0.00688924218335983,0.9931107578166402,985,0.43879173290937995,0.0392156862745098,0.5219925808161102
864,DeKalb,3463,11,1955,80,3452,3463,1.0,0.0031764366156511693,0.9968235633843489,1428,0.5645394166907306,0.02310135720473578,0.4123592261045336
865,DeKalb,1392,26,719,391,1366,1392,1.0,0.01867816091954023,0.9813218390804598,282,0.5165229885057471,0.28089080459770116,0.2025862068965517
866,DeKalb,4126,67,2377,81,4059,4126,1.0,0.016238487639360154,0.9837615123606398,1668,0.5761027629665536,0.019631604459524964,0.40426563257392145
867,DeKalb,2474,20,1852,90,2454,2474,1.0,0.008084074373484237,0.9919159256265158,532,0.7485852869846402,0.03637833468067906,0.21503637833468067
868,DeKalb,4618,77,2025,423,4541,4618,1.0,0.01667388479861412,0.9833261152013859,2170,0.43850151580770896,0.09159809441316587,0.4699003897791252
869,DeKalb,2512,33,1623,80,2479,2512,1.0,0.013136942675159236,0.9868630573248408,809,0.6460987261146497,0.03184713375796178,0.32205414012738853
870,DeKalb,1667,28,1213,53,1639,1667,1.0,0.016796640671865627,0.9832033593281344,401,0.7276544691061788,0.03179364127174565,0.24055188962207558
871,DeKalb,4086,76,2667,163,4010,4086,1.0,0.01860009789525208,0.9813999021047479,1256,0.6527165932452276,0.0398923152227117,0.3073910915320607
872,DeKalb,2859,28,1673,63,2831,2859,1.0,0.009793634137810424,0.9902063658621896,1123,0.5851696397341728,0.022035676810073453,0.39279468345575375
873,DeKalb,3808,50,1959,102,3758,3808,1.0,0.013130252100840336,0.9868697478991597,1747,0.5144432773109243,0.026785714285714284,0.4587710084033613
874,DeKalb,2155,38,1471,308,2117,2155,1.0,0.017633410672853827,0.9823665893271462,376,0.6825986078886311,0.14292343387471,0.17447795823665893
875,DeKalb,3298,42,1346,150,3256,3298,1.0,0.012734990903577926,0.9872650090964221,1802,0.40812613705275924,0.04548211036992116,0.5463917525773195
876,DeKalb,3199,22,2304,161,3177,3199,1.0,0.006877149109096593,0.9931228508909034,734,0.7202250703344796,0.05032822757111598,0.22944670209440451
877,DeKalb,2565,36,1333,963,2529,2565,1.0,0.014035087719298246,0.9859649122807017,269,0.5196881091617934,0.37543859649122807,0.10487329434697856
878,DeKalb,2049,22,1060,210,2027,2049,1.0,0.010736944851146901,0.9892630551488532,779,0.5173255246461689,0.10248901903367497,0.38018545632015616
879,DeKalb,2746,47,1553,133,2699,2746,1.0,0.01711580480699199,0.982884195193008,1060,0.5655498907501821,0.0484340859431901,0.3860160233066278
880,DeKalb,4757,64,2424,96,4693,4757,1.0,0.013453857473197394,0.9865461425268026,2237,0.5095648517973512,0.02018078620979609,0.47025436199285264
881,DeKalb,3776,30,1700,70,3746,3776,1.0,0.007944915254237288,0.9920550847457628,2006,0.4502118644067797,0.018538135593220338,0.53125
882,DeKalb,2029,24,1404,75,2005,2029,1.0,0.011828486939379004,0.988171513060621,550,0.6919664859536717,0.03696402168555939,0.2710694923607688
883,DeKalb,3244,55,1928,143,3189,3244,1.0,0.016954377311960544,0.9830456226880394,1173,0.594327990135635,0.04408138101109741,0.3615906288532676
884,DeKalb,4179,146,1067,168,4033,4179,1.0,0.03493658770040679,0.9650634122995932,2944,0.25532424024886335,0.04020100502512563,0.704474754726011
885,DeKalb,2339,41,1256,783,2298,2339,1.0,0.017528858486532708,0.9824711415134673,300,0.5369816160752459,0.3347584437793929,0.12825994014536127
886,DeKalb,3155,43,1459,375,3112,3155,1.0,0.013629160063391443,0.9863708399366086,1321,0.4624405705229794,0.11885895404120443,0.4187004754358162
887,DeKalb,2491,48,1124,1108,2443,2491,1.0,0.019269369731031716,0.9807306302689683,259,0.45122440786832596,0.44480128462464874,0.10397430750702528
888,DeKalb,3044,37,1084,802,3007,3044,1.0,0.012155059132720105,0.9878449408672799,1158,0.35611038107752957,0.26346911957950064,0.3804204993429698
889,DeKalb,3590,69,1245,191,3521,3590,1.0,0.019220055710306407,0.9807799442896936,2154,0.3467966573816156,0.0532033426183844,0.6
890,DeKalb,2476,28,1242,158,2448,2476,1.0,0.011308562197092083,0.9886914378029079,1076,0.5016155088852988,0.06381260096930533,0.4345718901453958
891,DeKalb,3684,168,851,345,3516,3684,1.0,0.04560260586319218,0.9543973941368078,2488,0.23099891422366992,0.09364820846905537,0.6753528773072747
892,DeKalb,1479,24,909,323,1455,1479,1.0,0.016227180527383367,0.9837728194726166,247,0.6146044624746451,0.21839080459770116,0.16700473292765383
893,DeKalb,2313,28,1341,525,2285,2313,1.0,0.012105490704712495,0.9878945092952875,447,0.5797665369649806,0.22697795071335927,0.1932555123216602
894,DeKalb,4666,37,2849,88,4629,4666,1.0,0.007929704243463351,0.9920702957565366,1729,0.6105872267466781,0.018859837119588514,0.3705529361337334
895,DeKalb,4042,193,913,377,3849,4042,1.0,0.047748639287481444,0.9522513607125186,2752,0.22587827808015834,0.09327065809005443,0.6808510638297872
896,DeKalb,4183,71,3384,271,4112,4183,1.0,0.016973464021037533,0.9830265359789625,528,0.8089887640449438,0.06478603872818552,0.12622519722687067
897,DeKalb,1535,24,928,62,1511,1535,1.0,0.015635179153094463,0.9843648208469056,545,0.6045602605863192,0.040390879478827364,0.3550488599348534
898,DeKalb,2987,20,1791,52,2967,2987,1.0,0.006695681285570807,0.9933043187144291,1144,0.5995982591228658,0.017408771342484097,0.3829929695346502
899,DeKalb,2276,36,1114,51,2240,2276,1.0,0.015817223198594025,0.984182776801406,1111,0.48945518453427067,0.02240773286467487,0.4881370826010545
900,DeKalb,2253,31,1218,121,2222,2253,1.0,0.013759431868619618,0.9862405681313804,914,0.5406125166444741,0.05370616955170883,0.4056813138038171
901,DeKalb,4273,46,1803,653,4227,4273,1.0,0.010765270301895623,0.9892347296981043,1817,0.42195179031125674,0.15282003276386613,0.42522817692487713
902,DeKalb,641,15,425,49,626,641,1.0,0.0234009360374415,0.9765990639625585,167,0.6630265210608425,0.07644305772230889,0.26053042121684866
903,DeKalb,2412,35,1042,62,2377,2412,1.0,0.01451077943615257,0.9854892205638475,1308,0.4320066334991708,0.02570480928689884,0.5422885572139303
904,DeKalb,7029,271,2068,394,6758,7029,1.0,0.038554559681320245,0.9614454403186797,4567,0.2942097026604069,0.05605349267321098,0.6497368046663822
905,DeKalb,2917,55,2640,276,2862,2917,1.1142529614061902,0.01885498800137127,0.9811450119986287,1,0.905039424065821,0.09461775797051765,0.00034281796366129587
906,DeKalb,2340,33,1469,73,2307,2340,1.0,0.014102564102564103,0.985897435897436,798,0.6277777777777778,0.031196581196581197,0.34102564102564104
907,DeKalb,3609,56,2302,118,3553,3609,1.0,0.015516763646439457,0.9844832363535605,1189,0.6378498198947077,0.03269603768356886,0.3294541424217235
908,DeKalb,2744,36,1942,83,2708,2744,1.0,0.013119533527696793,0.9868804664723032,719,0.7077259475218659,0.030247813411078718,0.2620262390670554
909,DeKalb,2394,25,1535,86,2369,2394,1.0,0.010442773600668337,0.9895572263993316,773,0.641186299081036,0.03592314118629908,0.322890559732665
910,DeKalb,2647,36,1620,93,2611,2647,1.0,0.01360030222893842,0.9863996977710616,934,0.612013600302229,0.03513411409142425,0.3528522856063468
911,DeKalb,3715,44,2296,89,3671,3715,1.0,0.011843876177658143,0.9881561238223419,1330,0.6180349932705249,0.02395693135935397,0.35800807537012114
912,DeKalb,1808,21,1028,424,1787,1808,1.0,0.011615044247787611,0.9883849557522124,356,0.5685840707964602,0.2345132743362832,0.19690265486725664
913,DeKalb,2744,29,1819,92,2715,2744,1.0,0.010568513119533527,0.9894314868804664,833,0.6629008746355685,0.033527696793002916,0.30357142857142855
914,DeKalb,4135,63,2636,231,4072,4135,1.0,0.015235792019347038,0.984764207980653,1268,0.6374848851269649,0.055864570737605805,0.30665054413542925
915,DeKalb,4092,62,1754,166,4030,4092,1.0,0.015151515151515152,0.9848484848484849,2172,0.4286412512218964,0.04056695992179863,0.530791788856305
916,DeKalb,3846,55,2715,144,3791,3846,1.0,0.014300572022880915,0.9856994279771191,987,0.7059282371294852,0.0374414976599064,0.25663026521060844
917,DeKalb,5019,44,1780,138,4975,5019,1.0,0.008766686590954373,0.9912333134090456,3101,0.35465232117951784,0.02749551703526599,0.6178521617852162
918,DeKalb,2080,21,1182,112,2059,2080,1.0,0.010096153846153847,0.9899038461538462,786,0.5682692307692307,0.05384615384615385,0.3778846153846154
919,DeKalb,2660,25,1801,710,2635,2660,1.0,0.009398496240601503,0.9906015037593985,149,0.6770676691729324,0.2669172932330827,0.05601503759398496
920,DeKalb,3328,26,2436,95,3302,3328,1.0,0.0078125,0.9921875,797,0.7319711538461539,0.028545673076923076,0.23948317307692307
921,DeKalb,3372,51,1783,313,3321,3372,1.0,0.015124555160142349,0.9848754448398577,1276,0.5287663107947805,0.09282325029655991,0.37841043890865955
922,DeKalb,4383,46,2853,156,4337,4383,1.0,0.010495094684006388,0.9895049053159937,1374,0.6509240246406571,0.03559206023271732,0.3134839151266256
923,DeKalb,1749,30,1029,299,1719,1749,1.0,0.017152658662092625,0.9828473413379074,421,0.5883361921097771,0.17095483133218983,0.24070897655803317
924,DeKalb,3103,58,1647,171,3045,3103,1.0,0.018691588785046728,0.9813084112149533,1285,0.5307766677408959,0.05510796003867225,0.4141153722204318
925,DeKalb,5954,64,2173,1522,5890,5954,1.0,0.010749076251259657,0.9892509237487404,2259,0.36496472959355053,0.25562646960026875,0.3794088008061807
926,DeKalb,2838,117,990,650,2721,2838,1.0,0.0412262156448203,0.9587737843551797,1198,0.3488372093023256,0.22903453136011276,0.42212825933756165
927,DeKalb,2000,16,1058,672,1984,2000,1.0,0.008,0.992,270,0.529,0.336,0.135
928,DeKalb,1655,17,1269,63,1638,1655,1.0,0.01027190332326284,0.9897280966767371,323,0.7667673716012084,0.038066465256797584,0.19516616314199395
929,DeKalb,2422,37,1395,69,2385,2422,1.0,0.0152766308835673,0.9847233691164327,958,0.5759702725020645,0.028488852188274155,0.3955408753096614
930,DeKalb,1784,35,1300,62,1749,1784,1.0,0.01961883408071749,0.9803811659192825,422,0.7286995515695067,0.034753363228699555,0.2365470852017937
931,DeKalb,3243,36,2156,95,3207,3243,1.0,0.011100832562442183,0.9888991674375578,992,0.6648165279062597,0.02929386370644465,0.30588960838729573
932,DeKalb,3527,52,2064,106,3475,3527,1.0,0.014743407995463568,0.9852565920045364,1357,0.5851998865891692,0.03005387014459881,0.3847462432662319
933,DeKalb,3477,53,2219,159,3424,3477,1.0,0.015243025596778832,0.9847569744032212,1099,0.63819384526891,0.0457290767903365,0.3160770779407535
934,DeKalb,3528,50,2431,154,3478,3528,1.0,0.01417233560090703,0.985827664399093,943,0.6890589569160998,0.04365079365079365,0.2672902494331066
935,DeKalb,4272,74,1445,133,4198,4272,1.0,0.017322097378277154,0.9826779026217228,2694,0.33824906367041196,0.031132958801498127,0.6306179775280899
936,DeKalb,1904,34,801,183,1870,1904,1.0,0.017857142857142856,0.9821428571428571,920,0.4206932773109244,0.09611344537815127,0.4831932773109244
937,DeKalb,3135,53,1502,184,3082,3135,1.0,0.01690590111642743,0.9830940988835726,1449,0.4791068580542265,0.05869218500797448,0.46220095693779906
938,DeKalb,2332,44,1185,384,2288,2332,1.0,0.018867924528301886,0.9811320754716981,763,0.508147512864494,0.1646655231560892,0.3271869639794168
939,DeKalb,3506,76,1208,131,3430,3506,1.0,0.02167712492869367,0.9783228750713063,2167,0.34455219623502564,0.03736451796919567,0.6180832857957786
940,DeKalb,4634,46,2285,102,4588,4634,1.0,0.009926629261976695,0.9900733707380233,2247,0.49309451877427707,0.0220112214069918,0.48489425981873113
941,DeKalb,2803,19,904,71,2784,2803,1.0,0.0067784516589368534,0.9932215483410631,1828,0.3225115947199429,0.025330003567606136,0.652158401712451
942,DeKalb,2386,26,1777,96,2360,2386,1.0,0.010896898575020955,0.989103101424979,513,0.7447611064543168,0.040234702430846606,0.21500419111483654
943,DeKalb,1580,36,674,609,1544,1580,1.0,0.02278481012658228,0.9772151898734177,297,0.42658227848101266,0.38544303797468354,0.1879746835443038
944,DeKalb,1472,29,984,43,1443,1472,1.0,0.01970108695652174,0.9802989130434783,445,0.6684782608695652,0.029211956521739132,0.3023097826086957
945,DeKalb,3614,80,1521,609,3534,3614,1.0,0.02213613724405091,0.977863862755949,1484,0.420863309352518,0.16851134477033758,0.41062534587714444
946,DeKalb,3249,62,1750,987,3187,3249,1.0,0.019082794706063406,0.9809172052939366,512,0.538627269929209,0.30378578024007385,0.15758694983071714
947,DeKalb,1216,37,643,152,1179,1216,1.0,0.03042763157894737,0.9695723684210527,421,0.5287828947368421,0.125,0.3462171052631579
948,DeKalb,2795,21,1825,82,2774,2795,1.0,0.0075134168157423974,0.9924865831842576,888,0.6529516994633273,0.02933810375670841,0.3177101967799642
949,DeKalb,2255,98,665,248,2157,2255,1.0,0.043458980044345896,0.9565410199556541,1342,0.29490022172949004,0.10997782705099779,0.5951219512195122
950,DeKalb,2685,17,2029,73,2668,2685,1.0,0.00633147113594041,0.9936685288640595,583,0.7556797020484172,0.027188081936685288,0.21713221601489757
951,DeKalb,3132,53,1461,62,3079,3132,1.0,0.016922094508301407,0.9830779054916986,1609,0.4664750957854406,0.01979565772669221,0.5137292464878672
952,DeKalb,1891,48,1518,162,1843,1891,1.0,0.02538339502908514,0.9746166049709148,211,0.8027498677948176,0.08566895822316235,0.1115811739820201
953,DeKalb,1430,21,652,532,1409,1430,1.0,0.014685314685314685,0.9853146853146854,246,0.45594405594405596,0.37202797202797205,0.17202797202797201
954,DeKalb,3620,45,2113,140,3575,3620,1.0,0.012430939226519336,0.9875690607734806,1367,0.5837016574585635,0.03867403314917127,0.3776243093922652
955,DeKalb,3312,26,1805,124,3286,3312,1.0,0.00785024154589372,0.9921497584541062,1383,0.544987922705314,0.03743961352657005,0.41757246376811596
956,DeKalb,3979,63,1779,542,3916,3979,1.0,0.015833123900477506,0.9841668760995225,1658,0.4470972606182458,0.1362151294295049,0.4166876099522493
957,DeKalb,3303,41,2394,162,3262,3303,1.0,0.01241295791704511,0.9875870420829549,747,0.7247956403269755,0.04904632152588556,0.22615803814713897
958,DeKalb,1780,21,1289,57,1759,1780,1.0,0.011797752808988765,0.9882022471910112,434,0.7241573033707865,0.03202247191011236,0.24382022471910111
959,Dodge,473,2,58,248,471,473,1.0,0.004228329809725159,0.9957716701902748,167,0.1226215644820296,0.5243128964059197,0.35306553911205074
960,Dodge,130,0,3,70,130,130,1.0,0.0,1.0,57,0.023076923076923078,0.5384615384615384,0.43846153846153846
961,Dodge,1153,16,235,540,1137,1153,1.0,0.013876843018213356,0.9861231569817867,378,0.20381613183000868,0.4683434518647008,0.32784041630529054
962,Dodge,573,12,29,289,561,573,1.0,0.020942408376963352,0.9790575916230366,255,0.0506108202443281,0.5043630017452007,0.44502617801047123
963,Dodge,275,1,46,102,274,275,1.0,0.0036363636363636364,0.9963636363636363,127,0.16727272727272727,0.3709090909090909,0.4618181818181818
964,Dodge,555,4,45,275,551,555,1.0,0.007207207207207207,0.9927927927927928,235,0.08108108108108109,0.4954954954954955,0.42342342342342343
965,Dodge,6581,56,1194,1962,6525,6581,1.0,0.008509345084333687,0.9914906549156663,3425,0.18143139340525755,0.2981309831332624,0.52043762346148
966,Dodge,316,6,39,190,310,316,1.0,0.0189873417721519,0.9810126582278481,87,0.12341772151898735,0.6012658227848101,0.27531645569620256
967,Dodge,364,3,41,189,361,364,1.0,0.008241758241758242,0.9917582417582418,134,0.11263736263736264,0.5192307692307693,0.36813186813186816
968,Dodge,400,0,55,220,400,400,1.0,0.0,1.0,125,0.1375,0.55,0.3125
969,Dodge,1743,5,75,290,1738,1743,1.0,0.002868617326448652,0.9971313826735514,1378,0.043029259896729774,0.1663798049340218,0.7905909351692484
970,Dodge,533,3,38,299,530,533,1.0,0.005628517823639775,0.9943714821763602,196,0.07129455909943715,0.5609756097560976,0.3677298311444653
971,Dodge,760,5,116,398,755,760,1.0,0.006578947368421052,0.993421052631579,246,0.15263157894736842,0.5236842105263158,0.3236842105263158
972,Dodge,1341,17,163,480,1324,1341,1.0,0.01267710663683818,0.9873228933631618,698,0.1215510812826249,0.3579418344519016,0.5205070842654735
973,Dodge,144,3,10,133,141,144,1.0287769784172662,0.020833333333333332,0.9791666666666666,1,0.06944444444444445,0.9236111111111112,0.006944444444444444
974,Dodge,373,10,24,158,363,373,1.0,0.02680965147453083,0.9731903485254692,191,0.064343163538874,0.42359249329758714,0.5120643431635389
975,Dooly,809,5,215,230,804,809,1.0,0.006180469715698393,0.9938195302843016,364,0.2657601977750309,0.2843016069221261,0.449938195302843
976,Dooly,553,3,179,174,550,553,1.0,0.0054249547920434,0.9945750452079566,200,0.32368896925858953,0.31464737793851716,0.3616636528028933
977,Dooly,624,9,100,282,615,624,1.0,0.014423076923076924,0.9855769230769231,242,0.16025641025641027,0.4519230769230769,0.38782051282051283
978,Dooly,3589,20,532,547,3569,3589,1.0,0.005572582892170521,0.9944274171078294,2510,0.14823070493173585,0.15241014210086376,0.6993591529674004
979,Dooly,3612,49,885,926,3563,3612,1.0,0.013565891472868217,0.9864341085271318,1801,0.24501661129568106,0.2563676633444075,0.4986157253599114
980,Dougherty,2419,6,871,63,2413,2419,1.0,0.0024803637866887144,0.9975196362133113,1485,0.3600661430343117,0.026043819760231502,0.6138900372054568
981,Dougherty,730,7,494,16,723,730,1.0,0.009589041095890411,0.9904109589041096,220,0.6767123287671233,0.021917808219178082,0.3013698630136986
982,Dougherty,2422,22,989,117,2400,2422,1.0,0.009083402146985962,0.990916597853014,1316,0.4083402146985962,0.048307184145334435,0.5433526011560693
983,Dougherty,1608,8,623,21,1600,1608,1.0,0.004975124378109453,0.9950248756218906,964,0.38743781094527363,0.013059701492537313,0.599502487562189
984,Dougherty,1854,20,583,914,1834,1854,1.0,0.010787486515641856,0.9892125134843581,357,0.3144552319309601,0.4929881337648328,0.1925566343042071
985,Dougherty,2659,29,759,655,2630,2659,1.0,0.010906355772846935,0.9890936442271531,1245,0.28544565626175256,0.24633320797292216,0.4682211357653253
986,Dougherty,4899,45,2043,502,4854,4899,1.0,0.009185548071034905,0.9908144519289651,2354,0.41702388242498467,0.10246989181465606,0.4805062257603593
987,Dougherty,1689,18,472,606,1671,1689,1.0,0.010657193605683837,0.9893428063943162,611,0.27945529899348726,0.35879218472468916,0.3617525162818236
988,Dougherty,3887,28,1531,1394,3859,3887,1.0,0.0072034988422948285,0.9927965011577051,962,0.3938770259840494,0.358631335219964,0.24749163879598662
989,Dougherty,1139,17,485,185,1122,1139,1.0,0.014925373134328358,0.9850746268656716,469,0.42581211589113255,0.16242317822651448,0.4117647058823529
990,Dougherty,2468,7,1101,32,2461,2468,1.0,0.0028363047001620746,0.997163695299838,1335,0.4461102106969206,0.012965964343598054,0.5409238249594813
991,Dougherty,974,5,637,44,969,974,1.0,0.00513347022587269,0.9948665297741273,293,0.6540041067761807,0.045174537987679675,0.3008213552361396
992,Dougherty,1431,16,656,32,1415,1431,1.0,0.011180992313067784,0.9888190076869322,743,0.4584206848357792,0.02236198462613557,0.5192173305380853
993,Dougherty,1909,4,392,12,1905,1909,1.0,0.0020953378732320588,0.997904662126768,1505,0.20534311157674176,0.006286013619696176,0.788370874803562
994,Dougherty,2621,28,775,816,2593,2621,1.0,0.0106829454406715,0.9893170545593285,1030,0.2956886684471576,0.31133155284242653,0.3929797787104159
995,Dougherty,3826,29,1762,49,3797,3826,1.0,0.007579717720857292,0.9924202822791427,2015,0.4605331939362258,0.01280710925248301,0.5266596968112912
996,Dougherty,3218,45,776,804,3173,3218,1.0,0.013983840894965818,0.9860161591050342,1638,0.24114356743318832,0.24984462399005594,0.5090118085767558
997,Dougherty,3487,35,1223,183,3452,3487,1.0,0.010037281330656725,0.9899627186693433,2081,0.350731287639805,0.05248064238600516,0.5967880699741899
998,Dougherty,2082,32,512,125,2050,2082,1.0,0.01536983669548511,0.9846301633045149,1445,0.24591738712776176,0.060038424591738714,0.6940441882804995
999,Dougherty,2360,42,878,457,2318,2360,1.0,0.017796610169491526,0.9822033898305085,1025,0.37203389830508476,0.19364406779661017,0.4343220338983051
1000,Dougherty,3072,59,909,856,3013,3072,1.0,0.019205729166666668,0.9807942708333334,1307,0.2958984375,0.2786458333333333,0.4254557291666667
1001,Dougherty,695,8,290,119,687,695,1.0,0.011510791366906475,0.9884892086330935,286,0.4172661870503597,0.1712230215827338,0.4115107913669065
1002,Dougherty,1517,32,450,549,1485,1517,1.0,0.02109426499670402,0.978905735003296,518,0.2966381015161503,0.36189848384970336,0.34146341463414637
1003,Dougherty,3953,46,1208,722,3907,3953,1.0,0.011636731596256009,0.988363268403744,2023,0.305590690614723,0.18264609157601822,0.5117632178092588
1004,Dougherty,1484,30,663,42,1454,1484,1.0,0.02021563342318059,0.9797843665768194,779,0.4467654986522911,0.02830188679245283,0.5249326145552561
1005,Dougherty,798,1,257,16,797,798,1.0,0.0012531328320802004,0.9987468671679198,525,0.32205513784461154,0.020050125313283207,0.6578947368421053
1006,Dougherty,3796,43,1433,1020,3753,3796,1.0,0.011327713382507903,0.9886722866174921,1343,0.3775026343519494,0.26870389884088514,0.35379346680716545
1007,Dougherty,3280,43,1805,103,3237,3280,1.0,0.013109756097560975,0.9868902439024391,1372,0.5503048780487805,0.031402439024390244,0.41829268292682925
1008,Douglas,3249,68,1336,579,3181,3249,1.0,0.020929516774392122,0.9790704832256079,1334,0.41120344721452756,0.17820867959372114,0.41058787319175133
1009,Douglas,3832,79,1197,1131,3753,3832,1.0,0.020615866388308975,0.9793841336116911,1504,0.3123695198329854,0.2951461377870564,0.3924843423799583
1010,Douglas,4098,60,2496,384,4038,4098,1.0,0.014641288433382138,0.9853587115666179,1218,0.6090775988286969,0.09370424597364568,0.2972181551976574
1011,Douglas,2953,68,802,1008,2885,2953,1.0,0.02302742973247545,0.9769725702675246,1143,0.27158821537419575,0.3413477819166949,0.3870640027091094
1012,Douglas,3980,89,2098,767,3891,3980,1.0,0.02236180904522613,0.9776381909547739,1115,0.5271356783919598,0.192713567839196,0.28015075376884424
1013,Douglas,4215,99,2065,677,4116,4215,1.0,0.023487544483985764,0.9765124555160143,1473,0.48991696322657174,0.16061684460260972,0.3494661921708185
1014,Douglas,6052,104,3250,1370,5948,6052,1.0,0.017184401850627893,0.9828155981493721,1432,0.5370125578321217,0.22637144745538665,0.23661599471249173
1015,Douglas,5058,85,1889,253,4973,5058,1.0,0.016805061289047053,0.983194938710953,2916,0.3734677738236457,0.05001977066034006,0.5765124555160143
1016,Douglas,3472,106,1107,749,3366,3472,1.0,0.03052995391705069,0.9694700460829493,1616,0.3188364055299539,0.2157258064516129,0.46543778801843316
1017,Douglas,4765,112,1051,2838,4653,4765,1.0,0.023504721930745015,0.976495278069255,876,0.22056663168940188,0.5955928646379853,0.18384050367261282
1018,Douglas,4308,130,1116,1342,4178,4308,1.0,0.030176415970287838,0.9698235840297121,1850,0.2590529247910863,0.3115134633240483,0.42943361188486534
1019,Douglas,4984,111,754,2282,4873,4984,1.0,0.022271268057784913,0.9777287319422151,1948,0.1512841091492777,0.45786516853932585,0.39085072231139645
1020,Douglas,4276,65,2347,770,4211,4276,1.0,0.01520112254443405,0.9847988774555659,1159,0.5488774555659495,0.18007483629560336,0.27104770813844714
1021,Douglas,2691,67,679,581,2624,2691,1.0,0.02489780750650316,0.9751021924934968,1431,0.2523225566703828,0.21590486807878112,0.5317725752508361
1022,Douglas,2419,63,1143,729,2356,2419,1.0,0.026043819760231502,0.9739561802397685,547,0.4725093013642001,0.3013642000826788,0.2261264985531211
1023,Douglas,5738,105,2960,497,5633,5738,1.0,0.018299058905542,0.981700941094458,2281,0.515859184384803,0.08661554548623214,0.39752527012896477
1024,Douglas,7068,102,3331,674,6966,7068,1.0,0.014431239388794566,0.9855687606112055,3063,0.4712790039615167,0.0953593661573288,0.4333616298811545
1025,Douglas,4125,83,2009,1056,4042,4125,1.0,0.02012121212121212,0.9798787878787879,1060,0.48703030303030304,0.256,0.25696969696969696
1026,Douglas,6459,128,2571,1969,6331,6459,1.0,0.019817309180987768,0.9801826908190122,1919,0.3980492336274965,0.3048459513856634,0.29710481498684005
1027,Douglas,6812,160,2249,1014,6652,6812,1.0,0.023487962419260128,0.9765120375807399,3549,0.3301526717557252,0.14885496183206107,0.5209923664122137
1028,Douglas,5607,119,1702,2182,5488,5607,1.0,0.02122347066167291,0.978776529338327,1723,0.3035491350098092,0.38915641162832176,0.3072944533618691
1029,Douglas,2433,55,749,751,2378,2433,1.0,0.02260583641594739,0.9773941635840526,933,0.3078503904644472,0.30867242087957253,0.3834771886559803
1030,Douglas,3231,41,1699,279,3190,3231,1.0,0.012689569792633859,0.9873104302073661,1253,0.5258433921386567,0.08635097493036212,0.38780563293098114
1031,Douglas,4511,118,1466,1040,4393,4511,1.0,0.026158279760585237,0.9738417202394147,2005,0.32498337397472843,0.23054755043227665,0.4444690755929949
1032,Douglas,2071,41,743,529,2030,2071,1.0,0.01979719942056977,0.9802028005794302,799,0.35876388218252053,0.25543215837759536,0.3858039594398841
1033,Early,970,11,369,294,959,970,1.0,0.01134020618556701,0.988659793814433,307,0.3804123711340206,0.3030927835051546,0.31649484536082473
1034,Early,4050,64,1452,833,3986,4050,1.0,0.01580246913580247,0.9841975308641975,1765,0.3585185185185185,0.205679012345679,0.43580246913580245
1035,Early,1317,31,191,641,1286,1317,1.0,0.023538344722854973,0.976461655277145,485,0.14502657555049356,0.486712224753227,0.3682611996962794
1036,Early,1275,17,316,535,1258,1275,1.0,0.013333333333333334,0.9866666666666667,424,0.24784313725490195,0.4196078431372549,0.3325490196078431
1037,Early,703,13,109,419,690,703,1.0,0.01849217638691323,0.9815078236130867,175,0.155049786628734,0.5960170697012802,0.24893314366998578
1038,Echols,2709,93,167,1256,2616,2709,1.0,0.03433001107419712,0.9656699889258029,1286,0.06164636397194537,0.46363971945367294,0.47471391657438167
1039,Effingham,1971,74,317,1168,1897,1971,1.0,0.03754439370877727,0.9624556062912227,486,0.16083206494165397,0.5925925925925926,0.2465753424657534
1040,Effingham,3297,92,350,1753,3205,3297,1.0,0.027904155292690323,0.9720958447073097,1194,0.10615711252653928,0.5316954807400667,0.362147406733394
1041,Effingham,1636,88,210,782,1548,1636,1.0,0.05378973105134474,0.9462102689486552,644,0.12836185819070906,0.4779951100244499,0.39364303178484106
1042,Effingham,2210,60,202,1230,2150,2210,1.0,0.027149321266968326,0.9728506787330317,778,0.09140271493212669,0.5565610859728507,0.35203619909502265
1043,Effingham,2974,62,510,1723,2912,2974,1.0,0.020847343644922665,0.9791526563550773,741,0.1714862138533961,0.5793544048419637,0.24915938130464022
1044,Effingham,3318,63,549,1522,3255,3318,1.0,0.0189873417721519,0.9810126582278481,1247,0.1654611211573237,0.458710066305003,0.3758288125376733
1045,Effingham,4709,113,931,2418,4596,4709,1.0,0.023996602251008706,0.9760033977489913,1360,0.19770651943087705,0.5134848163091952,0.2888086642599278
1046,Effingham,1506,27,184,840,1479,1506,1.0,0.017928286852589643,0.9820717131474104,482,0.12217795484727756,0.5577689243027888,0.3200531208499336
1047,Effingham,1611,31,414,722,1580,1611,1.0,0.019242706393544383,0.9807572936064556,475,0.2569832402234637,0.44816883923029177,0.2948479205462446
1048,Effingham,2551,51,334,1109,2500,2551,1.0,0.0199921599372795,0.9800078400627205,1108,0.13092904743237946,0.4347314778518228,0.4343394747157977
1049,Effingham,3220,102,608,1606,3118,3220,1.0,0.031677018633540374,0.9683229813664597,1006,0.18881987577639753,0.49875776397515525,0.3124223602484472
1050,Effingham,3996,106,596,1933,3890,3996,1.0,0.026526526526526525,0.9734734734734735,1467,0.14914914914914915,0.48373373373373374,0.36711711711711714
1051,Effingham,2181,62,419,847,2119,2181,1.0,0.028427326914259515,0.9715726730857405,915,0.19211370930765703,0.3883539660706098,0.4195323246217332
1052,Effingham,3065,117,313,1602,2948,3065,1.0,0.03817292006525286,0.9618270799347471,1150,0.10212071778140294,0.5226753670473083,0.37520391517128876
1053,Effingham,3015,107,445,1551,2908,3015,1.0,0.03548922056384743,0.9645107794361526,1019,0.14759535655058043,0.5144278606965174,0.33797678275290216
1054,Effingham,4351,114,970,1707,4237,4351,1.0,0.026200873362445413,0.9737991266375546,1674,0.22293725580326362,0.39232360376924846,0.3847391404274879
1055,Effingham,1684,37,368,845,1647,1684,1.0,0.021971496437054632,0.9780285035629454,471,0.21852731591448932,0.5017814726840855,0.27969121140142517
1056,Elbert,1287,31,154,604,1256,1287,1.0,0.024087024087024088,0.9759129759129759,529,0.11965811965811966,0.4693084693084693,0.411033411033411
1057,Elbert,5142,71,1263,1326,5071,5142,1.0,0.013807856865033061,0.986192143134967,2553,0.2456242707117853,0.25787631271878647,0.49649941656942825
1058,Elbert,1028,15,144,469,1013,1028,1.0,0.014591439688715954,0.9854085603112841,415,0.14007782101167315,0.45622568093385213,0.4036964980544747
1059,Elbert,715,20,55,371,695,715,1.0,0.027972027972027972,0.972027972027972,289,0.07692307692307693,0.5188811188811189,0.4041958041958042
1060,Elbert,2033,24,248,962,2009,2033,1.0,0.011805213969503197,0.9881947860304968,823,0.1219872110181997,0.4731923266109198,0.4048204623708805
1061,Elbert,708,10,122,347,698,708,1.0,0.014124293785310734,0.9858757062146892,239,0.17231638418079095,0.4901129943502825,0.3375706214689266
1062,Elbert,568,15,83,271,553,568,1.0,0.02640845070422535,0.9735915492957746,214,0.14612676056338028,0.477112676056338,0.3767605633802817
1063,Elbert,442,7,55,247,435,442,1.0,0.01583710407239819,0.9841628959276018,140,0.1244343891402715,0.5588235294117647,0.3167420814479638
1064,Elbert,1853,18,441,756,1835,1853,1.0,0.009713977334052886,0.9902860226659471,656,0.23799244468429573,0.4079870480302213,0.354020507285483
1065,Elbert,533,10,77,243,523,533,1.0,0.01876172607879925,0.9812382739212008,213,0.14446529080675422,0.45590994371482174,0.399624765478424
1066,Elbert,1184,16,237,630,1168,1184,1.0,0.013513513513513514,0.9864864864864865,317,0.20016891891891891,0.5320945945945946,0.2677364864864865
1067,Emanuel,852,15,74,489,837,852,1.0,0.017605633802816902,0.9823943661971831,289,0.08685446009389672,0.573943661971831,0.3392018779342723
1068,Emanuel,853,15,29,549,838,853,1.0,0.017584994138335287,0.9824150058616647,275,0.03399765533411489,0.6436107854630715,0.3223915592028136
1069,Emanuel,730,1,101,399,729,730,1.0,0.0013698630136986301,0.9986301369863013,230,0.13835616438356163,0.5465753424657535,0.3150684931506849
1070,Emanuel,252,0,117,65,252,252,1.0,0.0,1.0,70,0.4642857142857143,0.25793650793650796,0.2777777777777778
1071,Emanuel,618,11,77,294,607,618,1.0,0.01779935275080906,0.982200647249191,247,0.12459546925566344,0.47572815533980584,0.39967637540453077
1072,Emanuel,564,10,52,222,554,564,1.0,0.01773049645390071,0.9822695035460993,290,0.09219858156028368,0.39361702127659576,0.5141843971631206
1073,Emanuel,735,10,34,456,725,735,1.0,0.013605442176870748,0.9863945578231292,245,0.04625850340136054,0.6204081632653061,0.3333333333333333
1074,Emanuel,804,14,128,270,790,804,1.0,0.017412935323383085,0.9825870646766169,406,0.15920398009950248,0.3358208955223881,0.5049751243781094
1075,Emanuel,582,12,86,287,570,582,1.0,0.020618556701030927,0.979381443298969,209,0.14776632302405499,0.49312714776632305,0.359106529209622
1076,Emanuel,9084,115,1786,2790,8969,9084,1.0,0.01265962131219727,0.9873403786878028,4508,0.19660942316160282,0.30713342140026423,0.496257155438133
1077,Emanuel,2246,35,400,730,2211,2246,1.0,0.015583259127337488,0.9844167408726625,1116,0.17809439002671415,0.3250222617987533,0.4968833481745325
1078,Evans,8127,132,1324,2888,7995,8127,1.0,0.016242155777039496,0.9837578442229605,3915,0.16291374430909314,0.3553586809400763,0.48172757475083056
1079,Fannin,1302,41,150,711,1261,1302,1.0,0.0314900153609831,0.9685099846390169,441,0.1152073732718894,0.5460829493087558,0.3387096774193548
1080,Fannin,1296,38,169,726,1258,1296,1.0,0.029320987654320986,0.970679012345679,401,0.13040123456790123,0.5601851851851852,0.30941358024691357
1081,Fannin,3571,107,299,1824,3464,3571,1.0,0.029963595631475777,0.9700364043685242,1448,0.08373004760571269,0.5107812937552506,0.40548865863903666
1082,Fannin,1393,39,181,791,1354,1393,1.0,0.02799712849964106,0.9720028715003589,421,0.1299353912419239,0.5678391959798995,0.3022254127781766
1083,Fannin,1278,39,169,784,1239,1278,1.0,0.03051643192488263,0.9694835680751174,325,0.1322378716744914,0.6134585289514867,0.2543035993740219
1084,Fannin,1839,39,212,1168,1800,1839,1.0,0.021207177814029365,0.9787928221859706,459,0.11528004350190321,0.6351277868406743,0.2495921696574225
1085,Fannin,1219,28,124,711,1191,1219,1.0,0.022969647251845776,0.9770303527481542,384,0.10172272354388844,0.583264971287941,0.31501230516817064
1086,Fannin,2184,81,267,1265,2103,2184,1.0,0.03708791208791209,0.9629120879120879,652,0.12225274725274725,0.5792124542124543,0.29853479853479853
1087,Fannin,817,22,138,524,795,817,1.0,0.02692778457772338,0.9730722154222766,155,0.1689106487148103,0.6413708690330477,0.189718482252142
1088,Fannin,381,12,59,211,369,381,1.0,0.031496062992125984,0.968503937007874,111,0.15485564304461943,0.5538057742782152,0.29133858267716534
1089,Fannin,2418,52,332,1450,2366,2418,1.0,0.021505376344086023,0.978494623655914,636,0.13730355665839536,0.5996691480562448,0.2630272952853598
1090,Fannin,3476,76,471,2004,3400,3476,1.0,0.02186421173762946,0.9781357882623706,1001,0.1355005753739931,0.5765247410817032,0.2879746835443038
1091,Fayette,1848,10,488,886,1838,1848,1.0,0.005411255411255411,0.9945887445887446,474,0.26406926406926406,0.47943722943722944,0.2564935064935065
1092,Fayette,1866,37,596,870,1829,1866,1.0,0.01982851018220793,0.9801714898177921,400,0.31939978563772775,0.4662379421221865,0.21436227224008575
1093,Fayette,1682,33,643,567,1649,1682,1.0,0.019619500594530322,0.9803804994054697,472,0.3822829964328181,0.3370986920332937,0.2806183115338882
1094,Fayette,2524,42,1490,598,2482,2524,1.0,0.01664025356576862,0.9833597464342314,436,0.5903328050713154,0.23692551505546752,0.17274167987321712
1095,Fayette,1730,27,387,1114,1703,1730,1.0,0.01560693641618497,0.9843930635838151,229,0.22369942196531792,0.6439306358381502,0.13236994219653178
1096,Fayette,2464,79,343,1793,2385,2464,1.0,0.03206168831168831,0.9679383116883117,328,0.13920454545454544,0.7276785714285714,0.1331168831168831
1097,Fayette,1870,30,489,1021,1840,1870,1.0,0.016042780748663103,0.983957219251337,360,0.26149732620320854,0.5459893048128343,0.1925133689839572
1098,Fayette,3026,67,970,1519,2959,3026,1.0,0.022141440846001323,0.9778585591539987,537,0.3205551883674818,0.5019828155981494,0.1774619960343688
1099,Fayette,3114,31,2211,323,3083,3114,1.0,0.00995504174694926,0.9900449582530507,580,0.710019267822736,0.10372511239563263,0.18625561978163135
1100,Fayette,2131,40,915,568,2091,2131,1.0,0.018770530267480056,0.9812294697325199,648,0.4293758798686063,0.2665415297982168,0.3040825903331769
1101,Fayette,2805,43,984,732,2762,2805,1.0,0.015329768270944741,0.9846702317290552,1089,0.3508021390374332,0.2609625668449198,0.38823529411764707
1102,Fayette,3514,60,1105,1677,3454,3514,1.0,0.01707455890722823,0.9829254410927718,732,0.31445645987478654,0.47723392145702903,0.2083096186681844
1103,Fayette,2388,47,621,879,2341,2388,1.0,0.01968174204355109,0.9803182579564489,888,0.2600502512562814,0.36809045226130654,0.37185929648241206
1104,Fayette,1677,26,825,478,1651,1677,1.0,0.015503875968992248,0.9844961240310077,374,0.4919499105545617,0.28503279666070364,0.22301729278473464
1105,Fayette,1532,31,478,803,1501,1532,1.0,0.020234986945169713,0.9797650130548303,251,0.31201044386422977,0.5241514360313316,0.16383812010443866
1106,Fayette,2450,53,1070,628,2397,2450,1.0,0.02163265306122449,0.9783673469387755,752,0.43673469387755104,0.2563265306122449,0.3069387755102041
1107,Fayette,3261,52,1299,664,3209,3261,1.0,0.015946028825513645,0.9840539711744863,1298,0.3983440662373505,0.20361852192578964,0.39803741183685987
1108,Fayette,5511,63,1731,1991,5448,5511,1.0,0.011431682090364725,0.9885683179096353,1789,0.3140990745781165,0.36127744510978044,0.3246234803121031
1109,Fayette,961,20,625,155,941,961,1.0,0.02081165452653486,0.9791883454734651,181,0.6503642039542143,0.16129032258064516,0.18834547346514047
1110,Fayette,3363,58,1007,1620,3305,3363,1.0,0.017246506095747845,0.9827534939042522,736,0.2994350282485876,0.4817127564674398,0.21885221528397264
1111,Fayette,2814,66,1415,920,2748,2814,1.0,0.023454157782515993,0.976545842217484,479,0.5028429282160626,0.3269367448471926,0.17022032693674485
1112,Fayette,3051,44,1290,1189,3007,3051,1.0,0.014421501147164863,0.9855784988528351,572,0.42281219272369713,0.3897082923631596,0.18747951491314324
1113,Fayette,1305,19,412,640,1286,1305,1.0,0.014559386973180077,0.98544061302682,253,0.3157088122605364,0.4904214559386973,0.19386973180076628
1114,Fayette,2247,43,1038,643,2204,2247,1.0,0.01913662661326213,0.9808633733867379,566,0.46194926568758343,0.2861593235425011,0.25189141076991545
1115,Fayette,2892,50,824,1528,2842,2892,1.0,0.017289073305670817,0.9827109266943291,540,0.28492392807745504,0.5283540802213001,0.18672199170124482
1116,Fayette,3634,63,1068,2320,3571,3634,1.0,0.017336268574573474,0.9826637314254265,246,0.2938910291689598,0.6384149697303247,0.06769400110071547
1117,Fayette,4937,118,2252,1338,4819,4937,1.0,0.023901154547295928,0.9760988454527041,1347,0.4561474579704274,0.27101478630747416,0.27283775572209845
1118,Fayette,1887,62,471,775,1825,1887,1.0,0.03285638579756227,0.9671436142024378,641,0.24960254372019078,0.41070482246952833,0.33969263381028086
1119,Fayette,1194,19,417,634,1175,1194,1.0,0.015912897822445562,0.9840871021775545,143,0.3492462311557789,0.5309882747068677,0.11976549413735343
1120,Fayette,3215,49,1453,1083,3166,3215,1.0,0.015241057542768274,0.9847589424572317,679,0.45194401244167964,0.3368584758942457,0.21119751166407466
1121,Fayette,3287,57,653,1885,3230,3287,1.0,0.017341040462427744,0.9826589595375722,749,0.1986613933678126,0.573471250380286,0.22786735625190144
1122,Fayette,3296,74,997,1899,3222,3296,1.0,0.022451456310679612,0.9775485436893204,400,0.3024878640776699,0.5761529126213593,0.12135922330097088
1123,Fayette,3123,70,1188,1166,3053,3123,1.0,0.022414345180915785,0.9775856548190842,769,0.3804034582132565,0.3733589497278258,0.2462375920589177
1124,Fayette,1918,40,554,967,1878,1918,1.0,0.020855057351407715,0.9791449426485923,397,0.28884254431699685,0.5041710114702815,0.20698644421272158
1125,Fayette,932,19,280,496,913,932,1.0,0.0203862660944206,0.9796137339055794,156,0.30042918454935624,0.5321888412017167,0.16738197424892703
1126,Fayette,2349,55,476,1583,2294,2349,1.0,0.023414218816517667,0.9765857811834824,290,0.20263942103022564,0.6739037888463176,0.12345679012345678
1127,Floyd,4061,91,679,1764,3970,4061,1.0,0.022408273824181237,0.9775917261758188,1618,0.16720019699581384,0.4343757695148978,0.39842403348928834
1128,Floyd,1639,21,155,791,1618,1639,1.0,0.012812690665039659,0.9871873093349604,693,0.09456985967053082,0.48261134838316044,0.4228187919463087
1129,Floyd,2693,92,223,1543,2601,2693,1.0,0.03416264389157074,0.9658373561084292,927,0.08280727812848125,0.5729669513553658,0.344225770516153
1130,Floyd,1814,42,242,883,1772,1814,1.0,0.023153252480705624,0.9768467475192943,689,0.13340683572216097,0.48676957001102533,0.37982359426681367
1131,Floyd,1342,36,140,721,1306,1342,1.0,0.026825633383010434,0.9731743666169895,481,0.10432190760059612,0.53725782414307,0.35842026825633383
1132,Floyd,3909,116,565,1801,3793,3909,1.0,0.029675108723458684,0.9703248912765413,1543,0.14453824507546686,0.46073164492197494,0.3947301100025582
1133,Floyd,5135,104,1282,1303,5031,5135,1.0,0.020253164556962026,0.979746835443038,2550,0.24965920155793572,0.2537487828627069,0.49659201557935734
1134,Floyd,5477,135,795,2964,5342,5477,1.0,0.02464853021727223,0.9753514697827278,1718,0.14515245572393645,0.5411721745481103,0.31367536972795323
1135,Floyd,451,17,55,280,434,451,1.0,0.037694013303769404,0.9623059866962306,116,0.12195121951219512,0.6208425720620843,0.2572062084257206
1136,Floyd,1801,36,150,1154,1765,1801,1.0,0.019988895058300944,0.9800111049416991,497,0.0832870627429206,0.6407551360355358,0.27595780122154356
1137,Floyd,1230,38,83,631,1192,1230,1.0,0.030894308943089432,0.9691056910569106,516,0.06747967479674796,0.5130081300813009,0.4195121951219512
1138,Floyd,6793,152,450,1029,6641,6793,1.0,0.022375975268658914,0.9776240247313411,5314,0.06624466362431915,0.15147946415427646,0.7822758722214044
1139,Floyd,4660,106,562,1823,4554,4660,1.0,0.022746781115879827,0.9772532188841202,2275,0.12060085836909872,0.3912017167381974,0.48819742489270385
1140,Floyd,1848,27,120,971,1821,1848,1.0,0.01461038961038961,0.9853896103896104,757,0.06493506493506493,0.5254329004329005,0.4096320346320346
1141,Floyd,3895,147,1476,1704,3748,3895,1.0,0.03774069319640565,0.9622593068035944,715,0.37894736842105264,0.4374839537869063,0.18356867779204109
1142,Floyd,5198,136,1118,1426,5062,5198,1.0,0.026163909195844555,0.9738360908041555,2654,0.21508272412466334,0.2743362831858407,0.510580992689496
1143,Floyd,2297,62,216,977,2235,2297,1.0,0.026991728341314757,0.9730082716586852,1104,0.09403569873748367,0.42533739660426645,0.48062690465824986
1144,Floyd,4095,119,1037,1088,3976,4095,1.0,0.02905982905982906,0.9709401709401709,1970,0.2532356532356532,0.2656898656898657,0.4810744810744811
1145,Floyd,1465,33,146,405,1432,1465,1.0,0.022525597269624574,0.9774744027303754,914,0.09965870307167235,0.2764505119453925,0.6238907849829352
1146,Floyd,1995,37,638,204,1958,1995,1.0,0.018546365914786967,0.981453634085213,1153,0.3197994987468672,0.10225563909774436,0.5779448621553884
1147,Floyd,655,16,87,541,639,655,1.0,0.024427480916030534,0.9755725190839695,27,0.13282442748091602,0.8259541984732824,0.04122137404580153
1148,Floyd,4233,76,883,1035,4157,4233,1.0,0.01795416961965509,0.9820458303803449,2315,0.208599102291519,0.2445074415308292,0.5468934561776518
1149,Floyd,1969,60,107,436,1909,1969,1.0,0.03047232097511427,0.9695276790248857,1426,0.05434230573895378,0.22143219908583037,0.7242254951752158
1150,Floyd,4048,103,397,2138,3945,4048,1.0,0.025444664031620552,0.9745553359683794,1513,0.09807312252964427,0.5281620553359684,0.37376482213438733
1151,Floyd,3592,96,402,1511,3496,3592,1.0,0.026726057906458798,0.9732739420935412,1679,0.11191536748329621,0.42065701559020047,0.46742761692650336
1152,Forsyth,18111,186,3871,5095,17925,18111,1.0,0.01027000165645188,0.9897299983435481,9145,0.2137375075920711,0.2813207442990448,0.5049417481088841
1153,Forsyth,9707,163,1820,1404,9544,9707,1.0,0.016792005769032656,0.9832079942309674,6483,0.18749356134748119,0.14463789018234263,0.6678685484701762
1154,Forsyth,10345,270,1850,6123,10075,10345,1.0,0.02609956500724988,0.9739004349927501,2372,0.17883035282745288,0.5918801353310779,0.2292895118414693
1155,Forsyth,6993,203,889,4154,6790,6993,1.0,0.02902902902902903,0.970970970970971,1950,0.12712712712712712,0.594022594022594,0.27885027885027885
1156,Forsyth,7223,147,1577,4346,7076,7223,1.0,0.020351654437214452,0.9796483455627856,1300,0.21833033365637547,0.60168904887166,0.17998061747196456
1157,Forsyth,7653,185,1082,3981,7468,7653,1.0,0.024173526721547104,0.9758264732784528,2590,0.14138246439304847,0.520188161505292,0.33842937410165946
1158,Forsyth,5268,147,1332,2989,5121,5268,1.0,0.027904328018223234,0.9720956719817767,947,0.2528473804100228,0.5673880030372058,0.17976461655277146
1159,Forsyth,7876,117,1949,4633,7759,7876,1.0,0.014855256475368207,0.9851447435246318,1294,0.24746063991874048,0.5882427628237684,0.1642965972574911
1160,Forsyth,21094,304,6149,12780,20790,21094,1.0,0.01441168104674315,0.9855883189532568,2165,0.2915046932777093,0.6058594861097942,0.10263582061249645
1161,Forsyth,9437,252,1499,4801,9185,9437,1.0,0.026703401504715483,0.9732965984952845,3137,0.15884285260146233,0.5087421850164248,0.33241496238211293
1162,Forsyth,14308,361,1270,3520,13947,14308,1.0,0.025230640201285993,0.974769359798714,9518,0.0887615320100643,0.2460162147050601,0.6652222532848756
1163,Forsyth,9687,53,4336,5350,9634,9687,1.2256105276477287,0.005471250129038918,0.9945287498709611,1,0.4476101992360896,0.5522865696294003,0.00010323113451016826
1164,Forsyth,14596,115,4676,7740,14481,14596,1.0,0.007878870923540697,0.9921211290764593,2180,0.32036174294327213,0.530282269114826,0.14935598794190189
1165,Forsyth,11336,110,3233,4599,11226,11336,1.0,0.009703599153140438,0.9902964008468595,3504,0.28519760056457305,0.4056986591390261,0.30910374029640086
1166,Forsyth,10977,289,1741,5939,10688,10977,1.0,0.02632777625945158,0.9736722237405484,3297,0.15860435455953356,0.5410403571103216,0.30035528833014485
1167,Forsyth,18366,266,4929,7668,18100,18366,1.0,0.014483284329739736,0.9855167156702602,5769,0.2683763475988239,0.41751061744527934,0.31411303495589676
1168,Franklin,1421,19,110,805,1402,1421,1.0,0.013370865587614356,0.9866291344123856,506,0.07741027445460943,0.5665024630541872,0.35608726249120337
1169,Franklin,2754,51,193,1570,2703,2754,1.0,0.018518518518518517,0.9814814814814815,991,0.070079883805374,0.570079883805374,0.359840232389252
1170,Franklin,2904,46,382,1199,2858,2904,1.0,0.01584022038567493,0.9841597796143251,1323,0.1315426997245179,0.4128787878787879,0.4555785123966942
1171,Franklin,3344,60,325,1750,3284,3344,1.0,0.017942583732057416,0.9820574162679426,1269,0.097188995215311,0.5233253588516746,0.37948564593301437
1172,Franklin,3093,43,282,1130,3050,3093,1.0,0.013902360168121564,0.9860976398318785,1681,0.09117361784675072,0.36534109279017135,0.5434852893630779
1173,Franklin,2721,65,173,1563,2656,2721,1.0,0.02388827636898199,0.9761117236310181,985,0.06357956633590592,0.5744211686879823,0.36199926497611173
1174,Franklin,2061,62,128,1052,1999,2061,1.0,0.030082484230955848,0.9699175157690442,881,0.06210577389616691,0.5104318292091218,0.4274623968947113
1175,Fulton,3783,57,2579,247,3726,3783,1.0,0.01506740681998414,0.9849325931800159,957,0.6817340734866508,0.06529209621993128,0.2529738302934179
1176,Fulton,4043,75,2984,301,3968,4043,1.0,0.01855058125154588,0.9814494187484541,758,0.7380657927281722,0.07444966608953747,0.18748454118229038
1177,Fulton,1431,23,717,49,1408,1431,1.0,0.01607267645003494,0.983927323549965,665,0.5010482180293501,0.03424178895877009,0.4647099930118798
1178,Fulton,1043,17,435,34,1026,1043,1.0,0.016299137104506232,0.9837008628954937,574,0.4170661553211889,0.032598274209012464,0.5503355704697986
1179,Fulton,2974,54,2435,287,2920,2974,1.0,0.01815736381977135,0.9818426361802286,252,0.8187626092804304,0.09650302622730329,0.0847343644922663
1180,Fulton,963,15,481,34,948,963,1.0,0.01557632398753894,0.9844236760124611,448,0.4994807892004154,0.035306334371754934,0.4652128764278297
1181,Fulton,1918,37,1159,87,1881,1918,1.0,0.01929092805005214,0.9807090719499478,672,0.6042752867570386,0.04535974973931178,0.35036496350364965
1182,Fulton,1037,33,405,17,1004,1037,1.0,0.03182256509161042,0.9681774349083896,615,0.390549662487946,0.01639344262295082,0.5930568948891032
1183,Fulton,2697,33,1287,72,2664,2697,1.0,0.012235817575083427,0.9877641824249166,1338,0.4771968854282536,0.026696329254727477,0.4961067853170189
1184,Fulton,1241,22,603,28,1219,1241,1.0,0.017727639000805803,0.9822723609991942,610,0.48589846897663175,0.022562449637389202,0.49153908138597907
1185,Fulton,1022,24,468,37,998,1022,1.0,0.023483365949119372,0.9765166340508806,517,0.45792563600782776,0.036203522504892366,0.5058708414872799
1186,Fulton,1870,26,928,56,1844,1870,1.0,0.013903743315508022,0.986096256684492,886,0.49625668449197863,0.029946524064171122,0.4737967914438503
1187,Fulton,4144,58,808,67,4086,4144,1.0,0.013996138996138996,0.986003861003861,3269,0.19498069498069498,0.016167953667953667,0.7888513513513513
1188,Fulton,6738,70,3329,754,6668,6738,1.0,0.010388839418224993,0.989611160581775,2655,0.4940635203324429,0.11190264173345206,0.39403383793410507
1189,Fulton,2499,41,1242,168,2458,2499,1.0,0.01640656262505002,0.98359343737495,1089,0.4969987995198079,0.06722689075630252,0.43577430972388953
1190,Fulton,2454,31,1175,138,2423,2454,1.0,0.01263243683781581,0.9873675631621842,1141,0.47881010594947027,0.05623471882640587,0.4649551752241239
1191,Fulton,5753,78,3200,478,5675,5753,1.0,0.013558143577264037,0.986441856422736,2075,0.5562315313749349,0.0830870849991309,0.36068138362593427
1192,Fulton,1906,26,1463,143,1880,1906,1.0,0.013641133263378805,0.9863588667366212,300,0.7675760755508919,0.07502623294858342,0.15739769150052466
1193,Fulton,3435,58,2092,280,3377,3435,1.0,0.016885007278020378,0.9831149927219797,1063,0.6090247452692867,0.08151382823871907,0.30946142649199415
1194,Fulton,936,6,432,65,930,936,1.0,0.00641025641025641,0.9935897435897436,439,0.46153846153846156,0.06944444444444445,0.469017094017094
1195,Fulton,4068,58,2523,349,4010,4068,1.0,0.014257620452310717,0.9857423795476893,1196,0.6202064896755162,0.08579154375614553,0.29400196656833827
1196,Fulton,2523,46,1412,163,2477,2523,1.0,0.01823226317875545,0.9817677368212445,948,0.5596512088783194,0.06460562822037257,0.375743162901308
1197,Fulton,1539,38,924,135,1501,1539,1.0,0.024691358024691357,0.9753086419753086,480,0.6003898635477583,0.08771929824561403,0.31189083820662766
1198,Fulton,9044,122,4164,783,8922,9044,1.0,0.013489606368863335,0.9865103936311367,4097,0.46041574524546663,0.08657673595754091,0.45300751879699247
1199,Fulton,3350,13,1314,222,3337,3350,1.0,0.003880597014925373,0.9961194029850746,1814,0.39223880597014926,0.0662686567164179,0.5414925373134328
1200,Fulton,869,18,450,43,851,869,1.0,0.020713463751438434,0.9792865362485615,376,0.5178365937859609,0.04948216340621404,0.4326812428078251
1201,Fulton,1371,18,544,104,1353,1371,1.0,0.01312910284463895,0.986870897155361,723,0.3967906637490883,0.07585703865791393,0.5273522975929978
1202,Fulton,1667,24,777,41,1643,1667,1.0,0.014397120575884824,0.9856028794241152,849,0.46610677864427114,0.02459508098380324,0.5092981403719257
1203,Fulton,661,9,213,16,652,661,1.0,0.01361573373676248,0.9863842662632375,432,0.32223903177004537,0.024205748865355523,0.653555219364599
1204,Fulton,1506,28,728,27,1478,1506,1.0,0.01859229747675963,0.9814077025232404,751,0.48339973439575035,0.017928286852589643,0.49867197875166
1205,Fulton,852,17,433,29,835,852,1.0,0.01995305164319249,0.9800469483568075,390,0.5082159624413145,0.03403755868544601,0.45774647887323944
1206,Fulton,2316,15,1024,71,2301,2316,1.0,0.006476683937823834,0.9935233160621761,1221,0.4421416234887737,0.03065630397236615,0.5272020725388601
1207,Fulton,2675,38,1253,242,2637,2675,1.0,0.014205607476635514,0.9857943925233645,1180,0.46841121495327104,0.09046728971962617,0.4411214953271028
1208,Fulton,497,10,272,14,487,497,1.0,0.02012072434607646,0.9798792756539235,211,0.5472837022132797,0.028169014084507043,0.4245472837022133
1209,Fulton,918,12,388,33,906,918,1.0,0.013071895424836602,0.9869281045751634,497,0.4226579520697168,0.03594771241830065,0.5413943355119826
1210,Fulton,8400,95,559,89,8305,8400,1.0,0.01130952380952381,0.9886904761904762,7752,0.06654761904761905,0.010595238095238095,0.9228571428571428
1211,Fulton,566,16,206,16,550,566,1.0,0.028268551236749116,0.9717314487632509,344,0.36395759717314485,0.028268551236749116,0.607773851590106
1212,Fulton,3252,21,455,88,3231,3252,1.0,0.006457564575645757,0.9935424354243543,2709,0.13991389913899138,0.02706027060270603,0.8330258302583026
1213,Fulton,2709,33,870,48,2676,2709,1.0,0.012181616832779624,0.9878183831672204,1791,0.3211517165005537,0.017718715393133997,0.6611295681063123
1214,Fulton,7021,102,2118,313,6919,7021,1.0,0.014527845036319613,0.9854721549636803,4590,0.30166642928357784,0.0445805440820396,0.6537530266343826
1215,Fulton,8,2,7,0,6,8,1.1666666666666667,0.25,0.75,1,0.875,0.0,0.125
1216,Fulton,720,11,408,20,709,720,1.0,0.015277777777777777,0.9847222222222223,292,0.5666666666666667,0.027777777777777776,0.40555555555555556
1217,Fulton,1671,41,781,44,1630,1671,1.0,0.024536205864751647,0.9754637941352483,846,0.4673847995212448,0.026331538001196888,0.5062836624775583
1218,Fulton,1401,33,580,20,1368,1401,1.0,0.023554603854389723,0.9764453961456103,801,0.41399000713775874,0.014275517487508922,0.5717344753747323
1219,Fulton,2865,17,758,33,2848,2865,1.0,0.00593368237347295,0.9940663176265271,2074,0.26457242582897034,0.011518324607329843,0.7239092495636998
1220,Fulton,133,3,51,1,130,133,1.0,0.022556390977443608,0.9774436090225563,81,0.38345864661654133,0.007518796992481203,0.6090225563909775
1221,Fulton,1318,12,812,33,1306,1318,1.0,0.009104704097116844,0.9908952959028832,473,0.6160849772382397,0.02503793626707132,0.3588770864946889
1222,Fulton,4279,51,1145,114,4228,4279,1.0,0.01191867258705305,0.988081327412947,3020,0.2675858845524655,0.026641738724000934,0.7057723767235335
1223,Fulton,719,6,388,19,713,719,1.0,0.008344923504867872,0.9916550764951322,312,0.5396383866481224,0.02642559109874826,0.4339360222531293
1224,Fulton,4042,29,769,71,4013,4042,1.0,0.007174666006927264,0.9928253339930727,3202,0.19025235032162297,0.01756556160316675,0.7921820880752103
1225,Fulton,2071,8,183,9,2063,2071,1.0,0.00386286817962337,0.9961371318203767,1879,0.08836310960888459,0.0043457267020762915,0.9072911636890391
1226,Fulton,2279,24,1273,67,2255,2279,1.0,0.010530934620447565,0.9894690653795525,939,0.5585783238262396,0.029398859148749453,0.412022817025011
1227,Fulton,1593,15,929,60,1578,1593,1.0,0.009416195856873822,0.9905838041431262,604,0.5831763967357187,0.03766478342749529,0.37915881983678595
1228,Fulton,766,7,328,15,759,766,1.0,0.009138381201044387,0.9908616187989556,423,0.4281984334203655,0.0195822454308094,0.5522193211488251
1229,Fulton,1926,38,1198,48,1888,1926,1.0,0.01973001038421599,0.980269989615784,680,0.6220145379023884,0.024922118380062305,0.3530633437175493
1230,Fulton,951,11,643,40,940,951,1.0,0.011566771819137749,0.9884332281808622,268,0.676130389064143,0.04206098843322818,0.28180862250262884
1231,Fulton,2956,31,1288,69,2925,2956,1.0,0.010487144790257105,0.9895128552097429,1599,0.435723951285521,0.02334235453315291,0.5409336941813261
1232,Fulton,861,0,225,2,861,861,1.0,0.0,1.0,634,0.2613240418118467,0.0023228803716608595,0.7363530778164924
1233,Fulton,1858,33,1035,61,1825,1858,1.0,0.01776103336921421,0.9822389666307858,762,0.5570505920344456,0.03283100107642627,0.4101184068891281
1234,Fulton,733,6,380,30,727,733,1.0,0.008185538881309686,0.9918144611186903,323,0.5184174624829468,0.040927694406548434,0.4406548431105048
1235,Fulton,3044,34,1973,208,3010,3044,1.0,0.011169513797634692,0.9888304862023654,863,0.6481603153745072,0.0683311432325887,0.2835085413929041
1236,Fulton,3292,52,2185,217,3240,3292,1.0,0.015795868772782502,0.9842041312272175,890,0.663730255164034,0.06591737545565006,0.2703523693803159
1237,Fulton,2159,36,1055,68,2123,2159,1.0,0.01667438628994905,0.9833256137100509,1036,0.4886521537748958,0.031496062992125984,0.4798517832329782
1238,Fulton,43,1,38,5,42,43,1.0,0.023255813953488372,0.9767441860465116,0,0.8837209302325582,0.11627906976744186,0.0
1239,Fulton,267,1,85,6,266,267,1.0,0.003745318352059925,0.9962546816479401,176,0.31835205992509363,0.02247191011235955,0.6591760299625468
1240,Fulton,144,4,130,13,140,144,3.4878048780487805,0.027777777777777776,0.9722222222222222,1,0.9027777777777778,0.09027777777777778,0.006944444444444444
1241,Fulton,631,7,422,48,624,631,1.0,0.011093502377179081,0.9889064976228209,161,0.6687797147385103,0.07606973058637084,0.2551505546751189
1242,Fulton,7970,98,1097,119,7872,7970,1.0,0.012296110414052697,0.9877038895859473,6754,0.13764115432873275,0.01493099121706399,0.8474278544542032
1243,Fulton,1873,19,1231,224,1854,1873,1.0,0.01014415376401495,0.9898558462359851,418,0.6572343833422317,0.1195942338494394,0.22317138280832888
1244,Fulton,10253,140,5955,1304,10113,10253,1.0,0.013654540134594753,0.9863454598654052,2994,0.580805617867941,0.12718228811079685,0.29201209402126205
1245,Fulton,2385,28,1337,269,2357,2385,1.0,0.011740041928721174,0.9882599580712789,779,0.5605870020964361,0.11278825995807128,0.3266247379454927
1246,Fulton,3114,40,1726,306,3074,3114,1.0,0.012845215157353885,0.9871547848426461,1082,0.5542710340398201,0.09826589595375723,0.3474630700064226
1247,Fulton,531,6,355,65,525,531,1.0,0.011299435028248588,0.9887005649717514,111,0.6685499058380414,0.1224105461393597,0.20903954802259886
1248,Fulton,6154,108,2142,329,6046,6154,1.0,0.017549561260968474,0.9824504387390315,3683,0.34806629834254144,0.053461163470913224,0.5984725381865453
1249,Fulton,2626,20,1894,329,2606,2626,1.0,0.007616146230007616,0.9923838537699924,403,0.7212490479817213,0.12528560548362527,0.15346534653465346
1250,Fulton,912,5,628,162,907,912,1.0,0.005482456140350877,0.9945175438596491,122,0.6885964912280702,0.17763157894736842,0.1337719298245614
1251,Fulton,605,10,410,159,595,605,1.0,0.01652892561983471,0.9834710743801653,36,0.6776859504132231,0.2628099173553719,0.05950413223140496
1252,Fulton,1656,22,808,351,1634,1656,1.0,0.013285024154589372,0.9867149758454107,497,0.48792270531400966,0.21195652173913043,0.3001207729468599
1253,Fulton,644,11,324,22,633,644,1.0,0.017080745341614908,0.9829192546583851,298,0.5031055900621118,0.034161490683229816,0.46273291925465837
1254,Fulton,1687,26,1092,261,1661,1687,1.0,0.015411973918197985,0.9845880260818021,334,0.6473029045643154,0.15471250740960285,0.1979845880260818
1255,Fulton,8969,117,3341,2030,8852,8969,1.0,0.013044932545434273,0.9869550674545657,3598,0.3725052960196231,0.2263351544207827,0.40115954955959415
1256,Fulton,2628,20,1154,1280,2608,2628,1.0,0.0076103500761035,0.9923896499238964,194,0.439117199391172,0.487062404870624,0.07382039573820395
1257,Fulton,5466,36,1945,1266,5430,5466,1.0,0.006586169045005488,0.9934138309549945,2255,0.3558360775704354,0.23161361141602635,0.41255031101353823
1258,Fulton,5796,87,2020,1211,5709,5796,1.0,0.015010351966873706,0.9849896480331263,2565,0.34851621808143546,0.20893719806763286,0.44254658385093165
1259,Fulton,2359,34,1192,510,2325,2359,1.0,0.014412886816447647,0.9855871131835523,657,0.5052988554472234,0.2161933022467147,0.2785078423060619
1260,Fulton,4129,42,1790,1054,4087,4129,1.0,0.010171954468394284,0.9898280455316057,1285,0.4335190118672802,0.2552676192782756,0.3112133688544442
1261,Fulton,2048,20,1025,621,2028,2048,1.0,0.009765625,0.990234375,402,0.50048828125,0.30322265625,0.1962890625
1262,Fulton,3481,48,1537,707,3433,3481,1.0,0.013789141051422005,0.986210858948578,1237,0.4415397874174088,0.20310255673656996,0.35535765584602125
1263,Fulton,2963,42,1039,452,2921,2963,1.0,0.014174822814714817,0.9858251771852852,1472,0.3506581167735403,0.15254809314883563,0.49679379007762403
1264,Fulton,2644,40,1081,228,2604,2644,1.0,0.015128593040847202,0.9848714069591528,1335,0.4088502269288956,0.08623298033282904,0.5049167927382754
1265,Fulton,3092,23,1306,1070,3069,3092,1.0,0.007438551099611902,0.9925614489003881,716,0.42238033635187583,0.3460543337645537,0.2315653298835705
1266,Fulton,3438,37,1444,1298,3401,3438,1.0,0.010762070971495055,0.9892379290285049,696,0.4200116346713205,0.3775450843513671,0.2024432809773124
1267,Fulton,1378,12,506,691,1366,1378,1.0,0.008708272859216255,0.9912917271407837,181,0.3671988388969521,0.5014513788098693,0.1313497822931785
1268,Fulton,960,4,363,517,956,960,1.0,0.004166666666666667,0.9958333333333333,80,0.378125,0.5385416666666667,0.08333333333333333
1269,Fulton,2356,29,1085,1079,2327,2356,1.0,0.01230899830220713,0.9876910016977929,192,0.4605263157894737,0.4579796264855688,0.08149405772495756
1270,Fulton,1962,19,891,956,1943,1962,1.0,0.009683995922528032,0.990316004077472,115,0.4541284403669725,0.4872579001019368,0.058613659531090725
1271,Fulton,3561,54,1265,737,3507,3561,1.0,0.015164279696714406,0.9848357203032856,1559,0.35523729289525413,0.20696433586071328,0.4377983712440326
1272,Fulton,2644,22,1099,971,2622,2644,1.0,0.00832072617246596,0.9916792738275341,574,0.41565809379727686,0.3672465960665658,0.21709531013615735
1273,Fulton,3593,29,1630,955,3564,3593,1.0,0.008071249652101308,0.9919287503478987,1008,0.45365989423879766,0.2657946006123017,0.28054550514890064
1274,Fulton,818,19,570,247,799,818,1.3262987012987013,0.023227383863080684,0.9767726161369193,1,0.6968215158924206,0.3019559902200489,0.0012224938875305623
1275,Fulton,5679,69,2310,914,5610,5679,1.0,0.012150026413100899,0.9878499735868991,2455,0.40676175382989965,0.16094382813875682,0.43229441803134355
1276,Fulton,2429,33,839,942,2396,2429,1.0,0.013585837793330589,0.9864141622066694,648,0.3454096335940716,0.3878139151914368,0.26677645121449156
1277,Fulton,658,8,338,318,650,658,1.0,0.0121580547112462,0.9878419452887538,2,0.513677811550152,0.48328267477203646,0.00303951367781155
1278,Fulton,1875,3,756,452,1872,1875,1.0,0.0016,0.9984,667,0.4032,0.24106666666666668,0.35573333333333335
1279,Fulton,2333,39,946,186,2294,2333,1.0,0.016716673810544362,0.9832833261894557,1201,0.405486498071153,0.07972567509644235,0.5147878268324046
1280,Fulton,4290,106,2098,595,4184,4290,1.0,0.02470862470862471,0.9752913752913753,1597,0.48904428904428904,0.1386946386946387,0.37226107226107225
1281,Fulton,399,5,175,7,394,399,1.0,0.012531328320802004,0.9874686716791979,217,0.43859649122807015,0.017543859649122806,0.543859649122807
1282,Fulton,2808,45,1601,67,2763,2808,1.0,0.016025641025641024,0.9839743589743589,1140,0.5701566951566952,0.02386039886039886,0.405982905982906
1283,Fulton,1763,24,949,48,1739,1763,1.0,0.013613159387407828,0.9863868406125922,766,0.5382870107770845,0.027226318774815655,0.43448667044809985
1284,Fulton,2776,45,1514,123,2731,2776,1.0,0.016210374639769452,0.9837896253602305,1139,0.5453890489913544,0.04430835734870317,0.41030259365994237
1285,Fulton,4238,69,1917,1029,4169,4238,1.0,0.016281264747522416,0.9837187352524775,1292,0.4523360075507315,0.24280320906087777,0.30486078338839073
1286,Fulton,4547,57,2228,538,4490,4547,1.0,0.012535737849131295,0.9874642621508687,1781,0.4899934022432373,0.11831977127776556,0.39168682647899716
1287,Fulton,1537,32,624,75,1505,1537,1.0,0.02081977878985036,0.9791802212101497,838,0.405985686402082,0.048796356538711776,0.5452179570592063
1288,Fulton,1096,18,563,35,1078,1096,1.0,0.016423357664233577,0.9835766423357665,498,0.5136861313868614,0.03193430656934307,0.4543795620437956
1289,Fulton,4938,73,2051,119,4865,4938,1.0,0.014783313082219522,0.9852166869177805,2768,0.4153503442689348,0.024098825435398947,0.5605508302956662
1290,Fulton,2530,50,1591,279,2480,2530,1.0,0.019762845849802372,0.9802371541501976,660,0.6288537549407115,0.11027667984189723,0.2608695652173913
1291,Fulton,2764,26,1724,72,2738,2764,1.0,0.009406657018813314,0.9905933429811867,968,0.6237337192474675,0.02604920405209841,0.35021707670043417
1292,Fulton,3211,47,2592,96,3164,3211,1.0,0.014637184677670508,0.9853628153223295,523,0.8072251635004671,0.02989722827779508,0.16287760822173777
1293,Fulton,2365,15,1153,52,2350,2365,1.0,0.006342494714587738,0.9936575052854123,1160,0.4875264270613108,0.021987315010570826,0.4904862579281184
1294,Fulton,4192,52,2117,121,4140,4192,1.0,0.012404580152671756,0.9875954198473282,1954,0.5050095419847328,0.028864503816793893,0.4661259541984733
1295,Fulton,910,24,569,31,886,910,1.0,0.026373626373626374,0.9736263736263736,310,0.6252747252747253,0.03406593406593406,0.34065934065934067
1296,Fulton,1009,10,638,31,999,1009,1.0,0.009910802775024777,0.9900891972249752,340,0.6323092170465807,0.030723488602576808,0.33696729435084244
1297,Fulton,1141,8,844,38,1133,1141,1.0,0.007011393514460999,0.992988606485539,259,0.7397020157756354,0.033304119193689745,0.22699386503067484
1298,Fulton,421,3,269,8,418,421,1.0,0.007125890736342043,0.9928741092636579,144,0.6389548693586699,0.019002375296912115,0.342042755344418
1299,Fulton,2237,32,1083,50,2205,2237,1.0,0.014304872597228431,0.9856951274027715,1104,0.4841305319624497,0.022351363433169423,0.4935181046043809
1300,Fulton,305,4,264,10,301,305,1.0,0.013114754098360656,0.9868852459016394,31,0.8655737704918033,0.03278688524590164,0.10163934426229508
1301,Fulton,994,11,479,24,983,994,1.0,0.011066398390342052,0.9889336016096579,491,0.4818913480885312,0.02414486921529175,0.4939637826961771
1302,Fulton,1285,7,972,47,1278,1285,1.0,0.005447470817120622,0.9945525291828794,266,0.756420233463035,0.036575875486381325,0.20700389105058364
1303,Fulton,2162,39,1531,70,2123,2162,1.0,0.018038852913968548,0.9819611470860314,561,0.7081406105457909,0.032377428307123035,0.25948196114708605
1304,Fulton,1287,7,720,31,1280,1287,1.0,0.005439005439005439,0.9945609945609946,536,0.5594405594405595,0.024087024087024088,0.41647241647241645
1305,Fulton,999,7,385,22,992,999,1.0,0.007007007007007007,0.992992992992993,592,0.38538538538538536,0.022022022022022022,0.5925925925925926
1306,Fulton,5452,71,2949,101,5381,5452,1.0,0.013022743947175348,0.9869772560528246,2402,0.5409024211298606,0.018525311812179018,0.4405722670579604
1307,Fulton,2592,23,2095,53,2569,2592,1.0,0.008873456790123456,0.9911265432098766,444,0.8082561728395061,0.02044753086419753,0.1712962962962963
1308,Fulton,1287,19,688,37,1268,1287,1.0,0.014763014763014764,0.9852369852369852,562,0.5345765345765345,0.028749028749028748,0.4366744366744367
1309,Fulton,922,16,581,24,906,922,1.0,0.01735357917570499,0.982646420824295,317,0.6301518438177874,0.026030368763557483,0.3438177874186551
1310,Fulton,3425,22,1988,64,3403,3425,1.0,0.006423357664233576,0.9935766423357664,1373,0.5804379562043795,0.018686131386861315,0.40087591240875914
1311,Fulton,2220,24,957,51,2196,2220,1.0,0.010810810810810811,0.9891891891891892,1212,0.43108108108108106,0.022972972972972974,0.5459459459459459
1312,Fulton,575,10,372,26,565,575,1.0,0.017391304347826087,0.9826086956521739,177,0.6469565217391304,0.04521739130434783,0.30782608695652175
1313,Fulton,1882,22,1068,36,1860,1882,1.0,0.011689691817215728,0.9883103081827843,778,0.5674814027630181,0.019128586609989374,0.41339001062699254
1314,Fulton,1723,34,1158,53,1689,1723,1.0,0.019733023795705164,0.9802669762042948,512,0.6720835751596054,0.030760301799187463,0.2971561230412072
1315,Fulton,3452,35,1770,70,3417,3452,1.0,0.010139049826187718,0.9898609501738123,1612,0.5127462340672074,0.020278099652375436,0.46697566628041715
1316,Fulton,2133,33,1440,70,2100,2133,1.0,0.015471167369901548,0.9845288326300985,623,0.6751054852320675,0.032817627754336616,0.29207688701359585
1317,Fulton,2012,12,1088,39,2000,2012,1.0,0.005964214711729622,0.9940357852882704,885,0.5407554671968191,0.019383697813121274,0.4398608349900596
1318,Fulton,2396,28,809,37,2368,2396,1.0,0.011686143572621035,0.988313856427379,1550,0.33764607679465775,0.015442404006677797,0.6469115191986644
1319,Fulton,4707,78,3034,199,4629,4707,1.0,0.0165710643722116,0.9834289356277884,1474,0.6445719141703845,0.04227745910346293,0.3131506267261525
1320,Fulton,1282,15,586,30,1267,1282,1.0,0.01170046801872075,0.9882995319812793,666,0.45709828393135726,0.0234009360374415,0.5195007800312013
1321,Fulton,1912,34,671,64,1878,1912,1.0,0.01778242677824268,0.9822175732217573,1177,0.35094142259414224,0.03347280334728033,0.6155857740585774
1322,Fulton,902,18,496,29,884,902,1.0,0.019955654101995565,0.9800443458980045,377,0.549889135254989,0.03215077605321508,0.417960088691796
1323,Fulton,820,16,431,25,804,820,1.0,0.01951219512195122,0.9804878048780488,364,0.525609756097561,0.03048780487804878,0.44390243902439025
1324,Fulton,1044,24,346,32,1020,1044,1.0,0.022988505747126436,0.9770114942528736,666,0.3314176245210728,0.03065134099616858,0.6379310344827587
1325,Fulton,2575,26,1389,43,2549,2575,1.0,0.010097087378640776,0.9899029126213592,1143,0.5394174757281553,0.016699029126213592,0.4438834951456311
1326,Fulton,928,0,491,22,928,928,1.0,0.0,1.0,415,0.5290948275862069,0.023706896551724137,0.44719827586206895
1327,Fulton,3122,43,1327,78,3079,3122,1.0,0.013773222293401666,0.9862267777065984,1717,0.4250480461242793,0.024983984625240232,0.5499679692504804
1328,Fulton,2966,40,1512,105,2926,2966,1.0,0.013486176668914362,0.9865138233310856,1349,0.5097774780849629,0.035401213755900204,0.4548213081591369
1329,Fulton,614,8,268,18,606,614,1.0,0.013029315960912053,0.9869706840390879,328,0.4364820846905538,0.029315960912052116,0.5342019543973942
1330,Fulton,2499,27,1312,69,2472,2499,1.0,0.010804321728691477,0.9891956782713085,1118,0.5250100040016007,0.027611044417767107,0.44737895158063223
1331,Fulton,862,17,402,18,845,862,1.0,0.019721577726218097,0.9802784222737819,442,0.46635730858468677,0.02088167053364269,0.5127610208816705
1332,Fulton,1936,29,996,40,1907,1936,1.0,0.014979338842975207,0.9850206611570248,900,0.5144628099173554,0.02066115702479339,0.46487603305785125
1333,Fulton,5584,42,2195,1864,5542,5584,1.0,0.007521489971346705,0.9924785100286533,1525,0.39308739255014324,0.333810888252149,0.27310171919770776
1334,Fulton,1650,26,486,400,1624,1650,1.0,0.01575757575757576,0.9842424242424243,764,0.29454545454545455,0.24242424242424243,0.463030303030303
1335,Fulton,2399,16,978,879,2383,2399,1.0,0.006669445602334306,0.9933305543976657,542,0.40766986244268444,0.36640266777824093,0.2259274697790746
1336,Fulton,1229,15,392,278,1214,1229,1.0,0.012205044751830757,0.9877949552481693,559,0.3189585028478438,0.22620016273393004,0.4548413344182262
1337,Fulton,3352,66,1291,1266,3286,3352,1.0,0.019689737470167064,0.9803102625298329,795,0.38514319809069214,0.3776849642004773,0.23717183770883055
1338,Fulton,2661,50,1000,778,2611,2661,1.0,0.018789928598271326,0.9812100714017287,883,0.37579857196542654,0.29237128898910186,0.33183013904547165
1339,Fulton,746,8,280,203,738,746,1.0,0.010723860589812333,0.9892761394101877,263,0.3753351206434316,0.27211796246648795,0.35254691689008044
1340,Fulton,1091,35,325,101,1056,1091,1.0,0.032080659945004586,0.9679193400549955,665,0.29789184234647115,0.0925756186984418,0.6095325389550871
1341,Fulton,1593,24,658,764,1569,1593,1.0,0.015065913370998116,0.9849340866290018,171,0.4130571249215317,0.4795982423101067,0.10734463276836158
1342,Fulton,518,3,193,205,515,518,1.0,0.005791505791505791,0.9942084942084942,120,0.37258687258687256,0.39575289575289574,0.23166023166023167
1343,Fulton,4605,21,1927,1857,4584,4605,1.0,0.004560260586319218,0.9954397394136808,821,0.41845819761129205,0.40325732899022804,0.17828447339847991
1344,Fulton,1788,9,694,888,1779,1788,1.0,0.0050335570469798654,0.9949664429530202,206,0.38814317673378074,0.4966442953020134,0.11521252796420582
1345,Fulton,4594,59,1464,1370,4535,4594,1.0,0.012842838484980409,0.9871571615150196,1760,0.31867653461036133,0.2982150631258163,0.38310840226382237
1346,Fulton,1889,33,768,755,1856,1889,1.0,0.017469560614081524,0.9825304393859184,366,0.4065643197458973,0.39968237162519854,0.1937533086289042
1347,Fulton,5233,47,1933,1508,5186,5233,1.0,0.008981463787502388,0.9910185362124976,1792,0.36938658513281103,0.28817122109688514,0.3424421937703038
1348,Fulton,1005,13,453,238,992,1005,1.0,0.012935323383084577,0.9870646766169154,314,0.4507462686567164,0.23681592039800994,0.3124378109452736
1349,Fulton,946,16,343,476,930,946,1.0,0.016913319238900635,0.9830866807610994,127,0.36257928118393234,0.5031712473572939,0.13424947145877378
1350,Fulton,1507,23,320,185,1484,1507,1.0,0.015262110152621102,0.9847378898473789,1002,0.21234240212342403,0.12276045122760451,0.6648971466489715
1351,Fulton,1953,34,406,201,1919,1953,1.0,0.017409114183307733,0.9825908858166923,1346,0.2078853046594982,0.10291858678955453,0.6891961085509473
1352,Fulton,2684,32,792,955,2652,2684,1.0,0.011922503725782414,0.9880774962742176,937,0.29508196721311475,0.35581222056631895,0.3491058122205663
1353,Fulton,3184,43,1419,1161,3141,3184,1.0,0.01350502512562814,0.9864949748743719,604,0.44566582914572866,0.3646356783919598,0.18969849246231155
1354,Fulton,340,0,150,61,340,340,1.0,0.0,1.0,129,0.4411764705882353,0.17941176470588235,0.37941176470588234
1355,Fulton,413,4,96,151,409,413,1.0,0.009685230024213076,0.9903147699757869,166,0.2324455205811138,0.36561743341404357,0.4019370460048426
1356,Fulton,410,21,98,208,389,410,1.0,0.05121951219512195,0.948780487804878,104,0.23902439024390243,0.5073170731707317,0.25365853658536586
1357,Fulton,803,6,345,321,797,803,1.0,0.007471980074719801,0.9925280199252802,137,0.42963885429638854,0.39975093399750933,0.1706102117061021
1358,Fulton,475,9,90,240,466,475,1.0,0.018947368421052633,0.9810526315789474,145,0.18947368421052632,0.5052631578947369,0.30526315789473685
1359,Fulton,1285,25,610,143,1260,1285,1.0,0.019455252918287938,0.980544747081712,532,0.47470817120622566,0.111284046692607,0.4140077821011673
1360,Fulton,1377,25,786,143,1352,1377,1.0,0.01815541031227306,0.9818445896877269,448,0.5708061002178649,0.10384894698620188,0.3253449527959332
1361,Fulton,416,4,188,64,412,416,1.0,0.009615384615384616,0.9903846153846154,164,0.4519230769230769,0.15384615384615385,0.3942307692307692
1362,Fulton,1338,16,586,80,1322,1338,1.0,0.01195814648729447,0.9880418535127056,672,0.43796711509715996,0.059790732436472344,0.5022421524663677
1364,Fulton,44,1,16,3,43,44,1.0,0.022727272727272728,0.9772727272727273,25,0.36363636363636365,0.06818181818181818,0.5681818181818182
1365,Fulton,1481,12,921,43,1469,1481,1.0,0.008102633355840648,0.9918973666441594,517,0.6218771100607697,0.02903443619176232,0.34908845374746794
1366,Fulton,144,5,72,5,139,144,1.0,0.034722222222222224,0.9652777777777778,67,0.5,0.034722222222222224,0.4652777777777778
1367,Fulton,658,5,214,14,653,658,1.0,0.007598784194528876,0.9924012158054711,430,0.3252279635258359,0.02127659574468085,0.6534954407294833
1368,Fulton,18,1,3,1,17,18,1.0,0.05555555555555555,0.9444444444444444,14,0.16666666666666666,0.05555555555555555,0.7777777777777778
1369,Fulton,227,0,71,1,227,227,1.0,0.0,1.0,155,0.31277533039647576,0.004405286343612335,0.6828193832599119
1370,Fulton,237,34,225,11,203,237,33.714285714285715,0.14345991561181434,0.8565400843881856,1,0.9493670886075949,0.046413502109704644,0.004219409282700422
1371,Fulton,42,0,41,1,42,42,1.2352941176470589,0.0,1.0,0,0.9761904761904762,0.023809523809523808,0.0
1372,Fulton,363,3,61,3,360,363,1.0,0.008264462809917356,0.9917355371900827,299,0.16804407713498623,0.008264462809917356,0.8236914600550964
1373,Fulton,459,3,106,7,456,459,1.0,0.006535947712418301,0.9934640522875817,346,0.23093681917211328,0.015250544662309368,0.7538126361655774
1374,Fulton,171,3,36,0,168,171,1.0,0.017543859649122806,0.9824561403508771,135,0.21052631578947367,0.0,0.7894736842105263
1375,Fulton,283,2,0,0,281,283,1.0,0.007067137809187279,0.9929328621908127,283,0.0,0.0,1.0
1376,Fulton,604,5,177,6,599,604,1.0,0.008278145695364239,0.9917218543046358,421,0.29304635761589404,0.009933774834437087,0.6970198675496688
1377,Fulton,3187,52,1462,168,3135,3187,1.0,0.01631628490743646,0.9836837150925636,1557,0.45873862566677126,0.052714151239410104,0.48854722309381865
1378,Fulton,3358,72,1591,146,3286,3358,1.0,0.02144133412745682,0.9785586658725431,1621,0.47379392495533057,0.043478260869565216,0.48272781417510424
1379,Fulton,2645,67,1042,70,2578,2645,1.0,0.025330812854442344,0.9746691871455576,1533,0.3939508506616257,0.026465028355387523,0.5795841209829867
1380,Fulton,1737,39,982,154,1698,1737,1.0,0.022452504317789293,0.9775474956822107,601,0.565342544617156,0.08865860679332183,0.3459988485895222
1381,Fulton,545,8,261,48,537,545,1.0,0.014678899082568808,0.9853211009174312,236,0.47889908256880737,0.08807339449541285,0.43302752293577984
1382,Fulton,492,11,233,12,481,492,1.0,0.022357723577235773,0.9776422764227642,247,0.4735772357723577,0.024390243902439025,0.5020325203252033
1383,Fulton,1495,18,697,52,1477,1495,1.0,0.012040133779264214,0.9879598662207358,746,0.4662207357859532,0.034782608695652174,0.49899665551839467
1384,Fulton,5136,58,2674,178,5078,5136,1.0,0.011292834890965732,0.9887071651090342,2284,0.5206386292834891,0.03465732087227414,0.4447040498442368
1385,Fulton,1419,11,1020,61,1408,1419,1.0,0.007751937984496124,0.9922480620155039,338,0.718816067653277,0.04298801973220578,0.23819591261451725
1386,Fulton,6955,76,2991,120,6879,6955,1.0,0.010927390366642703,0.9890726096333573,3844,0.43005032350826744,0.017253774263120056,0.5526959022286125
1387,Fulton,2626,37,1490,57,2589,2626,1.0,0.01408987052551409,0.9859101294744859,1079,0.5674028941355674,0.021706016755521706,0.41089108910891087
1388,Fulton,4306,64,2223,300,4242,4306,1.0,0.014862981885740827,0.9851370181142591,1783,0.516256386437529,0.06967022758941012,0.41407338597306087
1389,Fulton,7259,76,3246,361,7183,7259,1.0,0.010469761675161868,0.9895302383248381,3652,0.44716903154704507,0.04973136795701887,0.503099600495936
1390,Fulton,813,8,445,32,805,813,1.0,0.00984009840098401,0.990159901599016,336,0.5473554735547356,0.03936039360393604,0.4132841328413284
1391,Fulton,5057,160,1622,556,4897,5057,1.0,0.03163931184496737,0.9683606881550326,2879,0.32074352382835675,0.10994660866126162,0.5693098675103816
1392,Fulton,6380,39,2902,1573,6341,6380,1.0,0.006112852664576803,0.9938871473354232,1905,0.454858934169279,0.24655172413793103,0.29858934169278994
1393,Fulton,3786,19,1306,897,3767,3786,1.0,0.005018489170628632,0.9949815108293714,1583,0.3449550977284733,0.23692551505546752,0.4181193872160592
1394,Fulton,596,12,283,198,584,596,1.0,0.020134228187919462,0.9798657718120806,115,0.4748322147651007,0.33221476510067116,0.1929530201342282
1395,Fulton,1890,24,777,445,1866,1890,1.0,0.012698412698412698,0.9873015873015873,668,0.4111111111111111,0.23544973544973544,0.35343915343915344
1396,Fulton,4196,49,2118,1431,4147,4196,1.0,0.011677788369876072,0.9883222116301239,647,0.5047664442326025,0.34103908484270734,0.15419447092469019
1397,Fulton,417,7,149,80,410,417,1.0,0.016786570743405275,0.9832134292565947,188,0.35731414868105515,0.19184652278177458,0.45083932853717024
1398,Fulton,2939,37,1054,700,2902,2939,1.0,0.012589316093909493,0.9874106839060905,1185,0.3586253827832596,0.23817625042531473,0.4031983667914257
1399,Fulton,3379,17,1094,967,3362,3379,1.0,0.005031074282332051,0.9949689257176679,1318,0.3237644273453685,0.2861793430008878,0.3900562296537437
1400,Fulton,5264,49,2145,1403,5215,5264,1.0,0.009308510638297872,0.9906914893617021,1716,0.40748480243161095,0.2665273556231003,0.32598784194528874
1401,Fulton,3157,32,1267,1013,3125,3157,1.0,0.010136205258156478,0.9898637947418435,877,0.401330376940133,0.32087424770351597,0.27779537535635096
1402,Fulton,3616,34,1426,947,3582,3616,1.0,0.009402654867256638,0.9905973451327433,1243,0.39435840707964603,0.26189159292035397,0.34375
1403,Fulton,3127,43,1246,725,3084,3127,1.0,0.013751199232491206,0.9862488007675088,1156,0.3984649824112568,0.23185161496642148,0.3696834026223217
1404,Fulton,4178,31,1314,1364,4147,4178,1.0,0.007419818094782192,0.9925801819052178,1500,0.31450454763044516,0.32647199617041645,0.35902345619913834
1405,Fulton,2759,22,907,1328,2737,2759,1.0,0.007973903588256614,0.9920260964117433,524,0.3287422979340341,0.48133381660021746,0.18992388546574845
1406,Fulton,2181,22,768,1067,2159,2181,1.0,0.010087116001834021,0.989912883998166,346,0.35213204951856947,0.48922512608895,0.1586428243924805
1407,Fulton,275,1,76,156,274,275,1.0,0.0036363636363636364,0.9963636363636363,43,0.27636363636363637,0.5672727272727273,0.15636363636363637
1408,Fulton,2648,17,1042,1040,2631,2648,1.0,0.006419939577039275,0.9935800604229608,566,0.3935045317220544,0.39274924471299094,0.21374622356495468
1409,Fulton,1074,18,430,266,1056,1074,1.0,0.01675977653631285,0.9832402234636871,378,0.40037243947858475,0.24767225325884543,0.35195530726256985
1410,Fulton,2708,37,1108,976,2671,2708,1.0,0.013663220088626292,0.9863367799113737,624,0.4091580502215657,0.3604135893648449,0.23042836041358936
1411,Fulton,2645,35,1146,1151,2610,2645,1.0,0.013232514177693762,0.9867674858223062,348,0.4332703213610586,0.43516068052930057,0.13156899810964084
1412,Fulton,4216,73,1794,1362,4143,4216,1.0,0.017314990512333966,0.982685009487666,1060,0.42552182163187857,0.3230550284629981,0.2514231499051233
1413,Fulton,2612,29,1078,1236,2583,2612,1.0,0.01110260336906585,0.9888973966309341,298,0.4127105666156202,0.47320061255742724,0.11408882082695253
1414,Fulton,717,17,206,346,700,717,1.0,0.023709902370990237,0.9762900976290098,165,0.28730822873082285,0.4825662482566248,0.2301255230125523
1415,Fulton,2404,63,679,1397,2341,2404,1.0,0.0262063227953411,0.9737936772046589,328,0.28244592346089853,0.5811148086522463,0.13643926788685523
1416,Fulton,1680,22,568,960,1658,1680,1.0,0.013095238095238096,0.986904761904762,152,0.3380952380952381,0.5714285714285714,0.09047619047619047
1417,Fulton,3626,40,1178,2048,3586,3626,1.0,0.011031439602868174,0.9889685603971319,400,0.3248758963044677,0.5648097076668506,0.11031439602868175
1418,Fulton,3151,48,1075,1576,3103,3151,1.0,0.015233259282767376,0.9847667407172326,500,0.341161536020311,0.5001586797841955,0.1586797841954935
1419,Fulton,5071,81,1869,1794,4990,5071,1.0,0.015973180832183003,0.984026819167817,1408,0.3685663577203707,0.35377637546834945,0.27765726681127983
1420,Fulton,4668,96,939,446,4572,4668,1.0,0.02056555269922879,0.9794344473007712,3283,0.2011568123393316,0.09554413024850043,0.7032990574121679
1421,Fulton,3682,63,1431,774,3619,3682,1.0,0.017110266159695818,0.9828897338403042,1477,0.388647474198805,0.2102118413905486,0.4011406844106464
1422,Fulton,1591,21,476,841,1570,1591,1.0,0.013199245757385292,0.9868007542426147,274,0.29918290383406665,0.5285983658076682,0.17221873035826524
1423,Fulton,761,18,235,411,743,761,1.0,0.023653088042049936,0.9763469119579501,115,0.3088042049934297,0.5400788436268068,0.15111695137976347
1424,Fulton,470,13,189,180,457,470,1.0,0.027659574468085105,0.9723404255319149,101,0.4021276595744681,0.3829787234042553,0.2148936170212766
1425,Fulton,3415,62,1393,411,3353,3415,1.0,0.01815519765739385,0.9818448023426062,1611,0.40790629575402637,0.12035139092240117,0.47174231332357247
1426,Fulton,4707,66,1928,2276,4641,4707,1.0,0.014021669853409816,0.9859783301465902,503,0.4096027193541534,0.48353516039940514,0.10686212024644147
1427,Fulton,4001,39,1737,1523,3962,4001,1.0,0.009747563109222694,0.9902524368907774,741,0.43414146463384157,0.3806548362909273,0.18520369907523118
1428,Fulton,5934,123,2038,1347,5811,5934,1.0,0.020728008088978768,0.9792719919110212,2549,0.34344455679137176,0.2269969666329626,0.42955847657566565
1429,Fulton,1709,24,883,650,1685,1709,1.0,0.014043300175541252,0.9859566998244588,176,0.5166764189584553,0.38033937975424226,0.10298420128730251
1430,Fulton,4283,148,1220,615,4135,4283,1.0,0.03455521830492645,0.9654447816950735,2448,0.2848470698108802,0.1435909409292552,0.5715619892598646
1431,Fulton,3067,68,1335,934,2999,3067,1.0,0.022171503097489404,0.9778284969025106,798,0.43527877404629933,0.3045321160743397,0.26018910987936095
1432,Fulton,2710,117,754,145,2593,2710,1.0,0.04317343173431734,0.9568265682656827,1811,0.2782287822878229,0.05350553505535055,0.6682656826568266
1433,Fulton,1335,31,203,74,1304,1335,1.0,0.023220973782771534,0.9767790262172285,1058,0.15205992509363295,0.05543071161048689,0.7925093632958802
1434,Fulton,2492,34,823,1008,2458,2492,1.0,0.013643659711075442,0.9863563402889246,661,0.33025682182985555,0.4044943820224719,0.26524879614767255
1435,Fulton,5744,58,2132,3031,5686,5744,1.0,0.0100974930362117,0.9899025069637883,581,0.3711699164345404,0.5276810584958217,0.10114902506963788
1436,Fulton,3635,63,1347,1599,3572,3635,1.0,0.01733149931224209,0.9826685006877579,689,0.3705639614855571,0.43988995873452547,0.18954607977991747
1437,Fulton,2961,49,1154,900,2912,2961,1.0,0.016548463356973995,0.983451536643026,907,0.38973319824383656,0.303951367781155,0.30631543397500843
1438,Fulton,6246,88,2447,2667,6158,6246,1.0,0.01408901697086135,0.9859109830291386,1132,0.39177073326929235,0.42699327569644574,0.18123599103426194
1439,Fulton,3910,58,1583,1329,3852,3910,1.0,0.014833759590792838,0.9851662404092072,998,0.4048593350383632,0.33989769820971866,0.25524296675191815
1440,Fulton,1957,25,804,856,1932,1957,1.0,0.012774655084312723,0.9872253449156873,297,0.4108329075114972,0.43740419008686765,0.15176290240163515
1441,Fulton,3369,81,1351,765,3288,3369,1.0,0.02404274265360641,0.9759572573463936,1253,0.40100920154348474,0.22707034728406056,0.37192045117245476
1442,Fulton,1948,22,801,950,1926,1948,1.0,0.011293634496919919,0.9887063655030801,197,0.41119096509240244,0.48767967145790553,0.10112936344969199
1443,Fulton,2627,31,1119,1045,2596,2627,1.0,0.011800532927293491,0.9881994670727066,463,0.42596117244004567,0.39779215835553866,0.17624666920441567
1444,Fulton,3367,30,1186,1420,3337,3367,1.0,0.00891000891000891,0.9910899910899911,761,0.35224235224235223,0.42174042174042176,0.22601722601722601
1445,Fulton,5776,87,2040,1100,5689,5776,1.0,0.015062326869806094,0.9849376731301939,2636,0.35318559556786705,0.1904432132963989,0.45637119113573404
1446,Fulton,427,1,50,3,426,427,1.0,0.00234192037470726,0.9976580796252927,374,0.117096018735363,0.00702576112412178,0.8758782201405152
1447,Fulton,2027,31,1557,49,1996,2027,1.0,0.015293537247163296,0.9847064627528367,421,0.7681302417365565,0.024173655648741982,0.20769610261470153
1448,Fulton,2192,37,1599,60,2155,2192,1.0,0.01687956204379562,0.9831204379562044,533,0.729470802919708,0.02737226277372263,0.24315693430656934
1450,Fulton,1065,9,1031,33,1056,1065,1.2049830124575311,0.008450704225352112,0.9915492957746479,1,0.968075117370892,0.030985915492957747,0.0009389671361502347
1451,Fulton,1129,22,527,208,1107,1129,1.0,0.01948627103631532,0.9805137289636847,394,0.466784765279008,0.18423383525243578,0.3489813994685562
1452,Fulton,704,2,458,16,702,704,1.0,0.002840909090909091,0.9971590909090909,230,0.6505681818181818,0.022727272727272728,0.32670454545454547
1453,Fulton,3391,28,2443,93,3363,3391,1.0,0.008257151282807431,0.9917428487171925,855,0.7204364494249484,0.027425538189324684,0.2521380123857269
1454,Fulton,2911,20,1829,80,2891,2911,1.0,0.006870491240123669,0.9931295087598764,1002,0.6283064239093095,0.027481964960494674,0.3442116111301958
1455,Fulton,663,13,399,74,650,663,1.0,0.0196078431372549,0.9803921568627451,190,0.6018099547511312,0.11161387631975868,0.2865761689291101
1456,Fulton,6661,73,4088,413,6588,6661,1.0,0.01095931541810539,0.9890406845818946,2160,0.6137216634139018,0.06200270229695241,0.3242756342891458
1457,Fulton,12,0,11,1,12,12,1.0909090909090908,0.0,1.0,0,0.9166666666666666,0.08333333333333333,0.0
1458,Fulton,3637,39,2442,124,3598,3637,1.0,0.010723123453395655,0.9892768765466043,1071,0.6714324993126203,0.03409403354412978,0.29447346714324996
1459,Fulton,94,1,71,0,93,94,1.0,0.010638297872340425,0.9893617021276596,23,0.7553191489361702,0.0,0.24468085106382978
1460,Fulton,607,13,345,11,594,607,1.0,0.0214168039538715,0.9785831960461285,251,0.5683690280065898,0.018121911037891267,0.4135090609555189
1461,Fulton,760,15,413,17,745,760,1.0,0.019736842105263157,0.9802631578947368,330,0.5434210526315789,0.02236842105263158,0.4342105263157895
1462,Fulton,717,3,420,14,714,717,1.0,0.0041841004184100415,0.99581589958159,283,0.5857740585774058,0.019525801952580194,0.3947001394700139
1463,Fulton,13,1,3,0,12,13,1.0,0.07692307692307693,0.9230769230769231,10,0.23076923076923078,0.0,0.7692307692307693
1465,Fulton,1857,7,943,46,1850,1857,1.0,0.003769520732364028,0.996230479267636,868,0.5078082929456113,0.024771136241249325,0.4674205708131395
1466,Fulton,1840,23,1202,46,1817,1840,1.0,0.0125,0.9875,592,0.6532608695652173,0.025,0.3217391304347826
1467,Fulton,1655,12,998,54,1643,1655,1.0,0.0072507552870090634,0.992749244712991,603,0.6030211480362537,0.03262839879154079,0.36435045317220544
1468,Fulton,1633,29,768,49,1604,1633,1.0,0.017758726270667484,0.9822412737293326,816,0.47030006123698714,0.030006123698714023,0.49969381506429883
1469,Fulton,1479,9,960,44,1470,1479,1.0,0.006085192697768763,0.9939148073022313,475,0.6490872210953347,0.029749830966869506,0.3211629479377958
1470,Fulton,1512,9,959,51,1503,1512,1.0,0.005952380952380952,0.9940476190476191,502,0.6342592592592593,0.03373015873015873,0.33201058201058203
1471,Fulton,3086,52,1904,115,3034,3086,1.0,0.016850291639662993,0.983149708360337,1067,0.6169799092676604,0.037265068049254696,0.3457550226830849
1472,Fulton,1058,11,474,32,1047,1058,1.0,0.010396975425330813,0.9896030245746692,552,0.44801512287334594,0.030245746691871456,0.5217391304347826
1473,Fulton,327,6,46,14,321,327,1.0,0.01834862385321101,0.981651376146789,267,0.14067278287461774,0.04281345565749235,0.8165137614678899
1474,Fulton,6720,59,4595,216,6661,6720,1.0,0.008779761904761905,0.9912202380952381,1909,0.6837797619047619,0.03214285714285714,0.28407738095238094
1475,Fulton,4780,49,3600,108,4731,4780,1.0,0.010251046025104602,0.9897489539748954,1072,0.7531380753138075,0.022594142259414227,0.22426778242677825
1476,Fulton,17,0,16,1,17,17,1.7,0.0,1.0,0,0.9411764705882353,0.058823529411764705,0.0
1477,Fulton,72,0,43,1,72,72,1.0,0.0,1.0,28,0.5972222222222222,0.013888888888888888,0.3888888888888889
1478,Fulton,33,6,4,1,27,33,1.0,0.18181818181818182,0.8181818181818182,28,0.12121212121212122,0.030303030303030304,0.8484848484848485
1479,Fulton,1241,11,732,45,1230,1241,1.0,0.008863819500402902,0.9911361804995971,464,0.5898468976631749,0.0362610797743755,0.37389202256244963
1480,Fulton,985,10,380,13,975,985,1.0,0.01015228426395939,0.9898477157360406,592,0.38578680203045684,0.013197969543147208,0.601015228426396
1481,Fulton,888,9,654,24,879,888,1.0,0.010135135135135136,0.9898648648648649,210,0.7364864864864865,0.02702702702702703,0.23648648648648649
1482,Fulton,1876,17,1507,72,1859,1876,1.0,0.00906183368869936,0.9909381663113006,297,0.8033049040511727,0.03837953091684435,0.15831556503198294
1483,Fulton,208,4,134,7,204,208,1.0,0.019230769230769232,0.9807692307692307,67,0.6442307692307693,0.03365384615384615,0.32211538461538464
1484,Fulton,1839,32,786,37,1807,1839,1.0,0.017400761283306143,0.9825992387166939,1016,0.4274061990212072,0.02011963023382273,0.5524741707449701
1485,Fulton,2449,31,1964,55,2418,2449,1.0,0.012658227848101266,0.9873417721518988,430,0.8019599836668028,0.022458146182115148,0.17558187015108206
1486,Fulton,1937,17,1212,62,1920,1937,1.0,0.008776458440887971,0.9912235415591121,663,0.6257098606091894,0.03200826019617966,0.3422818791946309
1487,Fulton,4478,26,2537,176,4452,4478,1.0,0.005806163465832961,0.994193836534167,1765,0.5665475658776239,0.03930326038410004,0.394149173738276
1488,Fulton,3642,37,2085,90,3605,3642,1.0,0.010159253157605712,0.9898407468423943,1467,0.5724876441515651,0.02471169686985173,0.4028006589785832
1489,Fulton,492,2,334,22,490,492,1.0,0.0040650406504065045,0.9959349593495935,136,0.6788617886178862,0.044715447154471545,0.2764227642276423
1490,Fulton,2573,25,1467,68,2548,2573,1.0,0.00971628449280995,0.9902837155071901,1038,0.5701515740380878,0.026428293820443063,0.4034201321414691
1491,Fulton,2183,11,1342,62,2172,2183,1.0,0.005038937242327073,0.9949610627576729,779,0.6147503435639029,0.028401282638570773,0.3568483737975263
1492,Fulton,2799,38,1776,74,2761,2799,1.0,0.013576277241872096,0.986423722758128,949,0.6345123258306538,0.02643801357627724,0.33904966059306896
1493,Fulton,165,5,114,7,160,165,1.0,0.030303030303030304,0.9696969696969697,44,0.6909090909090909,0.04242424242424243,0.26666666666666666
1494,Fulton,1609,19,575,22,1590,1609,1.0,0.011808576755748913,0.9881914232442511,1012,0.3573648228713487,0.013673088875077687,0.6289620882535737
1495,Fulton,4441,52,1807,2038,4389,4441,1.0,0.011709074532762891,0.9882909254672371,596,0.4068903400135105,0.45890565188020715,0.13420400810628236
1496,Fulton,1286,10,564,331,1276,1286,1.0,0.007776049766718507,0.9922239502332815,391,0.4385692068429238,0.2573872472783826,0.30404354587869364
1497,Fulton,1615,32,684,231,1583,1615,1.0,0.019814241486068113,0.9801857585139319,700,0.4235294117647059,0.14303405572755418,0.43343653250773995
1498,Fulton,1787,32,741,473,1755,1787,1.0,0.01790710688304421,0.9820928931169558,573,0.41466144376049247,0.2646894236149972,0.32064913262451034
1499,Fulton,4324,70,1799,895,4254,4324,1.0,0.016188714153561518,0.9838112858464385,1630,0.416049953746531,0.20698427382053655,0.37696577243293244
1500,Fulton,1734,4,864,692,1730,1734,1.0,0.002306805074971165,0.9976931949250288,178,0.4982698961937716,0.3990772779700115,0.10265282583621683
1501,Fulton,1680,19,776,625,1661,1680,1.0,0.01130952380952381,0.9886904761904762,279,0.46190476190476193,0.37202380952380953,0.16607142857142856
1502,Fulton,1288,28,527,471,1260,1288,1.0,0.021739130434782608,0.9782608695652174,290,0.4091614906832298,0.3656832298136646,0.2251552795031056
1503,Fulton,1091,25,370,195,1066,1091,1.0,0.022914757103574702,0.9770852428964253,526,0.3391384051329056,0.17873510540788268,0.4821264894592117
1504,Fulton,989,8,299,230,981,989,1.0,0.008088978766430738,0.9919110212335692,460,0.3023255813953488,0.23255813953488372,0.46511627906976744
1505,Fulton,2569,28,911,381,2541,2569,1.0,0.010899182561307902,0.989100817438692,1277,0.3546126897625535,0.1483067341377968,0.4970805760996497
1506,Fulton,695,17,308,252,678,695,1.0,0.02446043165467626,0.9755395683453237,135,0.44316546762589926,0.36258992805755397,0.19424460431654678
1507,Fulton,949,5,345,152,944,949,1.0,0.005268703898840885,0.9947312961011591,452,0.3635405690200211,0.1601685985247629,0.47629083245521603
1508,Fulton,2644,14,717,310,2630,2644,1.0,0.00529500756429652,0.9947049924357034,1617,0.27118003025718607,0.1172465960665658,0.6115733736762481
1509,Fulton,2951,32,1300,1273,2919,2951,1.0,0.010843781768891902,0.9891562182311081,378,0.44052863436123346,0.43137919349373094,0.12809217214503557
1510,Fulton,3272,51,1545,1399,3221,3272,1.0,0.01558679706601467,0.9844132029339854,328,0.4721882640586797,0.4275672371638142,0.10024449877750612
1511,Fulton,5249,67,1785,936,5182,5249,1.0,0.012764336064012193,0.9872356639359878,2528,0.3400647742427129,0.178319679939036,0.4816155458182511
1512,Fulton,3026,71,655,235,2955,3026,1.0,0.023463317911434238,0.9765366820885658,2136,0.21645736946463978,0.07766027759418374,0.7058823529411765
1513,Fulton,812,20,161,33,792,812,1.0,0.024630541871921183,0.9753694581280788,618,0.19827586206896552,0.04064039408866995,0.7610837438423645
1514,Fulton,411,1,172,145,410,411,1.0,0.0024330900243309003,0.9975669099756691,94,0.41849148418491483,0.35279805352798055,0.22871046228710462
1515,Fulton,3098,34,1302,942,3064,3098,1.0,0.010974822466107165,0.9890251775338929,854,0.42027114267269206,0.3040671400903809,0.27566171723692706
1516,Fulton,2628,30,855,653,2598,2628,1.0,0.01141552511415525,0.9885844748858448,1120,0.3253424657534247,0.2484779299847793,0.426179604261796
1517,Fulton,1387,27,541,368,1360,1387,1.0,0.01946647440519106,0.9805335255948089,478,0.39005046863734677,0.2653208363374189,0.3446286950252343
1518,Fulton,1402,22,500,665,1380,1402,1.0,0.015691868758915834,0.9843081312410842,237,0.3566333808844508,0.4743223965763195,0.16904422253922968
1519,Fulton,3432,52,1273,238,3380,3432,1.0,0.015151515151515152,0.9848484848484849,1921,0.3709207459207459,0.06934731934731934,0.5597319347319347
1520,Fulton,2149,35,756,344,2114,2149,1.0,0.016286644951140065,0.9837133550488599,1049,0.3517915309446254,0.16007445323406236,0.4881340158213122
1521,Fulton,1837,25,905,833,1812,1837,1.0,0.013609145345672292,0.9863908546543277,99,0.492651061513337,0.45345672291780076,0.05389221556886228
1522,Fulton,3872,72,1471,1253,3800,3872,1.0,0.01859504132231405,0.981404958677686,1148,0.37990702479338845,0.32360537190082644,0.2964876033057851
1523,Fulton,592,4,297,247,588,592,1.0,0.006756756756756757,0.9932432432432432,48,0.5016891891891891,0.4172297297297297,0.08108108108108109
1524,Fulton,222,2,100,99,220,222,1.0,0.009009009009009009,0.990990990990991,23,0.45045045045045046,0.44594594594594594,0.1036036036036036
1525,Fulton,3850,90,1530,494,3760,3850,1.0,0.023376623376623377,0.9766233766233766,1826,0.3974025974025974,0.12831168831168832,0.4742857142857143
1526,Fulton,2438,26,1222,443,2412,2438,1.0,0.01066447908121411,0.9893355209187858,773,0.5012305168170632,0.18170631665299425,0.3170631665299426
1527,Fulton,3137,43,1059,449,3094,3137,1.0,0.013707363723302519,0.9862926362766975,1629,0.3375836786738923,0.14313037934332165,0.5192859419827861
1528,Fulton,3355,61,1082,691,3294,3355,1.0,0.01818181818181818,0.9818181818181818,1582,0.3225037257824143,0.20596125186289121,0.47153502235469447
1529,Fulton,5064,103,1791,382,4961,5064,1.0,0.020339652448657188,0.9796603475513428,2891,0.3536729857819905,0.07543443917851501,0.5708925750394944
1530,Fulton,4994,46,1316,729,4948,4994,1.0,0.0092110532639167,0.9907889467360833,2949,0.263516219463356,0.14597517020424508,0.5905086103323989
1531,Fulton,1902,33,777,504,1869,1902,1.0,0.017350157728706624,0.9826498422712934,621,0.4085173501577287,0.26498422712933756,0.3264984227129338
1532,Fulton,4481,46,1859,120,4435,4481,1.0,0.010265565721937068,0.989734434278063,2502,0.41486275384958715,0.026779736665922784,0.55835750948449
1533,Fulton,512,5,216,13,507,512,1.0,0.009765625,0.990234375,283,0.421875,0.025390625,0.552734375
1534,Fulton,16,4,0,0,12,16,1.0,0.25,0.75,16,0.0,0.0,1.0
1535,Fulton,561,5,374,19,556,561,1.0,0.008912655971479501,0.9910873440285205,168,0.6666666666666666,0.0338680926916221,0.2994652406417112
1536,Fulton,10182,117,5141,300,10065,10182,1.0,0.011490866234531527,0.9885091337654685,4741,0.5049106265959536,0.02946375957572186,0.4656256138283245
1537,Fulton,44,4,15,5,40,44,1.0,0.09090909090909091,0.9090909090909091,24,0.3409090909090909,0.11363636363636363,0.5454545454545454
1538,Fulton,3390,19,1223,265,3371,3390,1.0,0.005604719764011799,0.9943952802359882,1902,0.3607669616519174,0.07817109144542773,0.5610619469026549
1539,Fulton,503,6,230,37,497,503,1.0,0.011928429423459244,0.9880715705765407,236,0.4572564612326044,0.073558648111332,0.4691848906560636
1540,Gilmer,1808,60,205,917,1748,1808,1.0,0.033185840707964605,0.9668141592920354,686,0.11338495575221239,0.5071902654867256,0.37942477876106195
1541,Gilmer,1371,25,221,937,1346,1371,1.0,0.01823486506199854,0.9817651349380014,213,0.1611962071480671,0.6834427425237053,0.15536105032822758
1542,Gilmer,1637,31,170,1055,1606,1637,1.0,0.018937080024434942,0.981062919975565,412,0.10384850335980451,0.6444715943799634,0.2516799022602321
1543,Gilmer,1022,31,171,556,991,1022,1.0,0.030332681017612523,0.9696673189823874,295,0.16731898238747553,0.5440313111545988,0.28864970645792565
1544,Gilmer,1833,39,227,1013,1794,1833,1.0,0.02127659574468085,0.9787234042553191,593,0.12384069830878341,0.552645935624659,0.32351336606655756
1545,Gilmer,2186,122,215,1050,2064,2186,1.0,0.055809698078682524,0.9441903019213175,921,0.09835315645013723,0.48032936870997256,0.42131747483989024
1546,Gilmer,2074,70,270,1102,2004,2074,1.0,0.033751205400192864,0.9662487945998072,702,0.13018322082931533,0.5313404050144648,0.33847637415621984
1547,Gilmer,3783,95,504,1763,3688,3783,1.0,0.025112344699973567,0.9748876553000264,1516,0.13322759714512292,0.4660322495374042,0.4007401533174729
1548,Gilmer,3470,98,392,1748,3372,3470,1.0,0.02824207492795389,0.9717579250720461,1330,0.11296829971181556,0.5037463976945245,0.38328530259365995
1549,Gilmer,1272,45,136,715,1227,1272,1.0,0.03537735849056604,0.964622641509434,421,0.1069182389937107,0.5621069182389937,0.3309748427672956
1550,Gilmer,2264,91,164,1036,2173,2264,1.0,0.04019434628975265,0.9598056537102474,1064,0.07243816254416961,0.4575971731448763,0.46996466431095407
1551,Gilmer,1328,26,119,726,1302,1328,1.0,0.01957831325301205,0.9804216867469879,483,0.08960843373493976,0.5466867469879518,0.36370481927710846
1552,Gilmer,1383,62,138,811,1321,1383,1.0,0.04483007953723789,0.9551699204627621,434,0.09978308026030369,0.586406362979031,0.3138105567606652
1553,Glascock,129,4,11,109,125,129,1.0,0.031007751937984496,0.9689922480620154,9,0.08527131782945736,0.8449612403100775,0.06976744186046512
1554,Glascock,818,13,58,442,805,818,1.0,0.01589242053789731,0.9841075794621027,318,0.07090464547677261,0.5403422982885085,0.38875305623471884
1555,Glascock,815,17,38,554,798,815,1.0,0.020858895705521473,0.9791411042944785,223,0.046625766871165646,0.6797546012269938,0.27361963190184047
1556,Glascock,474,5,48,298,469,474,1.0,0.010548523206751054,0.989451476793249,128,0.10126582278481013,0.6286919831223629,0.270042194092827
1557,Glynn,4007,73,694,1289,3934,4007,1.0,0.018218118292987272,0.9817818817070127,2024,0.17319690541552282,0.32168704766658346,0.5051160469178937
1558,Glynn,2682,58,334,1462,2624,2682,1.0,0.02162565249813572,0.9783743475018642,886,0.12453392990305742,0.5451155853840418,0.3303504847129008
1559,Glynn,4031,55,1543,189,3976,4031,1.0,0.013644257008186554,0.9863557429918135,2299,0.38278342842967006,0.04688662862813198,0.570329942942198
1560,Glynn,3159,76,725,1530,3083,3159,1.0,0.0240582462804685,0.9759417537195315,904,0.22950300728078507,0.4843304843304843,0.2861665083887306
1561,Glynn,3091,84,579,1412,3007,3091,1.0,0.027175671303785183,0.9728243286962148,1100,0.1873180200582336,0.45681009382077,0.35587188612099646
1562,Glynn,3745,37,967,2089,3708,3745,1.0,0.009879839786381843,0.9901201602136182,689,0.2582109479305741,0.5578104138851803,0.18397863818424567
1563,Glynn,3668,36,857,553,3632,3668,1.0,0.009814612868047983,0.990185387131952,2258,0.23364231188658668,0.15076335877862596,0.6155943293347873
1564,Glynn,4256,50,1090,2312,4206,4256,1.0,0.011748120300751879,0.9882518796992481,854,0.25610902255639095,0.543233082706767,0.20065789473684212
1565,Glynn,3686,43,1160,639,3643,3686,1.0,0.01166576234400434,0.9883342376559957,1887,0.31470428648941945,0.17335865436787845,0.5119370591427022
1566,Glynn,817,14,277,343,803,817,1.0,0.017135862913096694,0.9828641370869033,197,0.3390452876376989,0.41982864137086906,0.24112607099143207
1567,Glynn,3330,95,665,1725,3235,3330,1.0,0.028528528528528527,0.9714714714714715,940,0.1996996996996997,0.5180180180180181,0.2822822822822823
1568,Glynn,3452,65,1193,787,3387,3452,1.0,0.018829663962920046,0.9811703360370799,1472,0.3455967555040556,0.2279837775202781,0.4264194669756663
1569,Glynn,2498,25,697,1665,2473,2498,1.0,0.010008006405124099,0.9899919935948759,136,0.2790232185748599,0.666533226581265,0.0544435548438751
1570,Glynn,2737,63,615,1427,2674,2737,1.0,0.023017902813299233,0.9769820971867008,695,0.2246985750822068,0.5213737668980636,0.2539276580197296
1571,Glynn,2243,48,382,908,2195,2243,1.0,0.02139991083370486,0.9786000891662952,953,0.17030762371823452,0.4048149799375836,0.4248773963441819
1572,Glynn,2157,42,465,194,2115,2157,1.0,0.019471488178025034,0.980528511821975,1498,0.21557719054242003,0.0899397311080204,0.6944830783495596
1573,Glynn,4167,46,1122,2399,4121,4167,1.0,0.011039116870650349,0.9889608831293496,646,0.26925845932325415,0.5757139428845692,0.15502759779217662
1574,Glynn,4308,135,835,1725,4173,4308,1.0,0.031337047353760444,0.9686629526462396,1748,0.19382544103992572,0.40041782729805014,0.40575673166202414
1575,Glynn,4961,137,736,2280,4824,4961,1.0,0.027615400120943358,0.9723845998790567,1945,0.14835718605119935,0.4595847611368676,0.39205805281193307
1576,Glynn,3473,76,943,688,3397,3473,1.0,0.021883098186006335,0.9781169018139937,1842,0.271523178807947,0.19809962568384681,0.5303771955082062
1577,Gordon,12115,389,1702,4233,11726,12115,1.0,0.032108955839867934,0.967891044160132,6180,0.1404869995872885,0.3494015683037557,0.5101114321089558
1578,Gordon,2213,82,148,1215,2131,2213,1.0,0.03705377315860822,0.9629462268413918,850,0.06687754179846363,0.5490284681427926,0.3840939900587438
1579,Gordon,8199,266,769,3227,7933,8199,1.0,0.032442980851323334,0.9675570191486766,4203,0.0937919258446152,0.39358458348579095,0.5126234906695939
1580,Gordon,2114,37,203,1097,2077,2114,1.0,0.01750236518448439,0.9824976348155157,814,0.09602649006622517,0.5189214758751183,0.38505203405865657
1581,Gordon,1649,60,116,790,1589,1649,1.0,0.036385688295936934,0.9636143117040631,743,0.0703456640388114,0.4790782292298363,0.45057610673135234
1582,Gordon,696,16,93,403,680,696,1.0,0.022988505747126436,0.9770114942528736,200,0.1336206896551724,0.5790229885057471,0.28735632183908044
1583,Gordon,1276,41,84,644,1235,1276,1.0,0.03213166144200627,0.9678683385579937,548,0.06583072100313479,0.5047021943573667,0.42946708463949845
1584,Gordon,2438,78,197,1118,2360,2438,1.0,0.03199343724364233,0.9680065627563577,1123,0.0808039376538146,0.4585726004922067,0.4606234618539787
1585,Gordon,3160,104,332,1703,3056,3160,1.0,0.03291139240506329,0.9670886075949368,1125,0.10506329113924051,0.5389240506329114,0.3560126582278481
1586,Gordon,1849,55,127,838,1794,1849,1.0,0.029745808545159545,0.9702541914548405,884,0.06868577609518658,0.45321795565170364,0.4780962682531098
1587,Gordon,6044,161,497,3246,5883,6044,1.0,0.026637988087359364,0.9733620119126406,2301,0.08223031105228326,0.5370615486432826,0.3807081403044342
1588,Gordon,1747,50,116,891,1697,1747,1.0,0.028620492272467088,0.9713795077275329,740,0.06639954207212365,0.5100171722953635,0.42358328563251285
1589,Grady,1185,19,104,513,1166,1185,1.0,0.016033755274261603,0.9839662447257383,568,0.08776371308016878,0.43291139240506327,0.47932489451476795
1590,Grady,3013,40,1269,298,2973,3013,1.0,0.013275804845668768,0.9867241951543312,1446,0.42117490872884167,0.09890474610023232,0.47992034517092597
1591,Grady,4026,120,740,985,3906,4026,1.0,0.029806259314456036,0.970193740685544,2301,0.18380526577247888,0.24465971187282662,0.5715350223546944
1592,Grady,574,13,119,242,561,574,1.0,0.02264808362369338,0.9773519163763066,213,0.2073170731707317,0.42160278745644597,0.3710801393728223
1593,Grady,1095,25,201,418,1070,1095,1.0,0.0228310502283105,0.9771689497716894,476,0.18356164383561643,0.3817351598173516,0.434703196347032
1594,Grady,406,7,46,196,399,406,1.0,0.017241379310344827,0.9827586206896551,164,0.11330049261083744,0.4827586206896552,0.4039408866995074
1595,Grady,1789,30,230,764,1759,1789,1.0,0.016769144773616546,0.9832308552263834,795,0.1285634432643935,0.427054220234768,0.44438233650083847
1596,Grady,1228,30,212,464,1198,1228,1.0,0.024429967426710098,0.9755700325732899,552,0.17263843648208468,0.3778501628664495,0.4495114006514658
1597,Grady,699,12,103,261,687,699,1.0,0.017167381974248927,0.9828326180257511,335,0.1473533619456366,0.37339055793991416,0.4792560801144492
1598,Grady,1023,37,62,473,986,1023,1.0,0.03616813294232649,0.9638318670576735,488,0.06060606060606061,0.46236559139784944,0.47702834799608995
1599,Grady,609,22,54,374,587,609,1.0,0.0361247947454844,0.9638752052545156,181,0.08866995073891626,0.6141215106732348,0.29720853858784896
1600,Grady,1444,32,195,640,1412,1444,1.0,0.0221606648199446,0.9778393351800554,609,0.13504155124653738,0.44321329639889195,0.42174515235457066
1601,Grady,2871,78,284,1406,2793,2871,1.0,0.027168234064785787,0.9728317659352143,1181,0.09892023685127134,0.4897248345524208,0.4113549285963079
1602,Greene,4920,56,1501,1287,4864,4920,1.0,0.011382113821138212,0.9886178861788618,2132,0.3050813008130081,0.26158536585365855,0.43333333333333335
1603,Greene,6772,66,1421,4689,6706,6772,1.0,0.009746012994683993,0.990253987005316,662,0.20983461311281748,0.6924099232132309,0.09775546367395156
1604,Greene,1064,10,368,338,1054,1064,1.0,0.009398496240601503,0.9906015037593985,358,0.3458646616541353,0.3176691729323308,0.33646616541353386
1605,Greene,2221,34,673,614,2187,2221,1.0,0.01530841963079694,0.984691580369203,934,0.3030166591625394,0.2764520486267447,0.4205312922107159
1606,Greene,381,4,125,140,377,381,1.0,0.010498687664041995,0.989501312335958,116,0.32808398950131235,0.3674540682414698,0.30446194225721784
1607,Gwinnett,2786,55,1041,1062,2731,2786,1.0,0.01974156496769562,0.9802584350323044,683,0.373653984206748,0.3811916726489591,0.24515434314429288
1608,Gwinnett,6147,82,2998,1179,6065,6147,1.0,0.013339840572637058,0.986660159427363,1970,0.4877175858142183,0.191800878477306,0.3204815357084757
1609,Gwinnett,6672,83,3086,1710,6589,6672,1.0,0.012440047961630696,0.9875599520383693,1876,0.46252997601918466,0.256294964028777,0.28117505995203834
1610,Gwinnett,4635,107,1922,1481,4528,4635,1.0,0.02308522114347357,0.9769147788565264,1232,0.4146709816612729,0.3195253505933118,0.2658036677454153
1611,Gwinnett,3859,107,1425,839,3752,3859,1.0,0.027727390515677637,0.9722726094843224,1595,0.36926664939103393,0.21741383778180876,0.4133195128271573
1612,Gwinnett,4908,99,2353,1003,4809,4908,1.0,0.020171149144254278,0.9798288508557457,1552,0.4794213528932355,0.20436022819885902,0.3162184189079055
1613,Gwinnett,6433,109,3216,1332,6324,6433,1.0,0.01694388310275144,0.9830561168972486,1885,0.49992227576558373,0.20705736048499923,0.2930203637494171
1614,Gwinnett,7075,110,3025,2229,6965,7075,1.0,0.015547703180212015,0.984452296819788,1821,0.4275618374558304,0.3150530035335689,0.2573851590106007
1615,Gwinnett,6328,156,2639,1408,6172,6328,1.0,0.02465233881163085,0.9753476611883691,2281,0.4170353982300885,0.2225031605562579,0.3604614412136536
1616,Gwinnett,4588,100,2274,960,4488,4588,1.0,0.021795989537925022,0.978204010462075,1354,0.495640802092415,0.2092414995640802,0.2951176983435048
1617,Gwinnett,4147,45,1697,1166,4102,4147,1.0,0.010851217747769471,0.9891487822522306,1284,0.40921147817699544,0.28116710875331563,0.30962141306968893
1618,Gwinnett,4094,140,1033,529,3954,4094,1.0,0.03419638495359062,0.9658036150464093,2532,0.25232046897899363,0.12921348314606743,0.618466047874939
1619,Gwinnett,8763,197,2589,1008,8566,8763,1.0,0.022480885541481227,0.9775191144585188,5166,0.2954467648065731,0.11502909962341663,0.5895241355700103
1620,Gwinnett,3104,58,1293,895,3046,3104,1.0,0.018685567010309278,0.9813144329896907,916,0.4165592783505155,0.28833762886597936,0.29510309278350516
1621,Gwinnett,2131,35,767,789,2096,2131,1.0,0.01642421398404505,0.983575786015955,575,0.3599249178789301,0.3702487095260441,0.2698263725950258
1622,Gwinnett,3219,99,873,564,3120,3219,1.0,0.03075489282385834,0.9692451071761417,1782,0.2712022367194781,0.17520969245107176,0.5535880708294502
1623,Gwinnett,2512,60,1008,876,2452,2512,1.0,0.02388535031847134,0.9761146496815286,628,0.4012738853503185,0.3487261146496815,0.25
1624,Gwinnett,3288,70,768,447,3218,3288,1.0,0.021289537712895375,0.9787104622871047,2073,0.23357664233576642,0.13594890510948904,0.6304744525547445
1625,Gwinnett,2810,42,1150,990,2768,2810,1.0,0.01494661921708185,0.9850533807829182,670,0.4092526690391459,0.35231316725978645,0.23843416370106763
1626,Gwinnett,5028,96,1514,551,4932,5028,1.0,0.01909307875894988,0.9809069212410502,2963,0.3011137629276054,0.10958631662688942,0.5892999204455052
1627,Gwinnett,2058,50,734,671,2008,2058,1.0,0.024295432458697766,0.9757045675413022,653,0.3566569484936832,0.326044703595724,0.3172983479105928
1628,Gwinnett,3175,54,1275,1169,3121,3175,1.0,0.01700787401574803,0.982992125984252,731,0.4015748031496063,0.3681889763779528,0.23023622047244094
1629,Gwinnett,2880,68,963,984,2812,2880,1.0,0.02361111111111111,0.9763888888888889,933,0.334375,0.3416666666666667,0.32395833333333335
1630,Gwinnett,2581,92,561,321,2489,2581,1.0,0.03564509879891515,0.9643549012010848,1699,0.2173576133281674,0.12437039907012785,0.6582719876017048
1631,Gwinnett,2050,43,652,626,2007,2050,1.0,0.020975609756097562,0.9790243902439024,772,0.3180487804878049,0.3053658536585366,0.37658536585365854
1632,Gwinnett,2701,75,762,949,2626,2701,1.0,0.027767493520918177,0.9722325064790818,990,0.28211773417252867,0.35135135135135137,0.36653091447611996
1633,Gwinnett,1645,44,531,639,1601,1645,1.0,0.026747720364741642,0.9732522796352584,475,0.32279635258358663,0.3884498480243161,0.2887537993920973
1634,Gwinnett,3288,71,1398,671,3217,3288,1.0,0.02159367396593674,0.9784063260340633,1219,0.4251824817518248,0.20407542579075424,0.3707420924574209
1635,Gwinnett,4122,106,1637,1167,4016,4122,1.0,0.025715672003881612,0.9742843279961184,1318,0.39713731198447355,0.2831149927219796,0.3197476952935468
1636,Gwinnett,3016,97,1287,1041,2919,3016,1.0,0.03216180371352785,0.9678381962864722,688,0.4267241379310345,0.34515915119363394,0.22811671087533156
1637,Gwinnett,1909,38,652,750,1871,1909,1.0,0.01990570979570456,0.9800942902042954,507,0.34154007333682557,0.392875851231011,0.26558407543216345
1638,Gwinnett,2925,48,1133,1209,2877,2925,1.0,0.01641025641025641,0.9835897435897436,583,0.38735042735042735,0.41333333333333333,0.19931623931623932
1639,Gwinnett,4518,93,1779,710,4425,4518,1.0,0.020584329349269587,0.9794156706507304,2029,0.3937583001328021,0.1571491810535635,0.4490925188136344
1640,Gwinnett,3921,68,1606,1123,3853,3921,1.0,0.01734251466462637,0.9826574853353737,1192,0.4095893904616169,0.28640652894669727,0.3040040805916858
1641,Gwinnett,3837,63,1592,953,3774,3837,1.0,0.01641907740422205,0.983580922595778,1292,0.4149074798019286,0.24837112327339067,0.3367213969246807
1642,Gwinnett,2845,50,1138,970,2795,2845,1.0,0.01757469244288225,0.9824253075571178,737,0.4,0.3409490333919156,0.25905096660808435
1643,Gwinnett,4362,77,1840,1126,4285,4362,1.0,0.017652453003209535,0.9823475469967905,1396,0.4218248509857863,0.2581384685923888,0.32003668042182487
1644,Gwinnett,3620,63,1647,1533,3557,3620,1.0,0.017403314917127072,0.9825966850828729,440,0.4549723756906077,0.4234806629834254,0.12154696132596685
1645,Gwinnett,2579,38,831,1128,2541,2579,1.0,0.014734393175649476,0.9852656068243505,620,0.32221791392012405,0.43737882900348973,0.24040325707638618
1646,Gwinnett,1562,30,589,521,1532,1562,1.0,0.019206145966709345,0.9807938540332907,452,0.37708066581306016,0.33354673495518566,0.2893725992317542
1647,Gwinnett,5268,99,1976,1391,5169,5268,1.0,0.01879271070615034,0.9812072892938497,1901,0.37509491268033407,0.2640470766894457,0.3608580106302202
1648,Gwinnett,5958,70,2301,1479,5888,5958,1.0,0.011748909029875798,0.9882510909701242,2178,0.3862034239677744,0.24823766364551864,0.36555891238670696
1649,Gwinnett,4566,60,1312,1145,4506,4566,1.0,0.013140604467805518,0.9868593955321945,2109,0.287341217696014,0.250766535260622,0.461892247043364
1650,Gwinnett,2850,72,887,680,2778,2850,1.0,0.02526315789473684,0.9747368421052631,1283,0.3112280701754386,0.23859649122807017,0.45017543859649123
1651,Gwinnett,8048,185,2076,1204,7863,8048,1.0,0.02298707753479125,0.9770129224652088,4768,0.25795228628230615,0.1496023856858847,0.5924453280318092
1652,Gwinnett,6435,90,2372,965,6345,6435,1.0,0.013986013986013986,0.986013986013986,3098,0.3686091686091686,0.14996114996114995,0.48142968142968146
1653,Gwinnett,9559,147,2872,868,9412,9559,1.0,0.015378177633643686,0.9846218223663563,5819,0.3004498378491474,0.09080447745580082,0.6087456846950517
1654,Gwinnett,3620,53,1146,1137,3567,3620,1.0,0.014640883977900553,0.9853591160220995,1337,0.3165745856353591,0.31408839779005526,0.3693370165745856
1655,Gwinnett,3503,29,1167,894,3474,3503,1.0,0.008278618327148159,0.9917213816728518,1442,0.3331430202683414,0.25520982015415355,0.411647159577505
1656,Gwinnett,5531,55,1986,1825,5476,5531,1.0,0.009943952269029109,0.9900560477309709,1720,0.35906707647803293,0.32995841619960226,0.31097450732236487
1657,Gwinnett,5055,136,1116,318,4919,5055,1.0,0.026904055390702276,0.9730959446092977,3621,0.22077151335311573,0.0629080118694362,0.7163204747774481
1658,Gwinnett,4894,86,1435,2326,4808,4894,1.0,0.017572537801389457,0.9824274621986105,1133,0.2932161830813241,0.4752758479771148,0.2315079689415611
1659,Gwinnett,5575,87,1560,2641,5488,5575,1.0,0.015605381165919283,0.9843946188340807,1374,0.27982062780269057,0.4737219730941704,0.24645739910313902
1660,Gwinnett,2875,41,891,1570,2834,2875,1.0,0.014260869565217391,0.9857391304347826,414,0.3099130434782609,0.5460869565217391,0.144
1661,Gwinnett,7373,149,2054,3387,7224,7373,1.0,0.020208870202088704,0.9797911297979113,1932,0.2785840227858402,0.45937881459378815,0.26203716262037163
1662,Gwinnett,3580,56,1396,1321,3524,3580,1.0,0.01564245810055866,0.9843575418994414,863,0.38994413407821227,0.36899441340782124,0.2410614525139665
1663,Gwinnett,3381,45,1549,742,3336,3381,1.0,0.013309671694764862,0.9866903283052352,1090,0.45814847678201714,0.2194616977225673,0.32238982549541556
1664,Gwinnett,2360,36,855,560,2324,2360,1.0,0.015254237288135594,0.9847457627118644,945,0.3622881355932203,0.23728813559322035,0.4004237288135593
1665,Gwinnett,3799,97,1807,537,3702,3799,1.0,0.025533035009212952,0.974466964990787,1455,0.4756514872334825,0.14135298762832324,0.38299552513819424
1666,Gwinnett,1952,40,746,604,1912,1952,1.0,0.020491803278688523,0.9795081967213115,602,0.382172131147541,0.3094262295081967,0.3084016393442623
1667,Gwinnett,4451,91,1622,1101,4360,4451,1.0,0.02044484385531341,0.9795551561446866,1728,0.364412491574927,0.24736014378791282,0.3882273646371602
1668,Gwinnett,4144,64,1443,1478,4080,4144,1.0,0.015444015444015444,0.9845559845559846,1223,0.3482142857142857,0.35666023166023164,0.2951254826254826
1669,Gwinnett,7228,157,2609,1217,7071,7228,1.0,0.02172108467072496,0.978278915329275,3402,0.36095738793580523,0.16837299391256225,0.47066961815163255
1670,Gwinnett,4865,77,1658,1355,4788,4865,1.0,0.015827338129496403,0.9841726618705036,1852,0.3408016443987667,0.27852004110996914,0.38067831449126416
1671,Gwinnett,6046,98,2190,1682,5948,6046,1.0,0.01620906384386371,0.9837909361561363,2174,0.3622229573271585,0.2782004631161098,0.3595765795567317
1672,Gwinnett,3605,67,1325,877,3538,3605,1.0,0.018585298196948683,0.9814147018030513,1403,0.36754507628294036,0.2432732316227462,0.38918169209431347
1673,Gwinnett,3270,93,1231,502,3177,3270,1.0,0.028440366972477066,0.9715596330275229,1537,0.3764525993883792,0.15351681957186544,0.47003058103975537
1674,Gwinnett,3185,43,1143,850,3142,3185,1.0,0.013500784929356358,0.9864992150706436,1192,0.35886970172684457,0.2668759811616955,0.37425431711145996
1675,Gwinnett,2516,35,1033,877,2481,2516,1.0,0.013910969793322734,0.9860890302066773,606,0.4105723370429253,0.3485691573926868,0.24085850556438793
1676,Gwinnett,7775,169,2782,2405,7606,7775,1.0,0.021736334405144695,0.9782636655948553,2588,0.3578135048231511,0.3093247588424437,0.33286173633440513
1677,Gwinnett,5378,124,1533,1919,5254,5378,1.0,0.023056898475269618,0.9769431015247304,1926,0.2850502045370026,0.35682409817776123,0.35812569728523613
1678,Gwinnett,2965,47,1069,1160,2918,2965,1.0,0.01585160202360877,0.9841483979763912,736,0.36053962900505904,0.3912310286677909,0.24822934232715008
1679,Gwinnett,6253,92,2110,1326,6161,6253,1.0,0.014712937789860867,0.9852870622101392,2817,0.33743802974572207,0.21205821205821207,0.45050375819606586
1680,Gwinnett,4774,80,1622,1883,4694,4774,1.0,0.016757436112274822,0.9832425638877251,1269,0.339757017176372,0.3944281524926686,0.2658148303309594
1681,Gwinnett,5088,89,1442,1566,4999,5088,1.0,0.017492138364779874,0.9825078616352201,2080,0.28341194968553457,0.30778301886792453,0.4088050314465409
1682,Gwinnett,3450,77,1058,1192,3373,3450,1.0,0.022318840579710144,0.9776811594202899,1200,0.30666666666666664,0.34550724637681157,0.34782608695652173
1683,Gwinnett,4509,106,1313,941,4403,4509,1.0,0.023508538478598358,0.9764914615214016,2255,0.29119538700377023,0.20869372366378355,0.5001108893324462
1684,Gwinnett,5865,96,2428,1056,5769,5865,1.0,0.016368286445012786,0.9836317135549872,2381,0.41398124467178177,0.18005115089514068,0.40596760443307756
1685,Gwinnett,5015,106,982,1174,4909,5015,1.0,0.021136590229312063,0.978863409770688,2859,0.19581256231306082,0.2340977068793619,0.5700897308075773
1686,Gwinnett,7394,168,2101,621,7226,7394,1.0,0.022721125236678387,0.9772788747633216,4672,0.2841493102515553,0.08398701649986476,0.63186367324858
1687,Gwinnett,2774,110,860,793,2664,2774,1.0,0.03965392934390771,0.9603460706560922,1121,0.31002162941600575,0.28586878154289835,0.4041095890410959
1688,Gwinnett,4459,77,2077,681,4382,4459,1.0,0.01726844583987441,0.9827315541601256,1701,0.46579950661583314,0.15272482619421396,0.3814756671899529
1689,Gwinnett,3619,109,1457,563,3510,3619,1.0,0.030118817352859907,0.9698811826471401,1599,0.4025974025974026,0.15556783641890023,0.4418347609836972
1690,Gwinnett,4554,95,1692,1429,4459,4554,1.0,0.020860781730346948,0.979139218269653,1433,0.3715415019762846,0.3137900746596399,0.3146684233640755
1691,Gwinnett,4795,94,1368,774,4701,4795,1.0,0.019603753910323252,0.9803962460896768,2653,0.28529718456725756,0.16141814389989573,0.5532846715328467
1692,Gwinnett,2662,64,1054,467,2598,2662,1.0,0.02404207362885049,0.9759579263711495,1141,0.3959429000751315,0.17543200601051842,0.4286250939143501
1693,Gwinnett,3348,90,1327,1139,3258,3348,1.0,0.026881720430107527,0.9731182795698925,882,0.3963560334528076,0.34020310633213857,0.26344086021505375
1694,Gwinnett,5449,87,2201,1258,5362,5449,1.0,0.015966232336208478,0.9840337676637915,1990,0.40392732611488347,0.2308680491833364,0.36520462470178017
1695,Gwinnett,8456,170,3651,1114,8286,8456,1.0,0.02010406811731315,0.9798959318826869,3691,0.4317644276253548,0.13174077578051088,0.4364947965941343
1696,Gwinnett,3344,91,994,609,3253,3344,1.0,0.02721291866028708,0.9727870813397129,1741,0.2972488038277512,0.1821172248803828,0.5206339712918661
1697,Gwinnett,5064,115,1521,516,4949,5064,1.0,0.022709320695102685,0.9772906793048973,3027,0.3003554502369668,0.1018957345971564,0.5977488151658767
1698,Gwinnett,4011,133,1301,654,3878,4011,1.0,0.03315881326352531,0.9668411867364747,2056,0.3243580154574919,0.1630516080777861,0.512590376464722
1699,Gwinnett,3264,92,1092,682,3172,3264,1.0,0.028186274509803922,0.9718137254901961,1490,0.33455882352941174,0.20894607843137256,0.4564950980392157
1700,Gwinnett,3730,143,1023,342,3587,3730,1.0,0.03833780160857909,0.9616621983914209,2365,0.2742627345844504,0.09168900804289544,0.6340482573726541
1701,Gwinnett,10153,177,2766,474,9976,10153,1.0,0.017433270954397714,0.9825667290456023,6913,0.2724317935585541,0.04668570865753964,0.6808824977839062
1702,Gwinnett,4372,100,1076,421,4272,4372,1.0,0.022872827081427266,0.9771271729185728,2875,0.24611161939615736,0.09629460201280879,0.6575937785910339
1703,Gwinnett,3413,135,1065,437,3278,3413,1.0,0.039554644008203924,0.960445355991796,1911,0.3120421916202754,0.12803984764137122,0.5599179607383533
1704,Gwinnett,6776,125,2161,1171,6651,6776,1.0,0.01844746162927981,0.9815525383707202,3444,0.31891971664698937,0.17281582054309327,0.5082644628099173
1705,Gwinnett,6129,137,1719,766,5992,6129,1.0,0.02235274922499592,0.977647250775004,3644,0.28046989720998533,0.1249796051558166,0.5945504976341981
1706,Gwinnett,6105,196,1948,514,5909,6105,1.0,0.03210483210483211,0.9678951678951679,3643,0.31908271908271907,0.08419328419328419,0.5967239967239967
1707,Gwinnett,7159,168,2690,892,6991,7159,1.0,0.023466964659868698,0.9765330353401313,3577,0.37575080318480236,0.12459840759882665,0.499650789216371
1708,Gwinnett,5132,168,1283,362,4964,5132,1.0,0.03273577552611068,0.9672642244738893,3487,0.25,0.0705378020265004,0.6794621979734996
1709,Gwinnett,2520,21,1041,1228,2499,2520,1.0,0.008333333333333333,0.9916666666666667,251,0.41309523809523807,0.4873015873015873,0.0996031746031746
1710,Gwinnett,7928,308,1447,532,7620,7928,1.0,0.03884964682139253,0.9611503531786074,5949,0.18251765893037336,0.06710393541876893,0.7503784056508577
1711,Gwinnett,2234,20,889,741,2214,2234,1.0,0.008952551477170993,0.991047448522829,604,0.39794091316025065,0.3316920322291853,0.270367054610564
1712,Gwinnett,4252,197,935,327,4055,4252,1.0,0.04633113828786453,0.9536688617121355,2990,0.21989651928504234,0.07690498588899342,0.7031984948259643
1713,Gwinnett,3777,96,1017,277,3681,3777,1.0,0.025416997617156472,0.9745830023828436,2483,0.2692613185067514,0.07333862854117024,0.6574000529520784
1714,Gwinnett,5104,198,1065,452,4906,5104,1.0,0.03879310344827586,0.9612068965517241,3587,0.20865987460815047,0.08855799373040753,0.702782131661442
1715,Gwinnett,4959,67,1980,1485,4892,4959,1.0,0.013510788465416415,0.9864892115345836,1494,0.3992740471869328,0.29945553539019965,0.30127041742286753
1716,Gwinnett,4011,91,1154,434,3920,4011,1.0,0.02268760907504363,0.9773123909249564,2423,0.28770880079780603,0.1082024432809773,0.6040887559212167
1717,Gwinnett,5990,232,1200,265,5758,5990,1.0,0.038731218697829715,0.9612687813021703,4525,0.2003338898163606,0.04424040066777963,0.7554257095158597
1718,Gwinnett,6610,195,1694,489,6415,6610,1.0,0.029500756429652043,0.970499243570348,4427,0.2562783661119516,0.07397881996974282,0.6697428139183056
1719,Gwinnett,2146,37,898,1089,2109,2146,1.0,0.017241379310344827,0.9827586206896551,159,0.418452935694315,0.5074557315936626,0.07409133271202237
1720,Gwinnett,2483,27,950,1265,2456,2483,1.0,0.010873942811115585,0.9891260571888845,268,0.38260169150221507,0.5094643576318969,0.10793395086588804
1721,Gwinnett,6102,128,1922,383,5974,6102,1.0,0.02097672894133071,0.9790232710586693,3797,0.31497869550966895,0.06276630612913799,0.622254998361193
1722,Gwinnett,6922,193,1461,480,6729,6922,1.0,0.027882114995665994,0.972117885004334,4981,0.2110661658480208,0.06934412019647501,0.7195897139555042
1723,Gwinnett,2524,44,972,649,2480,2524,1.0,0.017432646592709985,0.9825673534072901,903,0.38510301109350237,0.2571315372424723,0.35776545166402535
1724,Gwinnett,3625,124,939,192,3501,3625,1.0,0.03420689655172414,0.9657931034482758,2494,0.2590344827586207,0.05296551724137931,0.688
1725,Gwinnett,4903,140,1418,751,4763,4903,1.0,0.028553946563328575,0.9714460534366715,2734,0.2892106873342851,0.15317152763614114,0.5576177850295737
1726,Gwinnett,4923,134,1257,802,4789,4923,1.0,0.027219175299614057,0.972780824700386,2864,0.25533211456429006,0.1629087954499289,0.5817590899857811
1727,Gwinnett,2459,76,955,528,2383,2459,1.0,0.03090687271248475,0.9690931272875153,976,0.3883692557950386,0.21472143147620984,0.3969093127287515
1728,Gwinnett,2720,70,665,420,2650,2720,1.0,0.025735294117647058,0.9742647058823529,1635,0.24448529411764705,0.15441176470588236,0.6011029411764706
1729,Gwinnett,6182,172,1711,1069,6010,6182,1.0,0.02782271109673245,0.9721772889032676,3402,0.27677127143319313,0.1729213846651569,0.5503073439016499
1730,Gwinnett,3898,72,1509,1130,3826,3898,1.0,0.018471010774756286,0.9815289892252437,1259,0.38712160082093383,0.2898922524371473,0.32298614674191894
1731,Gwinnett,6502,247,1393,371,6255,6502,1.0,0.0379883112888342,0.9620116887111658,4738,0.21424177176253462,0.05705936634881575,0.7286988618886496
1732,Gwinnett,1721,26,722,873,1695,1721,1.0,0.015107495642068565,0.9848925043579314,126,0.41952353282975013,0.5072632190586868,0.07321324811156305
1733,Gwinnett,5876,103,1562,2851,5773,5876,1.0,0.017528931245745404,0.9824710687542546,1463,0.26582709326072157,0.48519400953029274,0.2489788972089857
1734,Gwinnett,3307,54,957,1391,3253,3307,1.0,0.016328999092833384,0.9836710009071666,959,0.2893861505896583,0.4206229210765044,0.28999092833383733
1735,Gwinnett,4857,85,1014,1383,4772,4857,1.0,0.017500514721021206,0.9824994852789788,2460,0.20877084620135886,0.28474366893143915,0.506485484867202
1736,Gwinnett,4068,66,1147,1531,4002,4068,1.0,0.016224188790560472,0.9837758112094396,1390,0.28195673549655853,0.37635201573254673,0.3416912487708948
1737,Gwinnett,6661,99,2112,1754,6562,6661,1.0,0.014862633238252515,0.9851373667617475,2795,0.3170695090827203,0.26332382525146375,0.41960666566581595
1738,Gwinnett,4148,72,2202,539,4076,4148,1.0,0.017357762777242044,0.982642237222758,1407,0.5308582449373191,0.12994214079074254,0.3391996142719383
1739,Gwinnett,4634,92,2082,642,4542,4634,1.0,0.01985325852395339,0.9801467414760466,1910,0.44928787224859734,0.13854121709106604,0.4121709106603366
1740,Gwinnett,5361,85,3055,664,5276,5361,1.0,0.015855250886028727,0.9841447491139713,1642,0.569856370080209,0.12385748927438911,0.306286140645402
1741,Gwinnett,3718,63,2008,648,3655,3718,1.0,0.01694459386767079,0.9830554061323292,1062,0.5400753093060785,0.17428725121032812,0.2856374394835933
1742,Gwinnett,5231,114,2311,620,5117,5231,1.0,0.021793156184285987,0.978206843815714,2300,0.44178933282355193,0.11852418275664309,0.439686484419805
1743,Gwinnett,5905,87,3370,747,5818,5905,1.0,0.014733276883996614,0.9852667231160034,1788,0.5707027942421676,0.12650296359017782,0.30279424216765455
1744,Gwinnett,6080,118,3251,712,5962,6080,1.0,0.019407894736842107,0.9805921052631579,2117,0.5347039473684211,0.11710526315789474,0.3481907894736842
1745,Gwinnett,6184,108,2139,2277,6076,6184,1.0,0.017464424320827943,0.982535575679172,1768,0.34589262613195343,0.36820827943078915,0.2858990944372574
1746,Gwinnett,5497,130,1758,1911,5367,5497,1.0,0.02364926323449154,0.9763507367655084,1828,0.3198108058941241,0.34764416954702565,0.33254502455885027
1747,Gwinnett,4941,92,1793,1836,4849,4941,1.0,0.01861971260878365,0.9813802873912163,1312,0.36288200769075085,0.37158469945355194,0.2655332928556972
1748,Gwinnett,6658,162,1389,1598,6496,6658,1.0,0.024331631120456592,0.9756683688795434,3671,0.2086212075698408,0.24001201562030638,0.5513667768098528
1749,Gwinnett,6821,187,1854,2087,6634,6821,1.0,0.027415334994868788,0.9725846650051312,2880,0.27180765283682745,0.30596686702829495,0.4222254801348776
1750,Gwinnett,5353,83,1595,2225,5270,5353,1.0,0.015505324117317393,0.9844946758826826,1533,0.29796375864001495,0.41565477302447223,0.2863814683355128
1751,Gwinnett,6042,151,1439,1796,5891,6042,1.0,0.02499172459450513,0.9750082754054948,2807,0.23816617014233699,0.29725256537570344,0.46458126448195963
1752,Gwinnett,4128,80,1238,1373,4048,4128,1.0,0.01937984496124031,0.9806201550387597,1517,0.2999031007751938,0.3326065891472868,0.36749031007751937
1753,Gwinnett,4976,85,1379,1568,4891,4976,1.0,0.017081993569131832,0.9829180064308681,2029,0.2771302250803859,0.31511254019292606,0.4077572347266881
1754,Gwinnett,3079,65,891,1316,3014,3079,1.0,0.02111075024358558,0.9788892497564144,872,0.28937966872361154,0.42741149723936345,0.283208834037025
1755,Gwinnett,2157,44,680,549,2113,2157,1.0,0.020398701900788133,0.9796012980992118,928,0.31525266573945293,0.2545201668984701,0.43022716736207695
1756,Gwinnett,5308,62,1818,1725,5246,5308,1.0,0.011680482290881688,0.9883195177091183,1765,0.3425018839487566,0.3249811605124341,0.33251695553880933
1757,Gwinnett,7152,100,2190,1859,7052,7152,1.0,0.013982102908277404,0.9860178970917226,3103,0.3062080536912752,0.25992729306487694,0.4338646532438479
1758,Gwinnett,4832,72,1627,2150,4760,4832,1.0,0.014900662251655629,0.9850993377483444,1055,0.3367135761589404,0.4449503311258278,0.2183360927152318
1759,Gwinnett,4562,57,1541,1832,4505,4562,1.0,0.012494519947391494,0.9875054800526085,1189,0.33779044278825077,0.40157825515124945,0.2606313020604998
1760,Gwinnett,4354,51,1550,1375,4303,4354,1.0,0.011713367018833257,0.9882866329811667,1429,0.35599448782728527,0.3158015617822692,0.3282039503904456
1761,Gwinnett,4547,37,1676,1233,4510,4547,1.0,0.008137233340664175,0.9918627666593358,1638,0.36859467780954475,0.271167802946998,0.3602375192434572
1762,Gwinnett,3744,45,1203,1876,3699,3744,1.0,0.01201923076923077,0.9879807692307693,665,0.3213141025641026,0.5010683760683761,0.17761752136752137
1763,Habersham,1544,24,250,1006,1520,1544,1.0,0.015544041450777202,0.9844559585492227,288,0.16191709844559585,0.6515544041450777,0.18652849740932642
1764,Habersham,1947,33,190,523,1914,1947,1.0,0.01694915254237288,0.9830508474576272,1234,0.09758602978941962,0.26861838726245507,0.6337955829481253
1765,Habersham,6514,208,522,3098,6306,6514,1.0,0.03193122505373042,0.9680687749462695,2894,0.08013509364445809,0.47559103469450414,0.44427387166103777
1766,Habersham,9971,268,1177,5752,9703,9971,1.0,0.026877946043526228,0.9731220539564738,3042,0.11804232273593421,0.5768729315013539,0.3050847457627119
1767,Habersham,7889,221,858,3267,7668,7889,1.0,0.0280136899480289,0.9719863100519711,3764,0.10875903156293573,0.4141209278742553,0.477120040562809
1768,Habersham,7020,133,455,2588,6887,7020,1.0,0.018945868945868947,0.9810541310541311,3977,0.06481481481481481,0.36866096866096865,0.5665242165242165
1769,Habersham,993,37,111,403,956,993,1.0,0.03726082578046324,0.9627391742195368,479,0.11178247734138973,0.40584088620342396,0.4823766364551863
1770,Hall,7050,157,1287,2913,6893,7050,1.0,0.02226950354609929,0.9777304964539008,2850,0.1825531914893617,0.41319148936170214,0.40425531914893614
1771,Hall,6531,183,987,1219,6348,6531,1.0,0.028020211299954065,0.971979788700046,4325,0.15112540192926044,0.18664829275761752,0.662226305313122
1772,Hall,3860,85,690,978,3775,3860,1.0,0.022020725388601035,0.977979274611399,2192,0.17875647668393782,0.2533678756476684,0.5678756476683938
1773,Hall,4352,89,720,2300,4263,4352,1.0,0.020450367647058824,0.9795496323529411,1332,0.16544117647058823,0.5284926470588235,0.30606617647058826
1774,Hall,4768,109,801,2424,4659,4768,1.0,0.02286073825503356,0.9771392617449665,1543,0.16799496644295303,0.5083892617449665,0.3236157718120805
1775,Hall,4203,87,693,1732,4116,4203,1.0,0.02069950035688794,0.979300499643112,1778,0.16488222698072805,0.4120866048060909,0.42303116821318104
1776,Hall,5923,166,1025,3154,5757,5923,1.0,0.028026338004389667,0.9719736619956103,1744,0.1730541955090326,0.5325004220834036,0.29444538240756374
1777,Hall,4181,111,572,2419,4070,4181,1.0,0.02654867256637168,0.9734513274336283,1190,0.13680937574742885,0.5785697201626405,0.2846209040899306
1778,Hall,5349,101,1005,2398,5248,5349,1.0,0.01888203402505141,0.9811179659749486,1946,0.1878855860908581,0.44830809497102264,0.36380631893811927
1779,Hall,7724,187,1178,2695,7537,7724,1.0,0.02421025375453133,0.9757897462454687,3851,0.1525116519937856,0.34891248058001034,0.498575867426204
1780,Hall,9789,454,1688,1787,9335,9789,1.0,0.04637858821125753,0.9536214117887425,6314,0.17243845132291347,0.1825518439064256,0.645009704770661
1781,Hall,5352,132,600,1870,5220,5352,1.0,0.02466367713004484,0.9753363228699552,2882,0.11210762331838565,0.34940209267563527,0.5384902840059791
1782,Hall,4100,137,353,2067,3963,4100,1.0,0.033414634146341465,0.9665853658536585,1680,0.08609756097560975,0.5041463414634146,0.4097560975609756
1783,Hall,3684,110,281,2428,3574,3684,1.0,0.02985884907709012,0.9701411509229099,975,0.07627578718783931,0.6590662323561346,0.26465798045602607
1784,Hall,3033,88,259,1924,2945,3033,1.0,0.029014177382129903,0.9709858226178701,850,0.08539399934058688,0.6343554236729311,0.28025057698648204
1785,Hall,6446,191,799,3391,6255,6446,1.0,0.029630778777536455,0.9703692212224635,2256,0.12395283896990382,0.5260626745268383,0.3499844865032578
1786,Hall,4064,89,598,2273,3975,4064,1.0,0.021899606299212598,0.9781003937007874,1193,0.14714566929133857,0.5593011811023622,0.2935531496062992
1787,Hall,3582,83,549,2054,3499,3582,1.0,0.0231714126186488,0.9768285873813513,979,0.15326633165829145,0.5734226689000559,0.2733109994416527
1788,Hall,4772,150,690,2514,4622,4772,1.0,0.03143336127409891,0.9685666387259011,1568,0.14459346186085498,0.5268231349538978,0.32858340318524726
1789,Hall,3799,73,761,2369,3726,3799,1.0,0.01921558304817057,0.9807844169518294,669,0.2003158725980521,0.6235851539878916,0.17609897341405634
1790,Hall,5369,109,1018,1691,5260,5369,1.0,0.020301732166138946,0.979698267833861,2660,0.1896070031663252,0.3149562302104675,0.4954367666232073
1791,Hall,4427,54,1400,269,4373,4427,1.0,0.012197876665913711,0.9878021233340862,2758,0.3162412468940592,0.06076349672464423,0.6229952563812966
1792,Hall,10177,381,1264,1217,9796,10177,1.0,0.03743735875012283,0.9625626412498772,7696,0.12420163112901642,0.11958337427532671,0.7562149945956569
1793,Hall,4582,152,753,952,4430,4582,1.0,0.03317328677433435,0.9668267132256656,2877,0.16433871671759057,0.20776953295504147,0.627891750327368
1794,Hall,2154,40,362,547,2114,2154,1.0,0.018570102135561744,0.9814298978644382,1245,0.1680594243268338,0.2539461467038069,0.5779944289693594
1795,Hall,1398,33,130,755,1365,1398,1.0,0.023605150214592276,0.9763948497854077,513,0.09298998569384835,0.5400572246065808,0.3669527896995708
1796,Hall,3910,94,407,2602,3816,3910,1.0,0.02404092071611253,0.9759590792838875,901,0.1040920716112532,0.6654731457800511,0.23043478260869565
1797,Hall,8296,146,1834,5056,8150,8296,1.0,0.01759884281581485,0.9824011571841852,1406,0.22107039537126327,0.609450337512054,0.16947926711668274
1798,Hall,3393,78,585,1825,3315,3393,1.0,0.022988505747126436,0.9770114942528736,983,0.1724137931034483,0.5378720895962276,0.2897141173003242
1799,Hall,4592,121,900,2390,4471,4592,1.0,0.026350174216027873,0.9736498257839721,1302,0.19599303135888502,0.5204703832752613,0.28353658536585363
1800,Hall,2984,58,842,1957,2926,2984,1.0,0.01943699731903485,0.9805630026809652,185,0.282171581769437,0.6558310991957105,0.06199731903485255
1801,Hancock,719,1,470,146,718,719,1.0,0.0013908205841446453,0.9986091794158554,103,0.6536856745479833,0.20305980528511822,0.14325452016689846
1802,Hancock,1166,28,382,408,1138,1166,1.0,0.024013722126929673,0.9759862778730704,376,0.3276157804459691,0.34991423670668953,0.32246998284734135
1803,Hancock,335,7,197,37,328,335,1.0,0.020895522388059702,0.9791044776119403,101,0.5880597014925373,0.11044776119402985,0.30149253731343284
1804,Hancock,656,15,381,96,641,656,1.0,0.022865853658536585,0.9771341463414634,179,0.5807926829268293,0.14634146341463414,0.2728658536585366
1805,Hancock,954,13,315,48,941,954,1.0,0.013626834381551363,0.9863731656184487,591,0.330188679245283,0.050314465408805034,0.6194968553459119
1806,Hancock,493,6,192,93,487,493,1.0,0.012170385395537525,0.9878296146044625,208,0.3894523326572008,0.18864097363083165,0.42190669371196754
1807,Hancock,144,1,84,26,143,144,1.0,0.006944444444444444,0.9930555555555556,34,0.5833333333333334,0.18055555555555555,0.2361111111111111
1808,Hancock,576,2,315,60,574,576,1.0,0.003472222222222222,0.9965277777777778,201,0.546875,0.10416666666666667,0.3489583333333333
1809,Hancock,422,3,88,130,419,422,1.0,0.0071090047393364926,0.9928909952606635,204,0.20853080568720378,0.3080568720379147,0.4834123222748815
1810,Hancock,2032,7,561,115,2025,2032,1.0,0.0034448818897637795,0.9965551181102362,1356,0.27608267716535434,0.056594488188976375,0.6673228346456693
1811,Haralson,1105,14,38,434,1091,1105,1.0,0.012669683257918552,0.9873303167420815,633,0.034389140271493215,0.3927601809954751,0.5728506787330316
1812,Haralson,6974,178,760,3798,6796,6974,1.0,0.025523372526527102,0.9744766274734729,2416,0.10897619730427302,0.5445942070547749,0.3464295956409521
1813,Haralson,2690,47,183,1452,2643,2690,1.0,0.017472118959107805,0.9825278810408922,1055,0.06802973977695168,0.5397769516728624,0.39219330855018586
1814,Haralson,1280,29,62,637,1251,1280,1.0,0.02265625,0.97734375,581,0.0484375,0.49765625,0.45390625
1815,Haralson,1771,30,90,1050,1741,1771,1.0,0.01693958215697346,0.9830604178430266,631,0.050818746470920384,0.5928853754940712,0.35629587803500845
1816,Haralson,428,14,12,209,414,428,1.0,0.03271028037383177,0.9672897196261683,207,0.028037383177570093,0.4883177570093458,0.48364485981308414
1817,Haralson,537,8,36,500,529,537,1.279236276849642,0.0148975791433892,0.9851024208566108,1,0.0670391061452514,0.931098696461825,0.00186219739292365
1818,Haralson,335,19,18,231,316,335,1.0,0.056716417910447764,0.9432835820895522,86,0.05373134328358209,0.6895522388059702,0.25671641791044775
1819,Haralson,2102,55,168,1104,2047,2102,1.0,0.026165556612749764,0.9738344433872502,830,0.07992388201712655,0.5252140818268316,0.3948620361560419
1820,Haralson,3600,74,300,1715,3526,3600,1.0,0.020555555555555556,0.9794444444444445,1585,0.08333333333333333,0.47638888888888886,0.44027777777777777
1821,Haralson,869,26,46,493,843,869,1.0,0.02991944764096663,0.9700805523590333,330,0.05293440736478711,0.567318757192175,0.379746835443038
1822,Haralson,1281,45,79,708,1236,1281,1.0,0.0351288056206089,0.9648711943793911,494,0.06167056986729118,0.5526932084309133,0.38563622170179546
1823,Harris,2859,72,580,1696,2787,2859,1.0,0.025183630640083946,0.974816369359916,583,0.20286813571178733,0.5932144106330884,0.20391745365512418
1824,Harris,4197,90,1018,2326,4107,4197,1.0,0.021443888491779844,0.9785561115082202,853,0.24255420538479866,0.5542053847986658,0.20324040981653563
1825,Harris,1691,18,452,730,1673,1691,1.0,0.010644589000591367,0.9893554109994086,509,0.267297457125961,0.43169722057953874,0.3010053222945003
1826,Harris,3027,61,718,1342,2966,3027,1.0,0.02015196564255038,0.9798480343574496,967,0.237198546415593,0.44334324413610837,0.31945820944829867
1827,Harris,2726,56,458,1556,2670,2726,1.0,0.020542920029347028,0.979457079970653,712,0.16801173881144535,0.5707997065297139,0.2611885546588408
1828,Harris,2852,68,424,1842,2784,2852,1.0,0.023842917251051893,0.9761570827489481,586,0.14866760168302945,0.6458625525946704,0.20546984572230015
1829,Harris,1271,34,149,704,1237,1271,1.0,0.02675059008654603,0.973249409913454,418,0.11723052714398112,0.5538945712037766,0.3288749016522423
1830,Harris,992,6,255,429,986,992,1.0,0.006048387096774193,0.9939516129032258,308,0.25705645161290325,0.4324596774193548,0.31048387096774194
1831,Harris,1831,56,210,1082,1775,1831,1.0,0.030584380120152924,0.969415619879847,539,0.11469142545057345,0.5909339158929546,0.2943746586564719
1832,Harris,905,21,179,422,884,905,1.0,0.023204419889502764,0.9767955801104973,304,0.19779005524861878,0.4662983425414365,0.33591160220994476
1833,Harris,2927,72,731,1392,2855,2927,1.0,0.02459856508370345,0.9754014349162965,804,0.24974376494704476,0.4755722582849334,0.27468397676802186
1834,Harris,1521,51,283,798,1470,1521,1.0,0.03353057199211045,0.9664694280078896,440,0.18606180144641682,0.52465483234714,0.2892833662064431
1835,Hart,1724,21,269,802,1703,1724,1.0,0.012180974477958236,0.9878190255220418,653,0.15603248259860789,0.4651972157772622,0.37877030162412995
1836,Hart,1715,20,180,816,1695,1715,1.0,0.011661807580174927,0.9883381924198251,719,0.10495626822157435,0.47580174927113705,0.4192419825072886
1837,Hart,1365,30,345,499,1335,1365,1.0,0.02197802197802198,0.978021978021978,521,0.25274725274725274,0.36556776556776555,0.38168498168498166
1838,Hart,2354,46,272,1118,2308,2354,1.0,0.01954120645709431,0.9804587935429057,964,0.11554800339847068,0.4749362786745964,0.40951571792693287
1839,Hart,8167,102,1451,3258,8065,8167,1.0,0.012489286151585649,0.9875107138484144,3458,0.17766621770539978,0.398922492959471,0.42341128933512917
1840,Hart,3228,62,453,1912,3166,3228,1.0,0.019206939281288724,0.9807930607187113,863,0.14033457249070633,0.5923172242874845,0.2673482032218092
1841,Hart,1883,55,187,1059,1828,1883,1.0,0.029208709506107277,0.9707912904938927,637,0.09930961232076474,0.5624004248539565,0.3382899628252788
1842,Heard,1886,66,186,1122,1820,1886,1.0,0.03499469777306469,0.9650053022269353,578,0.09862142099681867,0.5949098621420997,0.3064687168610817
1843,Heard,840,24,37,384,816,840,1.0,0.02857142857142857,0.9714285714285714,419,0.04404761904761905,0.45714285714285713,0.4988095238095238
1844,Heard,1237,31,83,644,1206,1237,1.0,0.025060630557801132,0.9749393694421988,510,0.06709781729991916,0.5206143896523848,0.412287793047696
1845,Heard,1464,36,82,852,1428,1464,1.0,0.02459016393442623,0.9754098360655737,530,0.056010928961748634,0.5819672131147541,0.3620218579234973
1846,Heard,2559,67,331,1139,2492,2559,1.0,0.02618210238374365,0.9738178976162564,1089,0.129347401328644,0.44509574052364204,0.42555685814771393
1847,Heard,712,21,105,375,691,712,1.0,0.02949438202247191,0.9705056179775281,232,0.14747191011235955,0.526685393258427,0.3258426966292135
1848,Henry,3348,49,1733,773,3299,3348,1.0,0.014635603345280765,0.9853643966547192,842,0.5176224611708483,0.23088410991636799,0.25149342891278376
1849,Henry,5444,127,1958,1324,5317,5444,1.0,0.023328434974283614,0.9766715650257164,2162,0.35966201322556945,0.2432035268185158,0.3971344599559148
1850,Henry,2850,33,1068,947,2817,2850,1.0,0.011578947368421053,0.988421052631579,835,0.37473684210526315,0.33228070175438595,0.2929824561403509
1851,Henry,3289,64,863,1838,3225,3289,1.0,0.01945880206749772,0.9805411979325023,588,0.26238978412891456,0.5588324718759501,0.1787777439951353
1852,Henry,4258,70,2685,491,4188,4258,1.0,0.016439643024894316,0.9835603569751057,1082,0.6305777360263034,0.11531235321747299,0.2541099107562236
1853,Henry,4483,44,2443,948,4439,4483,1.0,0.009814856123131831,0.9901851438768682,1092,0.544947579745706,0.2114655364711131,0.2435868837831809
1854,Henry,4345,94,1263,1471,4251,4345,1.0,0.021634062140391253,0.9783659378596088,1611,0.2906789413118527,0.3385500575373993,0.37077100115074796
1855,Henry,5225,94,2636,1221,5131,5225,1.0,0.01799043062200957,0.9820095693779904,1368,0.5044976076555024,0.2336842105263158,0.26181818181818184
1856,Henry,3242,69,1111,1633,3173,3242,1.0,0.021283158544108574,0.9787168414558914,498,0.3426896977174584,0.5037014188772363,0.15360888340530537
1857,Henry,4938,87,1589,2217,4851,4938,1.0,0.01761846901579587,0.9823815309842041,1132,0.32179019846091533,0.4489671931956258,0.2292426083434589
1858,Henry,4374,92,1483,1584,4282,4374,1.0,0.021033379058070414,0.9789666209419295,1307,0.33904892546867854,0.36213991769547327,0.2988111568358482
1859,Henry,3831,105,1755,918,3726,3831,1.0,0.0274079874706343,0.9725920125293657,1158,0.4581049334377447,0.23962411902897415,0.30227094753328115
1860,Henry,7011,101,3274,1504,6910,7011,1.0,0.014405933533019541,0.9855940664669804,2233,0.46698045927827697,0.21452003993724147,0.3184995007844815
1861,Henry,10208,185,4666,2064,10023,10208,1.0,0.018123040752351098,0.981876959247649,3478,0.45709247648902823,0.20219435736677116,0.3407131661442006
1862,Henry,3038,43,1451,522,2995,3038,1.0,0.014154048716260697,0.9858459512837393,1065,0.47761685319289005,0.1718235681369322,0.35055957867017773
1863,Henry,4520,75,1828,1166,4445,4520,1.0,0.016592920353982302,0.9834070796460177,1526,0.4044247787610619,0.2579646017699115,0.33761061946902654
1864,Henry,3673,95,969,1898,3578,3673,1.0,0.025864416008712223,0.9741355839912877,806,0.2638170432888647,0.5167438061530084,0.21943915055812688
1865,Henry,3653,73,784,1855,3580,3653,1.0,0.019983575143717493,0.9800164248562825,1014,0.2146181220914317,0.5078018067341911,0.2775800711743772
1866,Henry,5466,87,3201,782,5379,5466,1.0,0.015916575192096598,0.9840834248079035,1483,0.5856201975850713,0.14306622758873033,0.27131357482619833
1867,Henry,7573,146,2956,1887,7427,7573,1.0,0.01927901756239271,0.9807209824376073,2730,0.3903340816057045,0.249174699590651,0.36049121880364454
1868,Henry,4523,76,1819,1460,4447,4523,1.0,0.01680300685385806,0.983196993146142,1244,0.40216670351536593,0.32279460535043114,0.275038691134203
1869,Henry,5669,85,2194,1416,5584,5669,1.0,0.01499382607161757,0.9850061739283824,2059,0.387017110601517,0.24977950255777032,0.3632033868407126
1870,Henry,4104,74,1589,1579,4030,4104,1.0,0.018031189083820662,0.9819688109161794,936,0.3871832358674464,0.3847465886939571,0.22807017543859648
1871,Henry,5954,90,3420,618,5864,5954,1.0,0.015115888478333893,0.9848841115216661,1916,0.574403762176688,0.10379576755122606,0.32180047027208597
1872,Henry,4975,121,926,2666,4854,4975,1.0,0.024321608040201004,0.975678391959799,1383,0.18613065326633166,0.5358793969849246,0.2779899497487437
1873,Henry,4089,48,2567,347,4041,4089,1.0,0.01173881144534116,0.9882611885546588,1175,0.6277818537539741,0.08486182440694547,0.28735632183908044
1874,Henry,4156,55,1891,702,4101,4156,1.0,0.013233878729547642,0.9867661212704524,1563,0.45500481231953804,0.16891241578440808,0.3760827718960539
1875,Henry,5868,169,2074,1715,5699,5868,1.0,0.02880027266530334,0.9711997273346966,2079,0.3534423994546694,0.29226312201772325,0.35429447852760737
1876,Henry,3856,95,1453,931,3761,3856,1.0,0.024636929460580912,0.9753630705394191,1472,0.37681535269709543,0.24144190871369295,0.3817427385892116
1877,Henry,5535,122,2034,679,5413,5535,1.0,0.02204155374887082,0.9779584462511292,2822,0.367479674796748,0.12267389340560073,0.5098464317976513
1878,Henry,7334,110,3662,667,7224,7334,1.0,0.014998636487592037,0.985001363512408,3005,0.4993182437960185,0.09094627761112627,0.4097354785928552
1879,Henry,3785,85,1213,1299,3700,3785,1.0,0.022457067371202115,0.9775429326287979,1273,0.32047556142668426,0.34319682959048875,0.33632760898282693
1880,Henry,2105,32,684,956,2073,2105,1.0,0.015201900237529691,0.9847980997624703,465,0.32494061757719717,0.45415676959619955,0.2209026128266033
1881,Henry,3559,82,423,2112,3477,3559,1.0,0.02304017982579376,0.9769598201742062,1024,0.11885361056476539,0.5934251194155662,0.28772127001966846
1882,Henry,5082,110,1150,2486,4972,5082,1.0,0.021645021645021644,0.9783549783549783,1446,0.226288862652499,0.48917748917748916,0.2845336481700118
1883,Henry,6529,126,3288,916,6403,6529,1.0,0.01929851432072293,0.9807014856792771,2325,0.5035993260836269,0.1402971358554143,0.3561035380609588
1884,Henry,8172,120,3173,595,8052,8172,1.0,0.014684287812041116,0.9853157121879589,4404,0.38827704356338716,0.07280959373470387,0.5389133627019089
1885,Houston,5270,109,1221,2180,5161,5270,1.0,0.020683111954459203,0.9793168880455408,1869,0.2316888045540797,0.41366223908918404,0.35464895635673627
1886,Houston,10308,237,2685,4812,10071,10308,1.0,0.0229918509895227,0.9770081490104773,2811,0.26047729918509893,0.4668218859138533,0.27270081490104775
1887,Houston,9036,199,2353,3130,8837,9036,1.0,0.022023019034971225,0.9779769809650287,3553,0.26040283311199647,0.3463922089420097,0.3932049579459938
1888,Houston,5417,82,1374,2236,5335,5417,1.0,0.015137529998153959,0.984862470001846,1807,0.2536459294812627,0.412774598486247,0.33357947203249033
1889,Houston,9745,196,2983,3439,9549,9745,1.0,0.020112878399179066,0.9798871216008209,3323,0.3061056952283222,0.3528989225243715,0.3409953822473063
1890,Houston,1971,58,299,1083,1913,1971,1.0,0.029426686960933535,0.9705733130390665,589,0.15169964485032977,0.5494672754946728,0.29883307965499745
1891,Houston,7716,192,2022,1909,7524,7716,1.0,0.024883359253499222,0.9751166407465007,3785,0.2620528771384137,0.24740798341109382,0.4905391394504925
1892,Houston,1443,38,361,675,1405,1443,1.0,0.026334026334026334,0.9736659736659736,407,0.25017325017325015,0.4677754677754678,0.28205128205128205
1893,Houston,11867,272,3109,2821,11595,11867,1.0,0.02292070447459341,0.9770792955254066,5937,0.26198702283643716,0.23771804162804416,0.5002949355355186
1894,Houston,9711,163,2713,4203,9548,9711,1.0,0.0167850890742457,0.9832149109257543,2795,0.27937390587993,0.432808155699722,0.2878179384203481
1895,Houston,2794,65,676,1120,2729,2794,1.0,0.023264137437365783,0.9767358625626342,998,0.24194702934860415,0.4008589835361489,0.35719398711524697
1896,Houston,12536,273,3878,1087,12263,12536,1.0,0.021777281429483087,0.9782227185705169,7571,0.3093490746649649,0.08671027440970007,0.603940650925335
1897,Houston,15787,264,3554,6314,15523,15787,1.0,0.01672261987711408,0.9832773801228859,5919,0.2251219357699373,0.39994932539431177,0.37492873883575095
1898,Houston,6817,123,2098,1493,6694,6817,1.0,0.018043127475429074,0.981956872524571,3226,0.3077600117353675,0.2190112952911838,0.4732286929734487
1899,Houston,4848,74,1328,1868,4774,4848,1.0,0.015264026402640265,0.9847359735973598,1652,0.2739273927392739,0.38531353135313534,0.34075907590759075
1900,Houston,6852,165,1578,3164,6687,6852,1.0,0.024080560420315235,0.9759194395796847,2110,0.23029772329246936,0.46176298890834794,0.3079392877991827
1901,Irwin,749,15,97,430,734,749,1.0,0.020026702269692925,0.9799732977303071,222,0.1295060080106809,0.5740987983978638,0.2963951935914553
1902,Irwin,2004,51,104,1160,1953,2004,1.0,0.025449101796407185,0.9745508982035929,740,0.05189620758483034,0.5788423153692615,0.36926147704590817
1903,Irwin,4794,57,807,1544,4737,4794,1.0,0.011889862327909888,0.9881101376720901,2443,0.16833541927409262,0.3220692532332082,0.5095953274926992
1904,Jackson,17191,356,2429,9157,16835,17191,1.0,0.020708510267000175,0.9792914897329998,5605,0.1412948635914141,0.5326624396486533,0.3260426967599325
1905,Jackson,14909,347,1664,6920,14562,14909,1.0,0.023274532161781474,0.9767254678382186,6325,0.11161043664900396,0.4641491716412905,0.42424039170970557
1906,Jackson,8812,222,1266,4181,8590,8812,1.0,0.025192918747162958,0.974807081252837,3365,0.1436677258284158,0.4744666364049024,0.3818656377666818
1907,Jackson,15561,315,2283,9239,15246,15561,1.0,0.020242914979757085,0.979757085020243,4039,0.1467129361866204,0.5937279095173832,0.2595591542959964
1908,Jasper,4167,140,311,2597,4027,4167,1.0,0.033597312215022795,0.9664026877849772,1259,0.07463402927765779,0.623230141588673,0.3021358291336693
1909,Jasper,4783,75,1171,2161,4708,4783,1.0,0.015680535228935814,0.9843194647710641,1451,0.24482542337445118,0.4518084883964039,0.3033660882291449
1910,Jasper,2168,70,279,1064,2098,2168,1.0,0.03228782287822878,0.9677121771217713,825,0.128690036900369,0.4907749077490775,0.3805350553505535
1911,Jeff Davis,834,8,68,447,826,834,1.0,0.009592326139088728,0.9904076738609112,319,0.0815347721822542,0.5359712230215827,0.3824940047961631
1912,Jeff Davis,1410,23,43,913,1387,1410,1.0,0.016312056737588652,0.9836879432624114,454,0.03049645390070922,0.6475177304964539,0.3219858156028369
1913,Jeff Davis,1518,44,111,381,1474,1518,1.0,0.028985507246376812,0.9710144927536232,1026,0.07312252964426877,0.2509881422924901,0.6758893280632411
1914,Jeff Davis,840,23,24,493,817,840,1.0,0.02738095238095238,0.9726190476190476,323,0.02857142857142857,0.5869047619047619,0.38452380952380955
1915,Jeff Davis,2065,27,408,406,2038,2065,1.0,0.013075060532687652,0.9869249394673123,1251,0.19757869249394674,0.19661016949152543,0.6058111380145278
1916,Jeff Davis,1718,18,127,821,1700,1718,1.0,0.010477299185098952,0.989522700814901,770,0.0739231664726426,0.4778812572759022,0.4481955762514552
1917,Jeff Davis,466,2,66,280,464,466,1.0,0.004291845493562232,0.9957081545064378,120,0.14163090128755365,0.6008583690987125,0.2575107296137339
1918,Jeff Davis,1204,23,152,503,1181,1204,1.0,0.01910299003322259,0.9808970099667774,549,0.12624584717607973,0.41777408637873753,0.45598006644518274
1919,Jeff Davis,801,17,29,451,784,801,1.0,0.02122347066167291,0.978776529338327,321,0.03620474406991261,0.5630461922596754,0.40074906367041196
1920,Jefferson,435,24,50,232,411,435,1.0,0.05517241379310345,0.9448275862068966,153,0.11494252873563218,0.5333333333333333,0.35172413793103446
1921,Jefferson,494,1,169,184,493,494,1.0,0.0020242914979757085,0.9979757085020243,141,0.34210526315789475,0.3724696356275304,0.2854251012145749
1922,Jefferson,4478,34,1534,1078,4444,4478,1.0,0.007592675301473872,0.9924073246985261,1866,0.3425636444841447,0.24073246985261276,0.4167038856632425
1923,Jefferson,634,11,137,322,623,634,1.0,0.017350157728706624,0.9826498422712934,175,0.21608832807570977,0.5078864353312302,0.27602523659305994
1924,Jefferson,783,14,172,280,769,783,1.0,0.017879948914431672,0.9821200510855683,331,0.21966794380587484,0.35759897828863346,0.4227330779054917
1925,Jefferson,578,4,117,188,574,578,1.0,0.006920415224913495,0.9930795847750865,273,0.20242214532871972,0.32525951557093424,0.47231833910034604
1926,Jefferson,1830,10,854,371,1820,1830,1.0,0.00546448087431694,0.994535519125683,605,0.4666666666666667,0.20273224043715846,0.33060109289617484
1927,Jefferson,3069,17,1028,882,3052,3069,1.0,0.005539263603779733,0.9944607363962202,1159,0.3349625285109156,0.2873900293255132,0.3776474421635712
1928,Jenkins,1113,12,369,292,1101,1113,1.0,0.01078167115902965,0.9892183288409704,452,0.33153638814016173,0.26235399820305483,0.40610961365678344
1929,Jenkins,1395,12,245,488,1383,1395,1.0,0.008602150537634409,0.9913978494623656,662,0.17562724014336917,0.34982078853046594,0.4745519713261649
1930,Jenkins,914,13,376,242,901,914,1.0,0.014223194748358862,0.9857768052516411,296,0.4113785557986871,0.2647702407002188,0.3238512035010941
1931,Jenkins,1247,16,162,548,1231,1247,1.0,0.012830793905372895,0.9871692060946271,537,0.12991178829190056,0.43945469125902165,0.43063352044907777
1932,Jenkins,2336,16,114,591,2320,2336,1.0,0.00684931506849315,0.9931506849315068,1631,0.0488013698630137,0.2529965753424658,0.6982020547945206
1933,Johnson,830,7,156,460,823,830,1.0,0.008433734939759036,0.9915662650602409,214,0.18795180722891566,0.5542168674698795,0.25783132530120484
1934,Johnson,1018,23,53,617,995,1018,1.0,0.022593320235756387,0.9774066797642437,348,0.05206286836935167,0.6060903732809431,0.3418467583497053
1935,Johnson,943,15,61,522,928,943,1.0,0.015906680805938492,0.9840933191940615,360,0.06468716861081654,0.5535524920466596,0.38176033934252385
1936,Johnson,4683,36,952,1251,4647,4683,1.0,0.007687379884689302,0.9923126201153107,2480,0.20328849028400597,0.26713645099295324,0.5295750587230408
1937,Jones,1407,18,276,742,1389,1407,1.0,0.01279317697228145,0.9872068230277186,389,0.19616204690831557,0.527363184079602,0.27647476901208246
1938,Jones,2235,49,468,1316,2186,2235,1.0,0.02192393736017897,0.978076062639821,451,0.20939597315436242,0.5888143176733781,0.2017897091722595
1939,Jones,1699,33,190,960,1666,1699,1.0,0.01942319011183049,0.9805768098881695,549,0.11183048852266039,0.5650382577987051,0.3231312536786345
1940,Jones,2368,45,442,823,2323,2368,1.0,0.01900337837837838,0.9809966216216216,1103,0.1866554054054054,0.34755067567567566,0.4657939189189189
1941,Jones,2451,29,545,1441,2422,2451,1.0,0.011831905344757242,0.9881680946552428,465,0.22235822113423093,0.5879232966136271,0.189718482252142
1942,Jones,2740,34,511,1575,2706,2740,1.0,0.012408759124087591,0.9875912408759124,654,0.1864963503649635,0.5748175182481752,0.23868613138686132
1943,Jones,3169,68,1377,868,3101,3169,1.0,0.02145787314610287,0.9785421268538971,924,0.4345219312085831,0.2739034395708425,0.2915746292205743
1944,Jones,1909,29,445,921,1880,1909,1.0,0.015191199580932426,0.9848088004190676,543,0.23310633839706651,0.4824515453116815,0.284442116291252
1945,Jones,3369,38,604,1204,3331,3369,1.0,0.011279311368358563,0.9887206886316414,1561,0.1792816859602256,0.35737607598693977,0.46334223805283464
1946,Jones,228,1,30,115,227,228,1.0,0.0043859649122807015,0.9956140350877193,83,0.13157894736842105,0.5043859649122807,0.36403508771929827
1947,Lamar,2601,39,1013,482,2562,2601,1.0,0.014994232987312572,0.9850057670126874,1106,0.38946559015763166,0.18531334102268357,0.42522106881968474
1948,Lamar,1521,33,207,975,1488,1521,1.0,0.021696252465483234,0.9783037475345168,339,0.13609467455621302,0.6410256410256411,0.22287968441814596
1949,Lamar,3813,51,466,1546,3762,3813,1.0,0.013375295043273014,0.9866247049567269,1801,0.12221348019931812,0.4054550222921584,0.4723314975085235
1950,Lamar,4469,86,527,2368,4383,4469,1.0,0.019243678675318864,0.9807563213246812,1574,0.11792347281270978,0.5298724546878496,0.3522040724994406
1951,Lamar,608,7,80,389,601,608,1.0,0.011513157894736841,0.9884868421052632,139,0.13157894736842105,0.6398026315789473,0.22861842105263158
1952,Lamar,1529,20,322,570,1509,1529,1.0,0.013080444735120994,0.986919555264879,637,0.210595160235448,0.3727926749509483,0.41661216481360364
1953,Lanier,7326,149,1019,2509,7177,7326,1.0,0.02033852033852034,0.9796614796614797,3798,0.1390936390936391,0.34247884247884247,0.5184275184275184
1954,Laurens,2033,25,244,926,2008,2033,1.0,0.012297097884899164,0.9877029021151008,863,0.12001967535661584,0.45548450565666504,0.4244958189867191
1955,Laurens,1128,8,329,397,1120,1128,1.0,0.0070921985815602835,0.9929078014184397,402,0.2916666666666667,0.3519503546099291,0.35638297872340424
1956,Laurens,523,9,69,249,514,523,1.0,0.017208413001912046,0.982791586998088,205,0.13193116634799235,0.47609942638623326,0.3919694072657744
1957,Laurens,985,20,78,479,965,985,1.0,0.02030456852791878,0.9796954314720813,428,0.07918781725888324,0.4862944162436548,0.43451776649746193
1958,Laurens,7324,71,2447,849,7253,7324,1.0,0.009694156198798471,0.9903058438012016,4028,0.3341070453304205,0.1159202621518296,0.5499726925177498
1959,Laurens,1174,10,169,761,1164,1174,1.0,0.008517887563884156,0.9914821124361158,244,0.14395229982964225,0.6482112436115843,0.20783645655877342
1960,Laurens,4408,43,1142,1912,4365,4408,1.0,0.009754990925589837,0.9902450090744102,1354,0.2590744101633394,0.4337568058076225,0.30716878402903813
1961,Laurens,4177,55,756,2090,4122,4177,1.0,0.013167344984438592,0.9868326550155614,1331,0.18099114196791957,0.5003591094086665,0.31864974862341394
1962,Laurens,2044,43,188,1167,2001,2044,1.0,0.021037181996086105,0.9789628180039139,689,0.09197651663405088,0.5709393346379648,0.33708414872798437
1963,Laurens,412,4,124,161,408,412,1.0,0.009708737864077669,0.9902912621359223,127,0.30097087378640774,0.3907766990291262,0.308252427184466
1964,Laurens,2516,25,547,883,2491,2516,1.0,0.009936406995230525,0.9900635930047694,1086,0.21740858505564387,0.3509538950715421,0.431637519872814
1965,Laurens,1110,27,44,632,1083,1110,1.0,0.024324324324324326,0.9756756756756757,434,0.03963963963963964,0.5693693693693693,0.390990990990991
1966,Laurens,1023,38,104,583,985,1023,1.0,0.03714565004887586,0.9628543499511242,336,0.10166177908113393,0.5698924731182796,0.3284457478005865
1967,Laurens,2749,62,398,1199,2687,2749,1.0,0.022553655874863587,0.9774463441251364,1152,0.1447799199708985,0.4361586031284103,0.4190614769006912
1968,Laurens,4055,36,931,1040,4019,4055,1.0,0.008877928483353885,0.9911220715166461,2084,0.22959309494451294,0.2564734895191122,0.5139334155363748
1969,Laurens,2073,22,503,1165,2051,2073,1.0,0.010612638687891944,0.989387361312108,405,0.24264351181862034,0.5619874577906416,0.19536903039073805
1970,Lee,3256,59,777,1495,3197,3256,1.0,0.01812039312039312,0.9818796068796068,984,0.23863636363636365,0.45915233415233414,0.3022113022113022
1971,Lee,493,17,160,189,476,493,1.0,0.034482758620689655,0.9655172413793104,144,0.32454361054766734,0.38336713995943206,0.2920892494929006
1972,Lee,1592,22,65,425,1570,1592,1.0,0.013819095477386936,0.9861809045226131,1102,0.04082914572864322,0.26695979899497485,0.6922110552763819
1973,Lee,3792,48,941,2152,3744,3792,1.0,0.012658227848101266,0.9873417721518988,699,0.24815400843881857,0.5675105485232067,0.1843354430379747
1974,Lee,1459,25,177,808,1434,1459,1.0,0.017135023989033583,0.9828649760109665,474,0.12131596984235778,0.5538039753255655,0.32488005483207677
1975,Lee,3476,69,674,1558,3407,3476,1.0,0.019850402761795168,0.9801495972382048,1244,0.19390103567318756,0.4482163406214039,0.3578826237054085
1976,Lee,4873,93,725,2749,4780,4873,1.0,0.019084752719064232,0.9809152472809358,1399,0.14877898625076955,0.5641288733839523,0.2870921403652781
1977,Lee,1816,48,308,916,1768,1816,1.0,0.02643171806167401,0.973568281938326,592,0.1696035242290749,0.5044052863436124,0.32599118942731276
1978,Lee,1077,12,270,407,1065,1077,1.0,0.011142061281337047,0.9888579387186629,400,0.25069637883008355,0.3779015784586815,0.3714020427112349
1979,Lee,2831,55,461,1308,2776,2831,1.0,0.01942776404097492,0.9805722359590251,1062,0.16283998587071707,0.46202755210173085,0.3751324620275521
1980,Liberty,6759,169,317,221,6590,6759,1.0,0.025003698772007695,0.9749963012279923,6221,0.04690042905755289,0.03269714454801006,0.920402426394437
1981,Liberty,3646,107,633,1536,3539,3646,1.0,0.029347229840921557,0.9706527701590785,1477,0.17361492046077895,0.4212835984640702,0.40510148107515087
1982,Liberty,487,6,255,94,481,487,1.0,0.012320328542094456,0.9876796714579056,138,0.5236139630390144,0.19301848049281314,0.28336755646817247
1983,Liberty,4490,108,884,902,4382,4490,1.0,0.024053452115812918,0.9759465478841871,2704,0.19688195991091315,0.20089086859688196,0.602227171492205
1984,Liberty,2711,69,653,521,2642,2711,1.0,0.025451862781261526,0.9745481372187385,1537,0.24087052748063445,0.19218000737735152,0.566949465142014
1985,Liberty,3512,81,1110,440,3431,3512,1.0,0.02306378132118451,0.9769362186788155,1962,0.31605922551252846,0.1252847380410023,0.5586560364464692
1986,Liberty,5241,119,1818,1034,5122,5241,1.0,0.02270559053615722,0.9772944094638428,2389,0.34688036634230107,0.19729059339820645,0.45582904025949245
1987,Liberty,4558,89,1612,1388,4469,4558,1.0,0.01952610794207986,0.9804738920579201,1558,0.3536638876700307,0.3045195261079421,0.3418165862220272
1988,Liberty,5379,147,1820,612,5232,5379,1.0,0.027328499721137756,0.9726715002788623,2947,0.338352853690277,0.11377579475738984,0.5478713515523331
1989,Liberty,2971,44,830,219,2927,2971,1.0,0.014809828340626052,0.985190171659374,1922,0.279367216425446,0.07371255469538876,0.6469202288791652
1990,Liberty,1012,14,629,161,998,1012,1.0,0.01383399209486166,0.9861660079051383,222,0.6215415019762845,0.1590909090909091,0.21936758893280633
1991,Liberty,3124,56,1218,395,3068,3124,1.0,0.01792573623559539,0.9820742637644047,1511,0.38988476312419973,0.1264404609475032,0.48367477592829705
1992,Liberty,4124,125,1320,436,3999,4124,1.0,0.030310378273520854,0.9696896217264791,2368,0.3200775945683802,0.10572259941804074,0.574199806013579
1993,Lincoln,607,11,72,340,596,607,1.0,0.018121911037891267,0.9818780889621087,195,0.1186161449752883,0.5601317957166392,0.3212520593080725
1994,Lincoln,504,17,128,232,487,504,1.0,0.03373015873015873,0.9662698412698413,144,0.25396825396825395,0.4603174603174603,0.2857142857142857
1995,Lincoln,1542,36,262,859,1506,1542,1.0,0.023346303501945526,0.9766536964980544,421,0.16990920881971466,0.5570687418936446,0.2730220492866407
1996,Lincoln,757,17,348,230,740,757,1.0,0.022457067371202115,0.9775429326287979,179,0.45970937912813736,0.3038309114927345,0.23645970937912814
1997,Lincoln,1265,28,185,785,1237,1265,1.0,0.022134387351778657,0.9778656126482214,295,0.14624505928853754,0.6205533596837944,0.233201581027668
1998,Lincoln,636,29,130,303,607,636,1.0,0.04559748427672956,0.9544025157232704,203,0.20440251572327045,0.47641509433962265,0.3191823899371069
1999,Lincoln,959,10,310,430,949,959,1.0,0.010427528675703858,0.9895724713242962,219,0.3232533889468196,0.4483837330552659,0.2283628779979145
2000,Long,360,7,33,174,353,360,1.0,0.019444444444444445,0.9805555555555555,153,0.09166666666666666,0.48333333333333334,0.425
2001,Long,1883,63,336,516,1820,1883,1.0,0.03345724907063197,0.966542750929368,1031,0.17843866171003717,0.2740308019118428,0.54753053637812
2002,Long,1206,28,119,372,1178,1206,1.0,0.02321724709784411,0.9767827529021559,715,0.09867330016583747,0.30845771144278605,0.5928689883913765
2003,Long,2151,60,526,627,2091,2151,1.0,0.02789400278940028,0.9721059972105998,998,0.24453742445374244,0.2914923291492329,0.46397024639702467
2004,Long,3137,110,601,1060,3027,3137,1.0,0.035065349059611096,0.9649346509403889,1476,0.19158431622569333,0.3379024545744342,0.4705132291998725
2005,Long,1799,56,329,328,1743,1799,1.0,0.0311284046692607,0.9688715953307393,1142,0.1828793774319066,0.18232351306281266,0.6347971095052807
2006,Long,698,21,89,451,677,698,1.0,0.03008595988538682,0.9699140401146131,158,0.12750716332378223,0.6461318051575932,0.22636103151862463
2007,Lowndes,5203,94,806,2146,5109,5203,1.0,0.018066500096098406,0.9819334999039016,2251,0.15491062848356718,0.41245435325773594,0.4326350182586969
2008,Lowndes,4627,92,493,2415,4535,4627,1.0,0.01988329371082775,0.9801167062891722,1719,0.10654851955910957,0.5219364599092284,0.37151502053166197
2009,Lowndes,5993,134,854,3073,5859,5993,1.0,0.022359419322542966,0.9776405806774571,2066,0.14249958284665443,0.5127648923744369,0.34473552477890873
2010,Lowndes,5176,40,1835,303,5136,5176,1.0,0.0077279752704791345,0.9922720247295209,3038,0.3545208655332303,0.058539412673879444,0.5869397217928902
2011,Lowndes,1367,14,329,614,1353,1367,1.0,0.010241404535479151,0.9897585954645208,424,0.24067300658376006,0.4491587417702999,0.31016825164594003
2012,Lowndes,35040,605,9135,6911,34435,35040,1.0,0.017265981735159818,0.9827340182648402,18994,0.2607020547945205,0.19723173515981735,0.5420662100456621
2013,Lowndes,11865,200,2395,4096,11665,11865,1.0,0.01685630004214075,0.9831436999578592,5374,0.20185419300463547,0.34521702486304257,0.45292878213232196
2014,Lowndes,4293,96,624,2154,4197,4293,1.0,0.02236198462613557,0.9776380153738644,1515,0.1453529000698812,0.5017470300489169,0.352900069881202
2015,Lowndes,15467,329,3646,3979,15138,15467,1.0,0.021271093295403116,0.9787289067045969,7842,0.23572767828279562,0.2572573866942523,0.5070149350229521
2016,Lumpkin,27689,873,3126,12163,26816,27689,1.0,0.031528765935931236,0.9684712340640688,12400,0.1128968182310665,0.4392719130340568,0.44783126873487666
2017,Macon,1710,15,409,535,1695,1710,1.0,0.008771929824561403,0.9912280701754386,766,0.2391812865497076,0.3128654970760234,0.447953216374269
2018,Macon,1787,23,544,360,1764,1787,1.0,0.012870733072188025,0.987129266927812,883,0.30442081701175155,0.20145495243424735,0.4941242305540011
2019,Macon,1561,17,713,344,1544,1561,1.0,0.010890454836643177,0.9891095451633568,504,0.4567584881486227,0.22037155669442665,0.32286995515695066
2020,Macon,1647,11,680,191,1636,1647,1.0,0.006678809957498482,0.9933211900425015,776,0.41287188828172433,0.11596842744383729,0.4711596842744384
2021,Macon,3233,19,511,353,3214,3233,1.0,0.005876894525208784,0.9941231054747912,2369,0.15805753170429943,0.10918651407361583,0.7327559542220847
2022,Madison,3660,73,702,1664,3587,3660,1.0,0.01994535519125683,0.9800546448087432,1294,0.1918032786885246,0.4546448087431694,0.35355191256830604
2023,Madison,791,18,57,403,773,791,1.0,0.022756005056890013,0.97724399494311,331,0.07206068268015171,0.5094816687737042,0.41845764854614415
2024,Madison,1705,27,364,716,1678,1705,1.0,0.015835777126099706,0.9841642228739003,625,0.21348973607038124,0.419941348973607,0.36656891495601174
2025,Madison,3314,112,354,1784,3202,3314,1.0,0.03379601689800845,0.9662039831019915,1176,0.10681955340977671,0.5383222691611346,0.3548581774290887
2026,Madison,633,4,130,273,629,633,1.0,0.00631911532385466,0.9936808846761453,230,0.20537124802527645,0.4312796208530806,0.36334913112164297
2027,Madison,671,10,34,445,661,671,1.0,0.014903129657228018,0.9850968703427719,192,0.05067064083457526,0.6631892697466468,0.28614008941877794
2028,Madison,4981,130,990,1950,4851,4981,1.0,0.026099176872114032,0.973900823127886,2041,0.1987552700260992,0.3914876530817105,0.4097570768921903
2029,Madison,1948,35,168,1001,1913,1948,1.0,0.017967145790554414,0.9820328542094456,779,0.08624229979466119,0.5138603696098563,0.39989733059548255
2030,Madison,1857,36,178,1060,1821,1857,1.0,0.01938610662358643,0.9806138933764136,619,0.09585352719439957,0.5708131394722671,0.3333333333333333
2031,Madison,273,11,27,191,262,273,1.0,0.040293040293040296,0.9597069597069597,55,0.0989010989010989,0.6996336996336996,0.20146520146520147
2032,Madison,2090,52,292,1135,2038,2090,1.0,0.024880382775119617,0.9751196172248804,663,0.1397129186602871,0.5430622009569378,0.31722488038277513
2033,Madison,1189,26,115,704,1163,1189,1.0,0.021867115222876366,0.9781328847771237,370,0.09671993271656855,0.592094196804037,0.31118587047939444
2034,Marion,502,35,47,262,467,502,1.0,0.0697211155378486,0.9302788844621513,193,0.09362549800796813,0.5219123505976095,0.3844621513944223
2035,Marion,2840,34,1046,730,2806,2840,1.0,0.011971830985915493,0.9880281690140845,1064,0.3683098591549296,0.25704225352112675,0.37464788732394366
2036,Marion,1059,26,105,476,1033,1059,1.0,0.024551463644948063,0.9754485363550519,478,0.09915014164305949,0.449480642115203,0.4513692162417375
2037,Marion,1118,27,67,600,1091,1118,1.0,0.024150268336314847,0.9758497316636852,451,0.05992844364937388,0.5366726296958855,0.4033989266547406
2038,Marion,335,8,46,207,327,335,1.0,0.023880597014925373,0.9761194029850746,82,0.1373134328358209,0.6179104477611941,0.24477611940298508
2039,McDuffie,1307,12,583,157,1295,1307,1.0,0.009181331293037491,0.9908186687069626,567,0.44605967865340473,0.12012241775057383,0.4338179035960214
2040,McDuffie,1575,40,138,1025,1535,1575,1.0,0.025396825396825397,0.9746031746031746,412,0.08761904761904762,0.6507936507936508,0.2615873015873016
2041,McDuffie,1506,34,257,590,1472,1506,1.0,0.02257636122177955,0.9774236387782205,659,0.17065073041168657,0.39176626826029215,0.43758300132802125
2042,McDuffie,2230,43,327,1058,2187,2230,1.0,0.019282511210762333,0.9807174887892377,845,0.14663677130044844,0.4744394618834081,0.3789237668161435
2043,McDuffie,2089,21,813,511,2068,2089,1.0,0.010052656773575874,0.9899473432264241,765,0.389181426519866,0.24461464815701292,0.3662039253231211
2044,McDuffie,3330,52,718,1442,3278,3330,1.0,0.015615615615615615,0.9843843843843844,1170,0.21561561561561562,0.43303303303303303,0.35135135135135137
2045,McDuffie,2199,25,895,171,2174,2199,1.0,0.011368804001819008,0.988631195998181,1133,0.4070031832651205,0.07776261937244201,0.5152341973624375
2046,McDuffie,1332,9,176,766,1323,1332,1.0,0.006756756756756757,0.9932432432432432,390,0.13213213213213212,0.575075075075075,0.2927927927927928
2047,McDuffie,1047,13,261,449,1034,1047,1.0,0.012416427889207259,0.9875835721107927,337,0.2492836676217765,0.4288443170964661,0.3218720152817574
2048,McIntosh,1965,31,868,501,1934,1965,1.0,0.015776081424936386,0.9842239185750636,596,0.44173027989821884,0.2549618320610687,0.30330788804071246
2049,McIntosh,2303,52,654,1041,2251,2303,1.0,0.022579244463742945,0.9774207555362571,608,0.2839774207555363,0.45201910551454627,0.2640034737299175
2050,McIntosh,2042,49,528,943,1993,2042,1.0,0.023996082272282077,0.9760039177277179,571,0.25857002938295787,0.46180215475024483,0.27962781586679725
2051,McIntosh,100,5,32,10,95,100,1.0,0.05,0.95,58,0.32,0.1,0.58
2052,McIntosh,2108,39,414,1213,2069,2108,1.0,0.018500948766603416,0.9814990512333965,481,0.19639468690702086,0.575426944971537,0.22817836812144213
2053,McIntosh,522,9,116,308,513,522,1.0,0.017241379310344827,0.9827586206896551,98,0.2222222222222222,0.5900383141762452,0.18773946360153257
2054,Meriwether,1511,31,377,723,1480,1511,1.0,0.020516214427531435,0.9794837855724685,411,0.24950363997352745,0.4784910655195235,0.27200529450694905
2055,Meriwether,506,6,48,307,500,506,1.0,0.011857707509881422,0.9881422924901185,151,0.09486166007905138,0.6067193675889329,0.2984189723320158
2056,Meriwether,235,5,11,151,230,235,1.0,0.02127659574468085,0.9787234042553191,73,0.04680851063829787,0.6425531914893617,0.31063829787234043
2057,Meriwether,783,19,173,357,764,783,1.0,0.024265644955300127,0.9757343550446999,253,0.22094508301404853,0.4559386973180077,0.3231162196679438
2058,Meriwether,434,6,75,217,428,434,1.0,0.013824884792626729,0.9861751152073732,142,0.1728110599078341,0.5,0.3271889400921659
2059,Meriwether,2153,31,667,676,2122,2153,1.0,0.014398513701811427,0.9856014862981886,810,0.30980027868091037,0.31398049233627495,0.3762192289828147
2060,Meriwether,1339,14,409,492,1325,1339,1.0,0.010455563853622106,0.9895444361463779,438,0.3054518297236744,0.3674383868558626,0.32710978342046304
2061,Meriwether,2875,55,687,1186,2820,2875,1.0,0.019130434782608695,0.9808695652173913,1002,0.23895652173913043,0.4125217391304348,0.34852173913043477
2062,Meriwether,1969,22,422,761,1947,1969,1.0,0.0111731843575419,0.9888268156424581,786,0.2143219908583037,0.38649060436769933,0.39918740477399695
2063,Meriwether,1050,15,519,146,1035,1050,1.0,0.014285714285714285,0.9857142857142858,385,0.4942857142857143,0.13904761904761906,0.36666666666666664
2064,Meriwether,339,7,93,138,332,339,1.0,0.02064896755162242,0.9793510324483776,108,0.2743362831858407,0.40707964601769914,0.3185840707964602
2065,Meriwether,513,17,68,311,496,513,1.0,0.03313840155945419,0.9668615984405458,134,0.13255360623781676,0.6062378167641326,0.26120857699805067
2066,Meriwether,1386,22,279,546,1364,1386,1.0,0.015873015873015872,0.9841269841269841,561,0.2012987012987013,0.3939393939393939,0.40476190476190477
2067,Meriwether,1433,15,459,513,1418,1433,1.0,0.0104675505931612,0.9895324494068388,461,0.32030704815073274,0.35799023028611304,0.3217027215631542
2068,Miller,4749,48,749,2066,4701,4749,1.0,0.01010739102969046,0.9898926089703095,1934,0.15771741419246157,0.4350389555695936,0.40724363023794485
2069,Mitchell,1198,18,331,400,1180,1198,1.0,0.015025041736227046,0.9849749582637729,467,0.27629382303839733,0.333889816360601,0.38981636060100167
2070,Mitchell,702,7,82,385,695,702,1.0,0.009971509971509971,0.99002849002849,235,0.1168091168091168,0.5484330484330484,0.33475783475783477
2071,Mitchell,2167,7,1000,248,2160,2167,1.0,0.003230272265805261,0.9967697277341947,919,0.46146746654360865,0.11444393170281496,0.4240886017535764
2072,Mitchell,5600,39,1171,1197,5561,5600,1.0,0.0069642857142857145,0.9930357142857142,3232,0.20910714285714285,0.21375,0.5771428571428572
2073,Mitchell,485,5,28,288,480,485,1.0,0.010309278350515464,0.9896907216494846,169,0.0577319587628866,0.5938144329896907,0.34845360824742266
2074,Mitchell,154,5,13,99,149,154,1.0,0.032467532467532464,0.9675324675324676,42,0.08441558441558442,0.6428571428571429,0.2727272727272727
2075,Mitchell,370,3,40,213,367,370,1.0,0.008108108108108109,0.9918918918918919,117,0.10810810810810811,0.5756756756756757,0.3162162162162162
2076,Mitchell,1465,36,166,704,1429,1465,1.0,0.024573378839590442,0.9754266211604096,595,0.11331058020477816,0.4805460750853242,0.4061433447098976
2077,Mitchell,196,4,21,107,192,196,1.0,0.02040816326530612,0.9795918367346939,68,0.10714285714285714,0.5459183673469388,0.3469387755102041
2078,Mitchell,4342,28,1080,1080,4314,4342,1.0,0.006448641179180101,0.9935513588208199,2182,0.24873330262551818,0.24873330262551818,0.5025333947489636
2079,Mitchell,386,6,63,214,380,386,1.0,0.015544041450777202,0.9844559585492227,109,0.16321243523316062,0.5544041450777202,0.2823834196891192
2080,Monroe,2433,45,402,1458,2388,2433,1.0,0.018495684340320593,0.9815043156596794,573,0.16522811344019728,0.5992601726263872,0.23551171393341552
2081,Monroe,1020,18,136,796,1002,1020,1.0,0.01764705882352941,0.9823529411764705,88,0.13333333333333333,0.7803921568627451,0.08627450980392157
2082,Monroe,2095,17,366,1523,2078,2095,1.0,0.008114558472553698,0.9918854415274463,206,0.1747016706443914,0.7269689737470167,0.09832935560859188
2083,Monroe,843,23,152,415,820,843,1.0,0.027283511269276393,0.9727164887307236,276,0.18030842230130487,0.49228944246737844,0.3274021352313167
2084,Monroe,698,12,130,428,686,698,1.0,0.017191977077363897,0.9828080229226361,140,0.18624641833810887,0.6131805157593123,0.20057306590257878
2085,Monroe,476,20,113,214,456,476,1.0,0.04201680672268908,0.957983193277311,149,0.23739495798319327,0.4495798319327731,0.3130252100840336
2086,Monroe,1026,7,135,558,1019,1026,1.0,0.00682261208576998,0.99317738791423,333,0.13157894736842105,0.543859649122807,0.32456140350877194
2087,Monroe,1970,51,332,1274,1919,1970,1.0,0.025888324873096447,0.9741116751269036,364,0.16852791878172588,0.6467005076142132,0.1847715736040609
2088,Monroe,5711,79,1732,1334,5632,5711,1.0,0.0138329539485204,0.9861670460514796,2645,0.3032743827700928,0.23358431097881283,0.4631413062510944
2089,Monroe,2021,50,212,1069,1971,2021,1.0,0.024740227610094014,0.975259772389906,740,0.10489856506679862,0.52894606630381,0.3661553686293914
2090,Monroe,594,11,245,305,583,594,1.0,0.018518518518518517,0.9814814814814815,44,0.41245791245791247,0.5134680134680135,0.07407407407407407
2091,Monroe,1291,25,168,810,1266,1291,1.0,0.019364833462432222,0.9806351665375678,313,0.13013168086754454,0.627420604182804,0.24244771494965142
2092,Monroe,1266,32,200,600,1234,1266,1.0,0.02527646129541864,0.9747235387045814,466,0.1579778830963665,0.47393364928909953,0.36808846761453395
2093,Monroe,486,9,61,276,477,486,1.0,0.018518518518518517,0.9814814814814815,149,0.12551440329218108,0.5679012345679012,0.3065843621399177
2094,Montgomery,656,8,95,244,648,656,1.0,0.012195121951219513,0.9878048780487805,317,0.1448170731707317,0.3719512195121951,0.48323170731707316
2095,Montgomery,527,8,48,325,519,527,1.0,0.015180265654648957,0.9848197343453511,154,0.09108159392789374,0.6166982922201139,0.2922201138519924
2096,Montgomery,1511,24,217,769,1487,1511,1.0,0.01588352084712111,0.9841164791528789,525,0.14361350099272005,0.5089344804765056,0.34745201853077434
2097,Montgomery,504,9,35,369,495,504,1.0,0.017857142857142856,0.9821428571428571,100,0.06944444444444445,0.7321428571428571,0.1984126984126984
2098,Montgomery,2130,17,408,545,2113,2130,1.0,0.007981220657276996,0.992018779342723,1177,0.19154929577464788,0.25586854460093894,0.5525821596244131
2099,Montgomery,385,6,16,247,379,385,1.0,0.015584415584415584,0.9844155844155844,122,0.04155844155844156,0.6415584415584416,0.3168831168831169
2100,Montgomery,1079,22,160,461,1057,1079,1.0,0.020389249304911955,0.9796107506950881,458,0.14828544949026876,0.4272474513438369,0.42446709916589437
2101,Morgan,876,17,137,553,859,876,1.0,0.019406392694063926,0.980593607305936,186,0.15639269406392695,0.6312785388127854,0.21232876712328766
2102,Morgan,3157,51,628,1543,3106,3157,1.0,0.016154577130186885,0.9838454228698131,986,0.19892302819132088,0.48875514729173264,0.31232182451694646
2103,Morgan,720,15,94,502,705,720,1.0,0.020833333333333332,0.9791666666666666,124,0.13055555555555556,0.6972222222222222,0.17222222222222222
2104,Morgan,2311,53,395,1412,2258,2311,1.0,0.02293379489398529,0.9770662051060147,504,0.1709216789268715,0.6109909130246647,0.21808740804846388
2105,Morgan,2777,58,475,1602,2719,2777,1.0,0.020885848037450486,0.9791141519625495,700,0.17104789341015483,0.5768815268275117,0.25207057976233344
2106,Morgan,3069,43,1205,936,3026,3069,1.0,0.01401107852720756,0.9859889214727925,928,0.39263603779732814,0.30498533724340177,0.30237862495927015
2107,Morgan,2664,63,421,1682,2601,2664,1.0,0.02364864864864865,0.9763513513513513,561,0.15803303303303304,0.6313813813813813,0.21058558558558557
2108,Murray,2687,89,157,1227,2598,2687,1.0,0.03312244138444362,0.9668775586155564,1303,0.05842947525120953,0.45664309639002604,0.4849274283587644
2109,Murray,3518,103,238,1453,3415,3518,1.0,0.029277998862990335,0.9707220011370097,1827,0.06765207504263786,0.4130187606594656,0.5193291642978966
2110,Murray,2687,63,164,1358,2624,2687,1.0,0.023446222553033122,0.9765537774469669,1165,0.06103461109043543,0.5053963528098251,0.4335690360997395
2111,Murray,4077,90,341,1677,3987,4077,1.0,0.02207505518763797,0.977924944812362,2059,0.08363993132205053,0.41133186166298746,0.505028207014962
2112,Murray,4566,230,227,1757,4336,4566,1.0,0.05037231712658782,0.9496276828734121,2582,0.04971528690319755,0.3848007008322383,0.5654840122645641
2113,Murray,4952,189,473,2068,4763,4952,1.0,0.038166397415185786,0.9618336025848142,2411,0.09551696284329564,0.4176090468497577,0.48687399030694667
2114,Murray,7723,373,702,3403,7350,7723,1.0,0.04829729379774699,0.9517027062022531,3618,0.09089731969441926,0.44063187880357374,0.468470801502007
2115,Muscogee,3343,83,723,1031,3260,3343,1.0,0.024827998803469937,0.97517200119653,1589,0.21627280885432246,0.30840562369129526,0.4753215674543823
2116,Muscogee,4727,42,2227,122,4685,4727,1.0,0.008885127988153163,0.9911148720118469,2378,0.4711233340385022,0.025809181298921093,0.5030674846625767
2117,Muscogee,7054,167,1000,1118,6887,7054,1.0,0.02367451091579246,0.9763254890842076,4936,0.14176353841791892,0.15849163595123333,0.6997448256308477
2118,Muscogee,7990,187,1841,2640,7803,7990,1.0,0.023404255319148935,0.9765957446808511,3509,0.23041301627033792,0.3304130162703379,0.43917396745932413
2119,Muscogee,7369,81,2589,188,7288,7369,1.0,0.010991993486226082,0.989008006513774,4592,0.3513366806893744,0.02551228117790745,0.6231510381327181
2120,Muscogee,3702,80,1365,641,3622,3702,1.0,0.021609940572663425,0.9783900594273366,1696,0.3687196110210697,0.1731496488384657,0.4581307401404646
2121,Muscogee,6144,171,1183,1320,5973,6144,1.0,0.02783203125,0.97216796875,3641,0.19254557291666666,0.21484375,0.5926106770833334
2122,Muscogee,4469,56,2567,227,4413,4469,1.0,0.012530767509509957,0.98746923249049,1675,0.5744014320877153,0.05079436115462072,0.3748042067576639
2123,Muscogee,2920,49,668,238,2871,2920,1.0,0.01678082191780822,0.9832191780821918,2014,0.22876712328767124,0.08150684931506849,0.6897260273972603
2124,Muscogee,9741,138,3286,664,9603,9741,1.0,0.014166923313828149,0.9858330766861718,5791,0.33733702905245866,0.06816548608972385,0.5944974848578175
2125,Muscogee,7688,184,1865,1670,7504,7688,1.0,0.023933402705515087,0.9760665972944849,4153,0.24258584807492195,0.2172216441207076,0.5401925078043704
2126,Muscogee,3955,77,1014,382,3878,3955,1.0,0.019469026548672566,0.9805309734513274,2559,0.2563843236409608,0.0965865992414665,0.6470290771175727
2127,Muscogee,7036,126,1434,2146,6910,7036,1.0,0.017907902217168845,0.9820920977828311,3456,0.2038089823763502,0.30500284252416143,0.49118817509948837
2128,Muscogee,6387,77,3465,212,6310,6387,1.0,0.012055738218255832,0.9879442617817442,2710,0.5425082198215124,0.03319242210740567,0.4242993580710819
2129,Muscogee,10041,167,3537,864,9874,10041,1.0,0.016631809580719054,0.9833681904192809,5640,0.35225575141918136,0.08604720645354048,0.5616970421272781
2130,Muscogee,7616,148,2692,2837,7468,7616,1.0,0.019432773109243698,0.9805672268907563,2087,0.35346638655462187,0.37250525210084034,0.27402836134453784
2131,Muscogee,8301,103,3896,553,8198,8301,1.0,0.01240814359715697,0.9875918564028431,3852,0.46934104324780146,0.06661847970124081,0.4640404770509577
2132,Muscogee,3671,92,1129,994,3579,3671,1.0,0.025061291201307546,0.9749387087986925,1548,0.30754562789430673,0.27077090710977936,0.4216834649959139
2133,Muscogee,6539,78,3124,230,6461,6539,1.0,0.011928429423459244,0.9880715705765407,3185,0.477748891267778,0.035173573940969566,0.4870775347912525
2134,Muscogee,6251,152,1785,2190,6099,6251,1.0,0.0243161094224924,0.9756838905775076,2276,0.2855543113101904,0.350343944968805,0.3641017437210046
2135,Muscogee,3775,95,908,1346,3680,3775,1.0,0.025165562913907286,0.9748344370860927,1521,0.2405298013245033,0.3565562913907285,0.4029139072847682
2136,Muscogee,8671,147,2605,3024,8524,8671,1.0,0.016953061930573176,0.9830469380694268,3042,0.30042670972206204,0.348748702571791,0.35082458770614694
2137,Muscogee,6515,167,1676,3243,6348,6515,1.0,0.02563315425940138,0.9743668457405986,1596,0.25725249424405217,0.4977743668457406,0.24497313891020722
2138,Muscogee,3113,42,722,1453,3071,3113,1.0,0.013491808544812078,0.9865081914551879,938,0.23193061355605527,0.46675232894314167,0.30131705750080306
2139,Muscogee,5804,85,2228,716,5719,5804,1.0,0.014645072363886975,0.985354927636113,2860,0.3838731909028256,0.1233631977946244,0.49276361130255
2140,Newton,5019,79,1655,1687,4940,5019,1.0,0.015740187288304442,0.9842598127116956,1677,0.3297469615461247,0.33612273361227335,0.3341303048416019
2141,Newton,4991,58,2705,763,4933,4991,1.0,0.011620917651773192,0.9883790823482268,1523,0.5419755560008015,0.15287517531556802,0.3051492686836305
2142,Newton,5367,69,2872,710,5298,5367,1.0,0.012856344326439352,0.9871436556735607,1785,0.5351220421091858,0.13228991988075275,0.3325880380100615
2143,Newton,3848,96,676,1845,3752,3848,1.0,0.02494802494802495,0.975051975051975,1327,0.17567567567567569,0.47946985446985446,0.3448544698544699
2144,Newton,2670,46,564,1441,2624,2670,1.0,0.017228464419475654,0.9827715355805243,665,0.21123595505617979,0.5397003745318352,0.24906367041198502
2145,Newton,5057,95,1835,1395,4962,5057,1.0,0.018785841407949377,0.9812141585920506,1827,0.36286335772196954,0.27585525014830925,0.36128139212972116
2146,Newton,3773,74,980,759,3699,3773,1.0,0.019613040021203287,0.9803869599787968,2034,0.2597402597402597,0.20116618075801748,0.5390935595017228
2147,Newton,2277,36,642,398,2241,2277,1.0,0.015810276679841896,0.9841897233201581,1237,0.28194993412384717,0.17479139218269654,0.5432586736934563
2148,Newton,3401,75,1085,946,3326,3401,1.0,0.022052337547780066,0.97794766245222,1370,0.3190238165245516,0.27815348426933256,0.40282269920611585
2149,Newton,5232,89,2743,399,5143,5232,1.0,0.017010703363914373,0.9829892966360856,2090,0.5242737003058104,0.07626146788990826,0.39946483180428133
2150,Newton,6530,134,2374,1954,6396,6530,1.0,0.020520673813169986,0.97947932618683,2202,0.36355283307810105,0.2992343032159265,0.3372128637059724
2151,Newton,3154,36,1573,233,3118,3154,1.0,0.011414077362079899,0.9885859226379201,1348,0.49873176918199114,0.07387444514901712,0.4273937856689918
2152,Newton,4219,92,943,2244,4127,4219,1.0,0.02180611519317374,0.9781938848068262,1032,0.2235126807300308,0.5318795923204551,0.2446077269495141
2153,Newton,2406,50,340,1560,2356,2406,1.0,0.020781379883624274,0.9792186201163757,506,0.14131338320864506,0.6483790523690773,0.21030756442227763
2154,Newton,2298,53,401,1227,2245,2298,1.0,0.023063533507397736,0.9769364664926022,670,0.17449956483899043,0.5339425587467362,0.2915578764142733
2155,Newton,4694,72,2094,837,4622,4694,1.0,0.01533873029399233,0.9846612697060076,1763,0.4461014060502769,0.17831273966766084,0.3755858542820622
2156,Newton,1572,37,145,1066,1535,1572,1.0,0.023536895674300253,0.9764631043256997,361,0.09223918575063614,0.678117048346056,0.2296437659033079
2157,Newton,912,16,109,494,896,912,1.0,0.017543859649122806,0.9824561403508771,309,0.11951754385964912,0.5416666666666666,0.33881578947368424
2158,Newton,3427,68,586,1204,3359,3427,1.0,0.019842427779398892,0.9801575722206011,1637,0.17099503939305516,0.3513276918587686,0.47767726874817623
2159,Newton,3701,70,1105,1297,3631,3701,1.0,0.01891380707916779,0.9810861929208322,1299,0.29856795460686303,0.3504458254525804,0.3509862199405566
2160,Newton,5256,79,2416,805,5177,5256,1.0,0.015030441400304413,0.9849695585996956,2035,0.4596651445966514,0.15315829528158295,0.3871765601217656
2161,Newton,4944,89,1951,605,4855,4944,1.0,0.018001618122977348,0.9819983818770227,2388,0.3946197411003236,0.1223705501618123,0.4830097087378641
2162,Oconee,1371,34,280,874,1337,1371,1.0,0.024799416484318017,0.975200583515682,217,0.20423048869438365,0.637490882567469,0.15827862873814733
2163,Oconee,3106,42,857,1217,3064,3106,1.0,0.013522215067611075,0.9864777849323889,1032,0.2759175788795879,0.3918222794591114,0.3322601416613007
2164,Oconee,1998,34,517,1086,1964,1998,1.0,0.01701701701701702,0.982982982982983,395,0.25875875875875876,0.5435435435435435,0.1976976976976977
2165,Oconee,2462,46,557,1299,2416,2462,1.0,0.01868399675060926,0.9813160032493907,606,0.2262388302193339,0.5276198212835094,0.24614134849715677
2166,Oconee,3761,75,1303,1854,3686,3761,1.0,0.019941504918904545,0.9800584950810954,604,0.346450412124435,0.4929540015953204,0.16059558628024462
2167,Oconee,4286,65,1338,2268,4221,4286,1.0,0.01516565562295847,0.9848343443770415,680,0.3121791880541297,0.5291647223518432,0.15865608959402708
2168,Oconee,1836,32,494,1101,1804,1836,1.0,0.017429193899782137,0.9825708061002179,241,0.2690631808278867,0.5996732026143791,0.1312636165577342
2169,Oconee,3436,57,666,2309,3379,3436,1.0,0.01658905704307334,0.9834109429569267,461,0.19383003492433062,0.6720023282887078,0.13416763678696159
2170,Oconee,718,23,174,421,695,718,1.0,0.03203342618384401,0.967966573816156,123,0.24233983286908078,0.5863509749303621,0.1713091922005571
2171,Oconee,1784,36,483,1177,1748,1784,1.0,0.020179372197309416,0.9798206278026906,124,0.2707399103139013,0.6597533632286996,0.06950672645739911
2172,Oconee,4152,32,1211,2217,4120,4152,1.0,0.007707129094412331,0.9922928709055877,724,0.2916666666666667,0.5339595375722543,0.174373795761079
2173,Oconee,1311,24,282,772,1287,1311,1.0,0.018306636155606407,0.9816933638443935,257,0.2151029748283753,0.5888634630053394,0.19603356216628529
2174,Oglethorpe,3740,114,746,1835,3626,3740,1.0,0.03048128342245989,0.9695187165775401,1159,0.19946524064171123,0.49064171122994654,0.30989304812834223
2175,Oglethorpe,3297,117,710,1467,3180,3297,1.0,0.03548680618744313,0.9645131938125568,1120,0.21534728541097967,0.44494995450409464,0.33970276008492567
2176,Oglethorpe,4602,72,980,2291,4530,4602,1.0,0.01564537157757497,0.984354628422425,1331,0.21295089091699262,0.4978270317253368,0.2892220773576706
2177,Paulding,7918,259,1957,3116,7659,7918,1.0,0.03271028037383177,0.9672897196261683,2845,0.24715837332659762,0.39353372063652436,0.359307906036878
2178,Paulding,6199,167,905,4036,6032,6199,1.0,0.026939829004678173,0.9730601709953218,1258,0.14599128891756735,0.6510727536699468,0.20293595741248588
2179,Paulding,7272,206,1184,5075,7066,7272,1.0,0.02832783278327833,0.9716721672167217,1013,0.1628162816281628,0.6978822882288229,0.1393014301430143
2180,Paulding,12052,284,1843,1516,11768,12052,1.0,0.023564553601062063,0.976435446398938,8693,0.15292067706604712,0.1257882509127116,0.7212910720212413
2181,Paulding,9498,188,1636,2760,9310,9498,1.0,0.019793640766477154,0.9802063592335228,5102,0.1722467887976416,0.29058749210360074,0.5371657190987577
2182,Paulding,10641,261,1958,5133,10380,10641,1.0,0.024527769946433606,0.9754722300535664,3550,0.18400526266328351,0.4823794756131943,0.33361526172352224
2183,Paulding,6521,154,1478,2588,6367,6521,1.0,0.023616009814445636,0.9763839901855543,2455,0.2266523539334458,0.39687164545315134,0.37647600061340286
2184,Paulding,5618,150,691,2210,5468,5618,1.0,0.026699893200427198,0.9733001067995728,2717,0.12299750800996796,0.39337842648629406,0.483624065503738
2185,Paulding,18454,389,5235,10738,18065,18454,1.0,0.021079440771648424,0.9789205592283515,2481,0.28367833532025577,0.5818792673675084,0.13444239731223584
2186,Paulding,10110,202,3710,4131,9908,10110,1.0,0.019980217606330366,0.9800197823936696,2269,0.3669634025717112,0.4086053412462908,0.22443125618199802
2187,Paulding,12942,279,3000,4233,12663,12942,1.0,0.021557719054242003,0.978442280945758,5709,0.23180343069077422,0.32707464070468245,0.44112192860454336
2188,Paulding,16773,386,6107,8989,16387,16773,1.0,0.023013175937518632,0.9769868240624814,1677,0.36409706075239967,0.5359208251356347,0.09998211411196566
2189,Peach,2903,98,600,1408,2805,2903,1.0,0.033758181191870476,0.9662418188081295,895,0.20668274199104375,0.48501550120564935,0.3083017568033069
2190,Peach,5763,105,1370,2299,5658,5763,1.0,0.018219677251431546,0.9817803227485684,2094,0.2377234079472497,0.3989241714384869,0.3633524206142634
2191,Peach,1024,36,133,541,988,1024,1.0,0.03515625,0.96484375,350,0.1298828125,0.5283203125,0.341796875
2192,Peach,3278,65,1079,681,3213,3278,1.0,0.01982916412446614,0.9801708358755339,1518,0.3291641244661379,0.20774862721171447,0.46308724832214765
2193,Peach,3508,47,1055,564,3461,3508,1.0,0.013397947548460661,0.9866020524515393,1889,0.3007411630558723,0.16077537058152794,0.5384834663625998
2194,Peach,4116,16,1399,266,4100,4116,1.0,0.003887269193391642,0.9961127308066083,2451,0.3398931000971817,0.06462585034013606,0.5954810495626822
2195,Peach,1519,28,284,743,1491,1519,1.0,0.018433179723502304,0.9815668202764977,492,0.1869651086240948,0.489137590520079,0.3238973008558262
2196,Pickens,2395,71,231,1136,2324,2395,1.0,0.02964509394572025,0.9703549060542798,1028,0.09645093945720251,0.474321503131524,0.4292275574112735
2197,Pickens,1925,50,241,1259,1875,1925,1.0,0.025974025974025976,0.974025974025974,425,0.1251948051948052,0.6540259740259741,0.22077922077922077
2198,Pickens,980,24,59,491,956,980,1.0,0.024489795918367346,0.9755102040816327,430,0.06020408163265306,0.5010204081632653,0.4387755102040816
2199,Pickens,2492,81,337,1240,2411,2492,1.0,0.032504012841091494,0.9674959871589085,915,0.13523274478330657,0.49759229534510435,0.3671749598715891
2200,Pickens,1382,37,101,755,1345,1382,1.0,0.026772793053545588,0.9732272069464544,526,0.07308248914616498,0.5463096960926194,0.38060781476121563
2201,Pickens,803,24,38,442,779,803,1.0,0.029887920298879204,0.9701120797011208,323,0.047322540473225407,0.5504358655043586,0.40224159402241594
2202,Pickens,1580,49,151,866,1531,1580,1.0,0.0310126582278481,0.9689873417721518,563,0.09556962025316455,0.5481012658227848,0.35632911392405064
2203,Pickens,3359,101,238,1499,3258,3359,1.0,0.030068472759749925,0.9699315272402501,1622,0.07085442095861863,0.4462637689788628,0.4828818100625186
2204,Pickens,2780,75,474,1586,2705,2780,1.0,0.02697841726618705,0.9730215827338129,720,0.17050359712230215,0.5705035971223021,0.2589928057553957
2205,Pickens,1852,88,131,1086,1764,1852,1.0,0.047516198704103674,0.9524838012958964,635,0.07073434125269978,0.5863930885529157,0.34287257019438444
2206,Pickens,2964,90,224,1654,2874,2964,1.0,0.030364372469635626,0.9696356275303644,1086,0.07557354925775979,0.558029689608637,0.36639676113360325
2207,Pickens,4287,58,583,2061,4229,4287,1.0,0.013529274550968043,0.9864707254490319,1643,0.13599253557266153,0.4807557732680196,0.3832516911593189
2208,Pierce,1100,19,55,602,1081,1100,1.0,0.017272727272727273,0.9827272727272728,443,0.05,0.5472727272727272,0.4027272727272727
2209,Pierce,3865,71,226,1969,3794,3865,1.0,0.018369987063389392,0.9816300129366106,1670,0.05847347994825356,0.5094437257438551,0.4320827943078913
2210,Pierce,4024,73,478,1898,3951,4024,1.0,0.018141153081510934,0.981858846918489,1648,0.11878727634194831,0.4716699801192843,0.4095427435387674
2211,Pierce,465,7,25,337,458,465,1.0,0.015053763440860216,0.9849462365591398,103,0.053763440860215055,0.7247311827956989,0.221505376344086
2212,Pierce,1674,18,80,935,1656,1674,1.0,0.010752688172043012,0.989247311827957,659,0.04778972520908005,0.5585424133811231,0.39366786140979687
2213,Pierce,1637,35,131,821,1602,1637,1.0,0.021380574221136223,0.9786194257788637,685,0.08002443494196701,0.5015271838729383,0.4184483811850947
2214,Pierce,1857,35,101,1113,1822,1857,1.0,0.01884760366182014,0.9811523963381799,643,0.05438879913839526,0.5993537964458805,0.3462574044157243
2215,Pierce,277,3,4,224,274,277,1.0,0.010830324909747292,0.9891696750902527,49,0.01444043321299639,0.8086642599277978,0.17689530685920576
2216,Pike,1423,24,246,881,1399,1423,1.0,0.016865776528460996,0.983134223471539,296,0.17287420941672524,0.6191145467322557,0.20801124385101896
2217,Pike,1758,31,113,1277,1727,1758,1.0,0.01763367463026166,0.9823663253697383,368,0.06427758816837315,0.7263936291240045,0.20932878270762229
2218,Pike,1193,17,104,771,1176,1193,1.0,0.014249790444258172,0.9857502095557418,318,0.08717518860016764,0.6462699077954736,0.26655490360435874
2219,Pike,1386,28,103,907,1358,1386,1.0,0.020202020202020204,0.9797979797979798,376,0.07431457431457432,0.6544011544011544,0.2712842712842713
2220,Pike,1559,34,181,980,1525,1559,1.0,0.021808851828094934,0.9781911481719051,398,0.11610006414368185,0.6286080821039127,0.2552918537524054
2221,Pike,2681,39,243,1799,2642,2681,1.0,0.01454681089145841,0.9854531891085416,639,0.09063782170831779,0.6710182767624021,0.23834390152928012
2222,Pike,1727,45,160,1244,1682,1727,1.0,0.02605674580196873,0.9739432541980313,323,0.09264620729588882,0.7203242617255357,0.18702953097857555
2223,Pike,2610,71,355,1268,2539,2610,1.0,0.027203065134099615,0.9727969348659004,987,0.1360153256704981,0.48582375478927203,0.3781609195402299
2224,Polk,4008,87,386,1926,3921,4008,1.0,0.021706586826347306,0.9782934131736527,1696,0.09630738522954092,0.4805389221556886,0.4231536926147705
2225,Polk,2102,41,187,966,2061,2102,1.0,0.01950523311132255,0.9804947668886774,949,0.0889628924833492,0.45956232159847765,0.4514747859181732
2226,Polk,10053,271,1331,2783,9782,10053,1.0,0.02695712722570377,0.9730428727742962,5939,0.1323982890679399,0.2768327862329653,0.5907689246990948
2227,Polk,3149,75,294,1584,3074,3149,1.0,0.023817084788821847,0.9761829152111782,1271,0.09336297237218165,0.5030168307399174,0.4036201968879009
2228,Polk,3229,69,306,1901,3160,3229,1.0,0.02136884484360483,0.9786311551563952,1022,0.09476618148033447,0.5887271601114896,0.3165066584081759
2229,Polk,7180,161,989,3178,7019,7180,1.0,0.022423398328690808,0.9775766016713092,3013,0.13774373259052924,0.44261838440111423,0.4196378830083565
2230,Polk,2517,72,165,1251,2445,2517,1.0,0.028605482717520857,0.9713945172824792,1101,0.06555423122765197,0.4970202622169249,0.4374255065554231
2231,Pulaski,8012,97,1217,2805,7915,8012,1.0,0.012106839740389416,0.9878931602596106,3990,0.1518971542685971,0.350099850224663,0.4980029955067399
2232,Putnam,3979,92,991,1216,3887,3979,1.0,0.023121387283236993,0.976878612716763,1772,0.24905755214878111,0.30560442322191506,0.44533802462930383
2233,Putnam,4067,58,1148,1181,4009,4067,1.0,0.014261126137201869,0.9857388738627981,1738,0.2822719449225473,0.29038603393164497,0.4273420211458077
2234,Putnam,3926,57,558,2472,3869,3926,1.0,0.014518593988792664,0.9854814060112074,896,0.14212939378502293,0.6296484971981661,0.228222109016811
2235,Putnam,1450,16,160,843,1434,1450,1.0,0.011034482758620689,0.9889655172413793,447,0.1103448275862069,0.5813793103448276,0.3082758620689655
2236,Putnam,4425,91,591,2579,4334,4425,1.0,0.02056497175141243,0.9794350282485875,1255,0.1335593220338983,0.5828248587570621,0.28361581920903955
2237,Quitman,1763,31,467,565,1732,1763,1.0,0.01758366420873511,0.9824163357912649,731,0.26488939307997733,0.3204764605785593,0.4146341463414634
2238,Quitman,107,11,30,39,96,107,1.0,0.102803738317757,0.897196261682243,38,0.2803738317757009,0.3644859813084112,0.35514018691588783
2239,Rabun,13767,372,1984,7474,13395,13767,1.0,0.027021137502723905,0.972978862497276,4309,0.14411273334786082,0.5428924239122539,0.31299484273988526
2240,Randolph,309,9,77,179,300,309,1.0,0.02912621359223301,0.970873786407767,53,0.24919093851132687,0.5792880258899676,0.1715210355987055
2241,Randolph,256,4,80,90,252,256,1.0,0.015625,0.984375,86,0.3125,0.3515625,0.3359375
2242,Randolph,466,5,225,11,461,466,1.0,0.01072961373390558,0.9892703862660944,230,0.48283261802575106,0.023605150214592276,0.49356223175965663
2243,Randolph,2681,34,833,690,2647,2681,1.0,0.01268183513614323,0.9873181648638568,1158,0.31070496083550914,0.257366654233495,0.4319283849309959
2244,Randolph,940,14,331,358,926,940,1.0,0.014893617021276596,0.9851063829787234,251,0.35212765957446807,0.38085106382978723,0.2670212765957447
2245,Randolph,325,2,125,63,323,325,1.0,0.006153846153846154,0.9938461538461538,137,0.38461538461538464,0.19384615384615383,0.42153846153846153
2246,Richmond,1043,15,355,294,1028,1043,1.0,0.014381591562799617,0.9856184084372004,394,0.34036433365292423,0.28187919463087246,0.37775647171620325
2247,Richmond,2152,45,483,160,2107,2152,1.0,0.020910780669144983,0.979089219330855,1509,0.22444237918215612,0.07434944237918216,0.7012081784386617
2248,Richmond,1657,8,752,26,1649,1657,1.0,0.004828002414001207,0.9951719975859988,879,0.45383222691611347,0.015691007845503924,0.5304767652383826
2249,Richmond,3024,20,1540,109,3004,3024,1.0,0.006613756613756613,0.9933862433862434,1375,0.5092592592592593,0.036044973544973546,0.4546957671957672
2250,Richmond,1387,6,511,34,1381,1387,1.0,0.004325883201153569,0.9956741167988464,842,0.3684210526315789,0.024513338139870222,0.6070656092285508
2251,Richmond,1241,39,384,125,1202,1241,1.0,0.031426269137792104,0.9685737308622079,732,0.30942788074133765,0.10072522159548751,0.5898468976631749
2252,Richmond,1994,24,697,578,1970,1994,1.0,0.012036108324974924,0.9879638916750251,719,0.34954864593781343,0.28986960882647944,0.36058174523570713
2253,Richmond,498,6,287,40,492,498,1.0,0.012048192771084338,0.9879518072289156,171,0.5763052208835341,0.08032128514056225,0.3433734939759036
2254,Richmond,1522,13,515,98,1509,1522,1.0,0.008541392904073587,0.9914586070959264,909,0.3383705650459921,0.06438896189224705,0.5972404730617609
2255,Richmond,1657,31,704,184,1626,1657,1.0,0.018708509354254676,0.9812914906457453,769,0.4248642124321062,0.11104405552202776,0.464091732045866
2256,Richmond,1476,14,336,202,1462,1476,1.0,0.009485094850948509,0.9905149051490515,938,0.22764227642276422,0.13685636856368563,0.6355013550135501
2257,Richmond,883,7,385,56,876,883,1.0,0.007927519818799546,0.9920724801812004,442,0.4360135900339751,0.06342015855039637,0.5005662514156285
2258,Richmond,751,7,146,108,744,751,1.0,0.009320905459387484,0.9906790945406125,497,0.19440745672436752,0.14380825565912117,0.6617842876165113
2259,Richmond,1560,18,749,34,1542,1560,1.0,0.011538461538461539,0.9884615384615385,777,0.48012820512820514,0.021794871794871794,0.4980769230769231
2260,Richmond,5254,55,1790,727,5199,5254,1.0,0.010468214693566806,0.9895317853064332,2737,0.34069280548153785,0.1383707651313285,0.5209364293871336
2261,Richmond,1057,7,526,11,1050,1057,1.0,0.006622516556291391,0.9933774834437086,520,0.49763481551561023,0.010406811731315043,0.49195837275307475
2262,Richmond,1998,36,563,510,1962,1998,1.0,0.018018018018018018,0.9819819819819819,925,0.28178178178178176,0.2552552552552553,0.46296296296296297
2263,Richmond,2737,41,1221,151,2696,2737,1.0,0.014979905005480453,0.9850200949945196,1365,0.44610887833394225,0.05516989404457435,0.49872122762148335
2264,Richmond,3144,43,1192,241,3101,3144,1.0,0.013676844783715014,0.986323155216285,1711,0.3791348600508906,0.07665394402035623,0.5442111959287532
2265,Richmond,2251,26,823,149,2225,2251,1.0,0.011550422034651266,0.9884495779653487,1279,0.36561528209684585,0.06619280319857841,0.5681919147045758
2266,Richmond,2565,42,761,1154,2523,2565,1.0,0.016374269005847954,0.9836257309941521,650,0.29668615984405455,0.4499025341130604,0.253411306042885
2267,Richmond,1583,23,470,135,1560,1583,1.0,0.014529374605180037,0.98547062539482,978,0.2969046114971573,0.08528111181301326,0.6178142766898295
2268,Richmond,1424,27,359,779,1397,1424,1.0,0.018960674157303372,0.9810393258426966,286,0.2521067415730337,0.5470505617977528,0.20084269662921347
2269,Richmond,373,16,112,158,357,373,1.0,0.04289544235924933,0.9571045576407506,103,0.3002680965147453,0.42359249329758714,0.2761394101876676
2270,Richmond,401,8,101,276,393,401,1.0,0.0199501246882793,0.9800498753117207,24,0.2518703241895262,0.6882793017456359,0.059850374064837904
2271,Richmond,5588,124,1681,867,5464,5588,1.0,0.02219040801717967,0.9778095919828204,3040,0.300823192555476,0.15515390121689335,0.5440229062276306
2272,Richmond,1908,25,472,702,1883,1908,1.0,0.01310272536687631,0.9868972746331237,734,0.24737945492662475,0.36792452830188677,0.38469601677148846
2273,Richmond,949,19,235,152,930,949,1.0,0.020021074815595362,0.9799789251844047,562,0.2476290832455216,0.1601685985247629,0.5922023182297155
2274,Richmond,3502,62,2135,307,3440,3502,1.0,0.01770416904625928,0.9822958309537407,1060,0.6096516276413478,0.08766419189034837,0.3026841804683038
2275,Richmond,6973,117,2736,801,6856,6973,1.0,0.016779004732539796,0.9832209952674602,3436,0.3923705722070845,0.11487164778431092,0.4927577800086046
2276,Richmond,2058,10,1424,94,2048,2058,1.0,0.004859086491739553,0.9951409135082604,540,0.6919339164237124,0.0456754130223518,0.26239067055393583
2277,Richmond,7621,157,1495,189,7464,7621,1.0,0.020600971001180947,0.979399028998819,5937,0.19616848182653196,0.024799895026899357,0.7790316231465687
2278,Richmond,1953,31,1030,142,1922,1953,1.0,0.015873015873015872,0.9841269841269841,781,0.5273937532002048,0.07270865335381464,0.3998975934459805
2279,Richmond,4333,49,2917,264,4284,4333,1.0,0.011308562197092083,0.9886914378029079,1152,0.6732056312024002,0.060927763674128776,0.26586660512347104
2280,Richmond,3054,48,2130,205,3006,3054,1.0,0.015717092337917484,0.9842829076620825,719,0.6974459724950884,0.06712508185985593,0.23542894564505568
2281,Richmond,3586,46,1861,269,3540,3586,1.0,0.012827663134411601,0.9871723368655884,1456,0.518962632459565,0.07501394311210262,0.4060234244283324
2282,Richmond,4354,75,2296,249,4279,4354,1.0,0.017225539733578318,0.9827744602664217,1809,0.5273311897106109,0.05718879191548002,0.4154800183739091
2283,Richmond,4444,51,2061,363,4393,4444,1.0,0.011476147614761477,0.9885238523852385,2020,0.46377137713771377,0.08168316831683169,0.45454545454545453
2284,Richmond,3186,77,909,336,3109,3186,1.0,0.02416823603264281,0.9758317639673572,1941,0.2853107344632768,0.10546139359698682,0.6092278719397364
2285,Richmond,480,15,162,69,465,480,1.0,0.03125,0.96875,249,0.3375,0.14375,0.51875
2286,Richmond,1352,28,487,147,1324,1352,1.0,0.020710059171597635,0.9792899408284024,718,0.36020710059171596,0.10872781065088757,0.5310650887573964
2287,Richmond,2152,34,1248,197,2118,2152,1.0,0.015799256505576207,0.9842007434944238,707,0.5799256505576208,0.09154275092936803,0.32853159851301117
2288,Richmond,4985,104,1693,523,4881,4985,1.0,0.02086258776328987,0.9791374122367101,2769,0.33961885656970914,0.1049147442326981,0.5554663991975928
2289,Richmond,3855,82,1181,1038,3773,3855,1.0,0.021271076523994813,0.9787289234760052,1636,0.3063553826199741,0.26926070038910505,0.4243839169909209
2290,Richmond,2134,54,724,313,2080,2134,1.0,0.02530459231490159,0.9746954076850984,1097,0.3392689784442362,0.14667291471415184,0.514058106841612
2291,Richmond,4768,58,1508,755,4710,4768,1.0,0.012164429530201342,0.9878355704697986,2505,0.3162751677852349,0.15834731543624161,0.5253775167785235
2292,Richmond,1727,17,1145,80,1710,1727,1.0,0.009843659525188187,0.9901563404748118,502,0.6629994209612045,0.04632310364794441,0.2906774753908512
2293,Richmond,1564,35,420,590,1529,1564,1.0,0.02237851662404092,0.9776214833759591,554,0.26854219948849106,0.3772378516624041,0.35421994884910485
2294,Richmond,2368,30,710,1087,2338,2368,1.0,0.01266891891891892,0.987331081081081,571,0.2998310810810811,0.45903716216216217,0.24113175675675674
2295,Richmond,2193,46,530,852,2147,2193,1.0,0.020975832193342453,0.9790241678066576,811,0.2416780665754674,0.38850889192886456,0.369813041495668
2296,Richmond,6123,106,1647,1189,6017,6123,1.0,0.017311775273558712,0.9826882247264412,3287,0.2689857912787849,0.19418585660623877,0.5368283521149764
2297,Richmond,2535,26,732,928,2509,2535,1.0,0.010256410256410256,0.9897435897435898,875,0.28875739644970416,0.3660749506903353,0.34516765285996054
2298,Richmond,3843,78,972,1451,3765,3843,1.0,0.02029664324746292,0.9797033567525371,1420,0.2529274004683841,0.3775696070778038,0.36950299245381213
2299,Richmond,3019,42,858,506,2977,3019,1.0,0.01391189135475323,0.9860881086452468,1655,0.2842000662471017,0.16760516727393177,0.5481947664789666
2300,Richmond,437,8,73,161,429,437,1.0,0.018306636155606407,0.9816933638443935,203,0.16704805491990846,0.3684210526315789,0.4645308924485126
2301,Richmond,658,16,211,194,642,658,1.0,0.0243161094224924,0.9756838905775076,253,0.32066869300911854,0.2948328267477204,0.3844984802431611
2302,Richmond,586,16,114,248,570,586,1.0,0.027303754266211604,0.9726962457337884,224,0.1945392491467577,0.4232081911262799,0.3822525597269625
2303,Richmond,531,11,92,276,520,531,1.0,0.02071563088512241,0.9792843691148776,163,0.17325800376647835,0.519774011299435,0.3069679849340866
2304,Richmond,3730,110,729,1344,3620,3730,1.0,0.029490616621983913,0.9705093833780161,1657,0.19544235924932976,0.36032171581769434,0.44423592493297587
2305,Richmond,2028,43,77,32,1985,2028,1.0,0.021203155818540435,0.9787968441814595,1919,0.03796844181459566,0.015779092702169626,0.9462524654832347
2306,Richmond,2162,72,808,567,2090,2162,1.0,0.03330249768732655,0.9666975023126735,787,0.3737280296022202,0.2622571692876966,0.3640148011100833
2307,Richmond,2985,86,900,1001,2899,2985,1.0,0.0288107202680067,0.9711892797319933,1084,0.3015075376884422,0.3353433835845896,0.36314907872696817
2308,Richmond,835,23,379,166,812,835,1.0,0.027544910179640718,0.9724550898203593,290,0.4538922155688623,0.19880239520958085,0.3473053892215569
2309,Richmond,1243,33,329,495,1210,1243,1.0,0.02654867256637168,0.9734513274336283,419,0.26468222043443285,0.39823008849557523,0.337087691069992
2310,Richmond,1828,53,698,232,1775,1828,1.0,0.02899343544857768,0.9710065645514223,898,0.38183807439824946,0.12691466083150985,0.4912472647702407
2311,Richmond,2383,59,832,843,2324,2383,1.0,0.024758707511540076,0.9752412924884599,708,0.34913973982375157,0.35375577003776754,0.2971044901384809
2312,Richmond,832,8,586,45,824,832,1.0,0.009615384615384616,0.9903846153846154,201,0.7043269230769231,0.054086538461538464,0.24158653846153846
2313,Richmond,422,15,135,173,407,422,1.0,0.035545023696682464,0.9644549763033176,114,0.31990521327014215,0.4099526066350711,0.27014218009478674
2314,Rockdale,4725,92,2204,1274,4633,4725,1.0,0.019470899470899472,0.9805291005291006,1247,0.46645502645502646,0.2696296296296296,0.26391534391534394
2315,Rockdale,4331,103,1099,1600,4228,4331,1.0,0.023782036481182173,0.9762179635188178,1632,0.2537520203186331,0.36942969291156774,0.3768182867697991
2316,Rockdale,4458,75,1714,453,4383,4458,1.0,0.016823687752355317,0.9831763122476447,2291,0.3844773441004935,0.1016150740242261,0.5139075818752804
2317,Rockdale,6961,86,3672,609,6875,6961,1.0,0.012354546760522913,0.9876454532394771,2680,0.5275104151702341,0.08748742996695877,0.3850021548628071
2318,Rockdale,3992,62,2198,571,3930,3992,1.0,0.015531062124248497,0.9844689378757515,1223,0.5506012024048096,0.14303607214428857,0.3063627254509018
2319,Rockdale,3767,72,1611,835,3695,3767,1.0,0.019113352800637112,0.9808866471993629,1321,0.4276612689142554,0.22166179984072207,0.3506769312450226
2320,Rockdale,2485,49,968,762,2436,2485,1.0,0.01971830985915493,0.9802816901408451,755,0.38953722334004026,0.3066398390342052,0.3038229376257545
2321,Rockdale,3817,69,1798,1200,3748,3817,1.0,0.0180770238407126,0.9819229761592874,819,0.47105056326958344,0.3143830233167409,0.21456641341367566
2322,Rockdale,3477,71,1226,962,3406,3477,1.0,0.020419902214552775,0.9795800977854472,1289,0.3526028185217141,0.276675294794363,0.3707218866839229
2323,Rockdale,4836,70,2054,557,4766,4836,1.0,0.014474772539288668,0.9855252274607114,2225,0.42473118279569894,0.11517783291976841,0.46009098428453266
2324,Rockdale,8101,94,3107,553,8007,8101,1.0,0.011603505740032095,0.9883964942599679,4441,0.3835328971731885,0.06826317738550797,0.5482039254413036
2325,Rockdale,4967,72,2339,834,4895,4967,1.0,0.014495671431447555,0.9855043285685524,1794,0.4709079927521643,0.16790819408093416,0.36118381316690157
2326,Rockdale,4061,45,2326,763,4016,4061,1.0,0.01108101452844127,0.9889189854715588,972,0.5727653287367643,0.1878847574489042,0.23934991381433143
2327,Rockdale,4795,83,2600,759,4712,4795,1.0,0.017309697601668405,0.9826903023983315,1436,0.5422314911366006,0.15828988529718457,0.2994786235662148
2328,Rockdale,3361,51,1473,929,3310,3361,1.0,0.01517405534067242,0.9848259446593276,959,0.43826242189824455,0.2764058315977388,0.28533174650401666
2329,Rockdale,3369,79,855,351,3290,3369,1.0,0.023449094686850698,0.9765509053131493,2163,0.25378450578806766,0.10418521816562779,0.6420302760463046
2330,Schley,3328,45,462,1800,3283,3328,1.0,0.013521634615384616,0.9864783653846154,1066,0.1388221153846154,0.5408653846153846,0.3203125
2331,Screven,1148,18,102,606,1130,1148,1.0,0.0156794425087108,0.9843205574912892,440,0.08885017421602788,0.5278745644599303,0.3832752613240418
2332,Screven,203,7,128,57,196,203,1.0,0.034482758620689655,0.9655172413793104,18,0.6305418719211823,0.28078817733990147,0.08866995073891626
2333,Screven,626,6,146,479,620,626,1.1927480916030535,0.009584664536741214,0.9904153354632588,1,0.23322683706070288,0.7651757188498403,0.001597444089456869
2334,Screven,944,8,286,327,936,944,1.0,0.00847457627118644,0.9915254237288136,331,0.3029661016949153,0.3463983050847458,0.350635593220339
2335,Screven,1084,14,128,228,1070,1084,1.0,0.012915129151291513,0.9870848708487084,728,0.11808118081180811,0.21033210332103322,0.6715867158671587
2336,Screven,359,4,84,209,355,359,1.0,0.011142061281337047,0.9888579387186629,66,0.233983286908078,0.5821727019498607,0.18384401114206128
2337,Screven,1186,12,402,386,1174,1186,1.0,0.01011804384485666,0.9898819561551433,398,0.33895446880269814,0.3254637436762226,0.33558178752107926
2338,Screven,1258,19,253,506,1239,1258,1.0,0.015103338632750398,0.9848966613672496,499,0.20111287758346583,0.40222575516693165,0.39666136724960255
2339,Screven,575,14,86,293,561,575,1.0,0.02434782608695652,0.9756521739130435,196,0.14956521739130435,0.5095652173913043,0.3408695652173913
2340,Screven,471,4,154,128,467,471,1.0,0.008492569002123142,0.9915074309978769,189,0.32696390658174096,0.27176220806794055,0.4012738853503185
2341,Screven,1517,18,519,264,1499,1517,1.0,0.011865524060646011,0.988134475939354,734,0.34212261041529335,0.17402768622280818,0.4838497033618985
2342,Screven,1624,13,373,433,1611,1624,1.0,0.008004926108374385,0.9919950738916257,818,0.22967980295566504,0.2666256157635468,0.5036945812807881
2343,Seminole,1459,16,215,659,1443,1459,1.0,0.010966415352981495,0.9890335846470185,585,0.14736120630568883,0.4516792323509253,0.4009595613433859
2344,Seminole,1473,25,257,492,1448,1473,1.0,0.01697216564833673,0.9830278343516633,724,0.17447386286490157,0.3340122199592668,0.49151391717583165
2345,Seminole,1289,2,530,89,1287,1289,1.0,0.0015515903801396431,0.9984484096198604,670,0.41117145073700545,0.06904577191621412,0.5197827773467805
2346,Seminole,1344,25,155,619,1319,1344,1.0,0.018601190476190476,0.9813988095238095,570,0.11532738095238096,0.46056547619047616,0.42410714285714285
2347,Seminole,1712,43,97,752,1669,1712,1.0,0.02511682242990654,0.9748831775700935,863,0.0566588785046729,0.4392523364485981,0.5040887850467289
2348,Spalding,2951,28,859,152,2923,2951,1.0,0.009488309047780414,0.9905116909522196,1940,0.291087766858692,0.05150796340223653,0.6574042697390715
2349,Spalding,2259,33,844,116,2226,2259,1.0,0.014608233731739707,0.9853917662682603,1299,0.3736166445329792,0.051350154935812305,0.5750332005312085
2350,Spalding,2932,46,575,1516,2886,2932,1.0,0.015688949522510234,0.9843110504774898,841,0.1961118690313779,0.5170532060027285,0.2868349249658936
2351,Spalding,4509,86,1190,875,4423,4509,1.0,0.01907296518074961,0.9809270348192504,2444,0.26391661122200044,0.1940563317808827,0.5420270569971168
2352,Spalding,3098,65,952,292,3033,3098,1.0,0.020981278244028404,0.9790187217559716,1854,0.30729502905100065,0.09425435765009683,0.5984506132989025
2353,Spalding,1723,27,327,964,1696,1723,1.0,0.01567034242600116,0.9843296575739988,432,0.1897852582704585,0.559489262913523,0.2507254788160186
2354,Spalding,1952,34,362,939,1918,1952,1.0,0.017418032786885244,0.9825819672131147,651,0.18545081967213115,0.48104508196721313,0.33350409836065575
2355,Spalding,2124,60,206,1106,2064,2124,1.0,0.02824858757062147,0.9717514124293786,812,0.09698681732580038,0.5207156308851224,0.3822975517890772
2356,Spalding,2506,45,537,910,2461,2506,1.0,0.017956903431763767,0.9820430965682362,1059,0.21428571428571427,0.36312849162011174,0.42258579409417396
2357,Spalding,2733,39,615,1195,2694,2733,1.0,0.014270032930845226,0.9857299670691547,923,0.22502744237102085,0.4372484449323088,0.33772411269667035
2358,Spalding,2433,82,279,1306,2351,2433,1.0,0.03370324702013974,0.9662967529798603,848,0.11467324290998766,0.5367858610768599,0.34854089601315247
2359,Spalding,2838,59,249,1445,2779,2838,1.0,0.020789288231148697,0.9792107117688513,1144,0.08773784355179703,0.5091613812544045,0.40310077519379844
2360,Spalding,2614,78,364,817,2536,2614,1.0,0.029839326702371844,0.9701606732976281,1433,0.13925019127773527,0.31254781943381793,0.5482019892884469
2361,Spalding,5086,78,1755,849,5008,5086,1.0,0.01533621706645694,0.9846637829335431,2482,0.3450648839952812,0.16692882422335825,0.4880062917813606
2362,Spalding,2332,75,397,755,2257,2332,1.0,0.03216123499142367,0.9678387650085764,1180,0.1702401372212693,0.3237564322469983,0.5060034305317325
2363,Spalding,2946,82,537,1334,2864,2946,1.0,0.027834351663272233,0.9721656483367278,1075,0.18228105906313646,0.4528173794976239,0.36490156143923963
2364,Spalding,2360,46,238,1252,2314,2360,1.0,0.019491525423728815,0.9805084745762712,870,0.10084745762711865,0.5305084745762711,0.3686440677966102
2365,Spalding,4727,82,1498,2234,4645,4727,1.0,0.017347154643537126,0.9826528453564629,995,0.3169028982441295,0.4726041887031944,0.21049291305267612
2366,Stephens,21163,567,2385,9368,20596,21163,1.0,0.02679204271606105,0.9732079572839389,9410,0.11269668761517743,0.44265935831403863,0.44464395407078394
2367,Stewart,288,7,125,83,281,288,1.0,0.024305555555555556,0.9756944444444444,80,0.4340277777777778,0.2881944444444444,0.2777777777777778
2368,Stewart,2612,17,478,292,2595,2612,1.0,0.006508422664624809,0.9934915773353752,1842,0.18300153139356815,0.11179173047473201,0.7052067381316999
2369,Stewart,229,4,78,81,225,229,1.0,0.017467248908296942,0.982532751091703,70,0.3406113537117904,0.3537117903930131,0.3056768558951965
2370,Stewart,1488,20,501,345,1468,1488,1.0,0.013440860215053764,0.9865591397849462,642,0.33669354838709675,0.2318548387096774,0.4314516129032258
2371,Sumter,1810,30,416,770,1780,1810,1.0,0.016574585635359115,0.9834254143646409,624,0.22983425414364642,0.425414364640884,0.3447513812154696
2372,Sumter,843,16,216,227,827,843,1.0,0.018979833926453145,0.9810201660735468,400,0.25622775800711745,0.269276393831554,0.4744958481613286
2373,Sumter,1012,21,219,465,991,1012,1.0,0.020750988142292492,0.9792490118577075,328,0.21640316205533597,0.45948616600790515,0.3241106719367589
2374,Sumter,520,11,87,268,509,520,1.0,0.021153846153846155,0.9788461538461538,165,0.1673076923076923,0.5153846153846153,0.3173076923076923
2375,Sumter,4057,45,1357,368,4012,4057,1.0,0.01109193985703722,0.9889080601429627,2332,0.3344836085777668,0.09070741927532659,0.5748089721469066
2376,Sumter,4809,30,975,1091,4779,4809,1.0,0.006238303181534623,0.9937616968184654,2743,0.20274485339987525,0.22686629236847577,0.570388854231649
2377,Sumter,3371,9,1437,296,3362,3371,1.0,0.0026698309107089885,0.9973301690892911,1638,0.42628300207653513,0.08780777217442895,0.4859092257490359
2378,Sumter,2037,19,614,728,2018,2037,1.0,0.009327442317133039,0.990672557682867,695,0.3014236622484045,0.35738831615120276,0.34118802160039274
2379,Sumter,427,6,41,260,421,427,1.0,0.01405152224824356,0.9859484777517564,126,0.09601873536299765,0.6088992974238876,0.29508196721311475
2380,Sumter,1304,32,379,397,1272,1304,1.0,0.024539877300613498,0.9754601226993865,528,0.2906441717791411,0.3044478527607362,0.4049079754601227
2381,Sumter,2846,47,577,862,2799,2846,1.0,0.01651440618411806,0.983485593815882,1407,0.20274068868587491,0.30288123682361207,0.494378074490513
2382,Talbot,542,16,144,200,526,542,1.0,0.02952029520295203,0.9704797047970479,198,0.2656826568265683,0.36900369003690037,0.36531365313653136
2383,Talbot,1172,9,488,330,1163,1172,1.0,0.007679180887372013,0.992320819112628,354,0.41638225255972694,0.2815699658703072,0.30204778156996587
2384,Talbot,485,4,217,158,481,485,1.0,0.008247422680412371,0.9917525773195877,110,0.44742268041237115,0.32577319587628867,0.2268041237113402
2385,Talbot,460,2,203,120,458,460,1.0,0.004347826086956522,0.9956521739130435,137,0.44130434782608696,0.2608695652173913,0.29782608695652174
2386,Talbot,522,3,256,189,519,522,1.0,0.005747126436781609,0.9942528735632183,77,0.4904214559386973,0.3620689655172414,0.1475095785440613
2387,Talbot,854,8,517,123,846,854,1.0,0.00936768149882904,0.990632318501171,214,0.6053864168618267,0.14402810304449648,0.2505854800936768
2388,Talbot,748,9,289,272,739,748,1.0,0.012032085561497326,0.9879679144385026,187,0.38636363636363635,0.36363636363636365,0.25
2389,Taliaferro,1037,13,447,289,1024,1037,1.0,0.01253616200578592,0.9874638379942141,301,0.43105110896817744,0.2786885245901639,0.29026036644165865
2390,Taliaferro,252,3,114,71,249,252,1.0,0.011904761904761904,0.9880952380952381,67,0.4523809523809524,0.28174603174603174,0.26587301587301587
2391,Tattnall,999,28,99,436,971,999,1.0,0.028028028028028028,0.9719719719719719,464,0.0990990990990991,0.4364364364364364,0.4644644644644645
2392,Tattnall,1652,22,227,783,1630,1652,1.0,0.013317191283292978,0.986682808716707,642,0.137409200968523,0.47397094430992737,0.38861985472154964
2393,Tattnall,3111,53,532,1073,3058,3111,1.0,0.017036322725811636,0.9829636772741883,1506,0.17100610736097718,0.34490517518482805,0.4840887174541948
2394,Tattnall,2929,33,512,1221,2896,2929,1.0,0.011266643905769888,0.9887333560942301,1196,0.17480368726527826,0.4168658245134858,0.4083304882212359
2395,Tattnall,1219,19,93,620,1200,1219,1.0,0.015586546349466776,0.9844134536505332,506,0.07629204265791632,0.5086136177194421,0.41509433962264153
2396,Tattnall,3090,53,365,1405,3037,3090,1.0,0.01715210355987055,0.9828478964401295,1320,0.11812297734627832,0.4546925566343042,0.42718446601941745
2397,Tattnall,278,1,51,145,277,278,1.0,0.0035971223021582736,0.9964028776978417,82,0.18345323741007194,0.5215827338129496,0.2949640287769784
2398,Tattnall,4376,31,182,370,4345,4376,1.0,0.007084095063985375,0.9929159049360147,3824,0.041590493601462525,0.08455210237659963,0.8738574040219378
2399,Taylor,1255,3,555,119,1252,1255,1.0,0.002390438247011952,0.9976095617529881,581,0.44223107569721115,0.09482071713147411,0.46294820717131474
2400,Taylor,2644,41,252,1364,2603,2644,1.0,0.015506807866868382,0.9844931921331316,1028,0.09531013615733737,0.5158850226928896,0.3888048411497731
2401,Taylor,2221,27,580,935,2194,2221,1.0,0.012156686177397569,0.9878433138226025,706,0.2611436289959478,0.42098153984691583,0.31787483115713644
2402,Telfair,2490,16,216,438,2474,2490,1.0,0.00642570281124498,0.993574297188755,1836,0.08674698795180723,0.17590361445783131,0.7373493975903614
2403,Telfair,720,10,95,351,710,720,1.0,0.013888888888888888,0.9861111111111112,274,0.13194444444444445,0.4875,0.38055555555555554
2404,Telfair,1217,15,334,386,1202,1217,1.0,0.012325390304026294,0.9876746096959738,497,0.2744453574363188,0.3171733771569433,0.40838126540673786
2405,Telfair,4465,35,715,893,4430,4465,1.0,0.007838745800671893,0.9921612541993281,2857,0.1601343784994401,0.2,0.6398656215005599
2406,Telfair,929,8,73,558,921,929,1.0,0.008611410118406888,0.9913885898815931,298,0.07857911733046287,0.6006458557588805,0.3207750269106566
2407,Telfair,369,5,54,199,364,369,1.0,0.013550135501355014,0.986449864498645,116,0.14634146341463414,0.5392953929539296,0.3143631436314363
2408,Terrell,777,11,281,315,766,777,1.0,0.014157014157014158,0.9858429858429858,181,0.36164736164736166,0.40540540540540543,0.23294723294723294
2409,Terrell,3630,26,1434,439,3604,3630,1.0,0.007162534435261708,0.9928374655647383,1757,0.3950413223140496,0.1209366391184573,0.4840220385674931
2410,Terrell,661,12,146,289,649,661,1.0,0.018154311649016642,0.9818456883509834,226,0.22087745839636913,0.4372163388804841,0.34190620272314676
2411,Terrell,272,1,91,118,271,272,1.0,0.003676470588235294,0.9963235294117647,63,0.33455882352941174,0.4338235294117647,0.23161764705882354
2412,Terrell,480,9,114,206,471,480,1.0,0.01875,0.98125,160,0.2375,0.42916666666666664,0.3333333333333333
2413,Terrell,1384,19,310,637,1365,1384,1.0,0.013728323699421965,0.986271676300578,437,0.2239884393063584,0.4602601156069364,0.3157514450867052
2414,Thomas,735,9,103,380,726,735,1.0,0.012244897959183673,0.9877551020408163,252,0.1401360544217687,0.5170068027210885,0.34285714285714286
2415,Thomas,1900,33,546,592,1867,1900,1.0,0.017368421052631578,0.9826315789473684,762,0.2873684210526316,0.31157894736842107,0.4010526315789474
2416,Thomas,4052,85,850,1719,3967,4052,1.0,0.020977295162882527,0.9790227048371175,1483,0.20977295162882528,0.42423494570582426,0.3659921026653504
2417,Thomas,1193,23,162,561,1170,1193,1.0,0.019279128248113998,0.980720871751886,470,0.1357921207041073,0.4702430846605197,0.393964794635373
2418,Thomas,2981,39,1211,263,2942,2981,1.0,0.013082858101308286,0.9869171418986917,1507,0.40623951694062393,0.08822542770882254,0.5055350553505535
2419,Thomas,1204,18,182,730,1186,1204,1.0,0.014950166112956811,0.9850498338870431,292,0.1511627906976744,0.606312292358804,0.2425249169435216
2420,Thomas,1521,30,324,798,1491,1521,1.0,0.01972386587771203,0.980276134122288,399,0.21301775147928995,0.52465483234714,0.26232741617357
2421,Thomas,2463,57,408,1157,2406,2463,1.0,0.023142509135200974,0.976857490864799,898,0.1656516443361754,0.4697523345513601,0.3645960211124645
2422,Thomas,2232,29,999,300,2203,2232,1.0,0.012992831541218637,0.9870071684587813,933,0.4475806451612903,0.13440860215053763,0.41801075268817206
2423,Thomas,2128,18,580,883,2110,2128,1.0,0.008458646616541353,0.9915413533834586,665,0.2725563909774436,0.4149436090225564,0.3125
2424,Thomas,1055,21,239,344,1034,1055,1.0,0.01990521327014218,0.9800947867298578,472,0.22654028436018958,0.32606635071090045,0.44739336492890996
2425,Thomas,867,25,133,368,842,867,1.0,0.02883506343713956,0.9711649365628604,366,0.15340253748558247,0.4244521337946944,0.42214532871972316
2426,Thomas,357,7,64,163,350,357,1.0,0.0196078431372549,0.9803921568627451,130,0.1792717086834734,0.4565826330532213,0.3641456582633053
2427,Thomas,2503,55,412,1160,2448,2503,1.0,0.021973631642029565,0.9780263683579704,931,0.16460247702756692,0.463443867359169,0.3719536556132641
2428,Thomas,1502,35,149,684,1467,1502,1.0,0.02330226364846871,0.9766977363515313,669,0.09920106524633822,0.45539280958721706,0.44540612516644473
2429,Thomas,483,10,58,251,473,483,1.0,0.020703933747412008,0.979296066252588,174,0.12008281573498965,0.5196687370600414,0.36024844720496896
2430,Thomas,849,13,90,401,836,849,1.0,0.015312131919905771,0.9846878680800942,358,0.10600706713780919,0.4723203769140165,0.4216725559481743
2431,Thomas,2669,42,635,973,2627,2669,1.0,0.015736230798051705,0.9842637692019482,1061,0.23791682278006743,0.3645560134881978,0.39752716373173475
2432,Thomas,1526,15,811,71,1511,1526,1.0,0.009829619921363041,0.990170380078637,644,0.5314547837483617,0.04652686762778506,0.42201834862385323
2433,Thomas,2817,54,752,1156,2763,2817,1.0,0.019169329073482427,0.9808306709265175,909,0.26695065672701457,0.4103656372026979,0.3226837060702875
2434,Tift,2378,38,304,1480,2340,2378,1.0,0.0159798149705635,0.9840201850294366,594,0.127838519764508,0.6223717409587889,0.24978973927670312
2435,Tift,2072,23,162,882,2049,2072,1.0,0.0111003861003861,0.9888996138996139,1028,0.07818532818532818,0.42567567567567566,0.49613899613899615
2436,Tift,1438,22,158,899,1416,1438,1.0,0.015299026425591099,0.9847009735744089,381,0.10987482614742698,0.625173852573018,0.26495132127955495
2437,Tift,1081,13,90,756,1068,1081,1.0,0.012025901942645698,0.9879740980573543,235,0.08325624421831637,0.6993524514338575,0.21739130434782608
2438,Tift,1581,26,111,771,1555,1581,1.0,0.01644528779253637,0.9835547122074636,699,0.07020872865275142,0.4876660341555977,0.44212523719165087
2439,Tift,3405,66,1174,272,3339,3405,1.0,0.019383259911894272,0.9806167400881057,1959,0.3447870778267254,0.07988252569750368,0.5753303964757709
2440,Tift,1427,17,129,403,1410,1427,1.0,0.011913104414856343,0.9880868955851436,895,0.09039943938332165,0.28241065171688856,0.6271899088997898
2441,Tift,4307,62,701,1344,4245,4307,1.0,0.014395170652426282,0.9856048293475738,2262,0.16275830044114234,0.3120501509171117,0.525191548641746
2442,Tift,4546,81,818,1291,4465,4546,1.0,0.01781786185657721,0.9821821381434228,2437,0.17993840739111305,0.2839859216893973,0.5360756709194897
2443,Tift,4848,63,685,1637,4785,4848,1.0,0.012995049504950494,0.9870049504950495,2526,0.1412953795379538,0.33766501650165015,0.5210396039603961
2444,Tift,2738,35,783,409,2703,2738,1.0,0.012783053323593864,0.9872169466764061,1546,0.28597516435354275,0.1493791088385683,0.5646457268078889
2445,Tift,1403,26,207,640,1377,1403,1.0,0.018531717747683536,0.9814682822523164,556,0.14754098360655737,0.45616535994297935,0.39629365645046327
2446,Toombs,5205,68,597,1656,5137,5205,1.0,0.013064361191162345,0.9869356388088376,2952,0.11469740634005764,0.31815561959654176,0.5671469740634005
2447,Toombs,1757,30,109,946,1727,1757,1.0,0.01707455890722823,0.9829254410927718,702,0.062037564029595905,0.5384177575412635,0.3995446784291406
2448,Toombs,1772,38,72,908,1734,1772,1.0,0.02144469525959368,0.9785553047404063,792,0.040632054176072234,0.5124153498871332,0.4469525959367946
2449,Toombs,6561,83,1271,2709,6478,6561,1.0,0.012650510592897424,0.9873494894071025,2581,0.19372046944063406,0.41289437585733885,0.3933851547020271
2450,Toombs,4966,71,890,1653,4895,4966,1.0,0.014297221103503826,0.9857027788964962,2423,0.1792186870720902,0.3328634716069271,0.4879178413209827
2451,Towns,4439,74,523,2162,4365,4439,1.0,0.01667042126605091,0.9833295787339491,1754,0.11781932867763009,0.48704663212435234,0.3951340391980176
2452,Towns,3016,63,477,2299,2953,3016,1.0,0.020888594164456233,0.9791114058355438,240,0.15815649867374004,0.7622679045092838,0.07957559681697612
2453,Towns,3461,67,550,1923,3394,3461,1.0,0.019358566888182605,0.9806414331118174,988,0.15891360878358857,0.555619763074256,0.28546662814215545
2454,Treutlen,2163,31,133,1300,2132,2163,1.0,0.014331946370781322,0.9856680536292187,730,0.061488673139158574,0.6010171058714748,0.3374942209893666
2455,Treutlen,2771,26,819,801,2745,2771,1.0,0.009382894261999277,0.9906171057380008,1151,0.29556116925297726,0.2890653193792855,0.41537351136773726
2456,Troup,5234,49,1423,645,5185,5234,1.0,0.009361864730607567,0.9906381352693925,3166,0.2718761941153993,0.12323270920901797,0.6048910966755827
2457,Troup,3429,73,443,1958,3356,3429,1.0,0.021289005540974047,0.978710994459026,1028,0.12919218431029456,0.5710119568387285,0.299795858850977
2458,Troup,3016,34,886,1195,2982,3016,1.0,0.011273209549071617,0.9887267904509284,935,0.2937665782493369,0.39622015915119363,0.3100132625994695
2459,Troup,2106,28,357,991,2078,2106,1.0,0.013295346628679962,0.9867046533713201,758,0.16951566951566951,0.47056030389363723,0.3599240265906933
2460,Troup,2927,27,1153,94,2900,2927,1.0,0.009224461906388794,0.9907755380936112,1680,0.39391868807652886,0.03211479330372395,0.5739665186197472
2461,Troup,5920,118,1709,1025,5802,5920,1.0,0.019932432432432434,0.9800675675675675,3186,0.2886824324324324,0.17314189189189189,0.5381756756756757
2462,Troup,2069,13,605,511,2056,2069,1.0,0.006283228612856452,0.9937167713871435,953,0.29241179313678106,0.24697921701304978,0.4606089898501692
2463,Troup,3893,98,857,1817,3795,3893,1.0,0.025173388132545594,0.9748266118674545,1219,0.22013871050603648,0.4667351656819933,0.3131261238119702
2464,Troup,4437,38,707,1997,4399,4437,1.0,0.00856434527834122,0.9914356547216587,1733,0.15934189767861168,0.4500788821275637,0.3905792201938247
2465,Troup,3610,72,626,1772,3538,3610,1.0,0.019944598337950138,0.9800554016620499,1212,0.17340720221606648,0.49085872576177286,0.33573407202216066
2466,Troup,3950,72,629,2132,3878,3950,1.0,0.018227848101265823,0.9817721518987341,1189,0.15924050632911393,0.5397468354430379,0.3010126582278481
2468,Troup,3190,71,791,1042,3119,3190,1.0,0.02225705329153605,0.977742946708464,1357,0.24796238244514107,0.3266457680250784,0.42539184952978054
2469,Troup,4377,70,561,2515,4307,4377,1.0,0.015992689056431347,0.9840073109435686,1301,0.1281699794379712,0.5745944710989263,0.2972355494631026
2470,Troup,2468,27,831,449,2441,2468,1.0,0.01094003241491086,0.9890599675850892,1188,0.336709886547812,0.18192868719611022,0.4813614262560778
2471,Turner,4358,26,1217,1025,4332,4358,1.0,0.005966039467645709,0.9940339605323543,2116,0.2792565396971088,0.2351996328591097,0.48554382744378155
2472,Turner,574,6,45,289,568,574,1.0,0.010452961672473868,0.9895470383275261,240,0.078397212543554,0.5034843205574913,0.4181184668989547
2473,Turner,2028,32,148,1035,1996,2028,1.0,0.015779092702169626,0.9842209072978304,845,0.07297830374753451,0.5103550295857988,0.4166666666666667
2474,Twiggs,1747,65,190,781,1682,1747,1.0,0.03720663995420721,0.9627933600457927,776,0.10875787063537493,0.4470520892959359,0.4441900400686892
2475,Twiggs,1799,17,687,484,1782,1799,1.0,0.009449694274596998,0.990550305725403,628,0.3818788215675375,0.26903835464146747,0.349082823790995
2476,Twiggs,821,18,151,410,803,821,1.0,0.02192448233861145,0.9780755176613886,260,0.18392204628501826,0.4993909866017052,0.3166869671132765
2477,Twiggs,1441,6,710,401,1435,1441,1.0,0.004163775156141568,0.9958362248438585,330,0.49271339347675225,0.2782789729354615,0.22900763358778625
2478,Twiggs,781,7,306,294,774,781,1.0,0.008962868117797696,0.9910371318822023,181,0.39180537772087065,0.3764404609475032,0.23175416133162613
2479,Union,3082,64,355,1518,3018,3082,1.0,0.020765736534717714,0.9792342634652823,1209,0.11518494484101233,0.4925373134328358,0.3922777417261519
2480,Union,1225,27,199,908,1198,1225,1.0,0.022040816326530613,0.9779591836734693,118,0.16244897959183674,0.7412244897959184,0.0963265306122449
2481,Union,2659,75,268,1575,2584,2659,1.0,0.028206092515983452,0.9717939074840165,816,0.10078977059044754,0.5923279428356525,0.3068822865739
2482,Union,1548,30,260,950,1518,1548,1.0,0.01937984496124031,0.9806201550387597,338,0.16795865633074936,0.6136950904392765,0.21834625322997417
2483,Union,2252,40,277,1429,2212,2252,1.0,0.017761989342806393,0.9822380106571936,546,0.12300177619893428,0.6345470692717584,0.2424511545293073
2484,Union,2224,64,267,1400,2160,2224,1.0,0.02877697841726619,0.9712230215827338,557,0.12005395683453238,0.6294964028776978,0.2504496402877698
2485,Union,2047,46,276,1342,2001,2047,1.0,0.02247191011235955,0.9775280898876404,429,0.1348314606741573,0.6555935515388374,0.20957498778700537
2486,Union,1485,25,258,962,1460,1485,1.0,0.016835016835016835,0.9831649831649831,265,0.17373737373737375,0.6478114478114478,0.17845117845117844
2487,Union,2322,57,368,1488,2265,2322,1.0,0.02454780361757106,0.975452196382429,466,0.15848406546080965,0.6408268733850129,0.20068906115417742
2488,Union,648,23,93,381,625,648,1.0,0.035493827160493825,0.9645061728395061,174,0.14351851851851852,0.5879629629629629,0.26851851851851855
2489,Union,1323,46,180,698,1277,1323,1.0,0.03476946334089191,0.9652305366591081,445,0.1360544217687075,0.527588813303099,0.3363567649281935
2490,Upson,9751,212,1280,4717,9539,9751,1.0,0.021741359860527127,0.9782586401394728,3754,0.1312685878371449,0.48374525689672854,0.38498615526612656
2491,Upson,354,0,266,44,354,354,1.0,0.0,1.0,44,0.751412429378531,0.12429378531073447,0.12429378531073447
2492,Upson,10056,147,2405,3064,9909,10056,1.0,0.014618138424821002,0.985381861575179,4587,0.2391607000795545,0.3046937151949085,0.456145584725537
2493,Upson,1550,28,250,783,1522,1550,1.0,0.01806451612903226,0.9819354838709677,517,0.16129032258064516,0.5051612903225806,0.3335483870967742
2494,Walker,1625,42,164,885,1583,1625,1.0,0.025846153846153845,0.9741538461538461,576,0.10092307692307692,0.5446153846153846,0.35446153846153844
2495,Walker,7336,217,996,3442,7119,7336,1.0,0.029580152671755726,0.9704198473282443,2898,0.13576881134133043,0.4691930207197383,0.3950381679389313
2496,Walker,7731,189,846,4089,7542,7731,1.0,0.024447031431897557,0.9755529685681025,2796,0.10942956926658906,0.5289095847885138,0.36166084594489717
2497,Walker,4085,122,418,1449,3963,4085,1.0,0.029865361077111383,0.9701346389228886,2218,0.10232558139534884,0.3547123623011016,0.5429620563035495
2498,Walker,1197,19,321,593,1178,1197,1.0,0.015873015873015872,0.9841269841269841,283,0.2681704260651629,0.4954051796157059,0.23642439431913115
2499,Walker,1544,32,199,751,1512,1544,1.0,0.02072538860103627,0.9792746113989638,594,0.12888601036269431,0.48639896373056996,0.38471502590673573
2500,Walker,8443,246,832,3325,8197,8443,1.0,0.029136562833116192,0.9708634371668838,4286,0.09854317185834419,0.3938173634963875,0.5076394646452683
2501,Walker,1544,31,178,714,1513,1544,1.0,0.020077720207253884,0.9799222797927462,652,0.11528497409326424,0.46243523316062174,0.422279792746114
2502,Walker,7685,153,700,3831,7532,7685,1.0,0.019908913467794404,0.9800910865322056,3154,0.09108653220559532,0.4985035783994795,0.4104098893949252
2503,Walker,8897,263,943,2710,8634,8897,1.0,0.029560526020006743,0.9704394739799933,5244,0.10599078341013825,0.30459705518714175,0.58941216140272
2504,Walker,2707,64,172,1385,2643,2707,1.0,0.023642408570373107,0.9763575914296269,1150,0.06353897303287773,0.5116364979682305,0.4248245289988918
2505,Walton,3329,85,498,2064,3244,3329,1.0,0.025533193151096426,0.9744668068489035,767,0.14959447281465907,0.6200060078101532,0.23039951937518774
2506,Walton,4827,105,763,3113,4722,4827,1.0,0.02175264139216905,0.978247358607831,951,0.15806919411642842,0.6449140252744976,0.19701678060907396
2507,Walton,1155,34,107,816,1121,1155,1.0,0.02943722943722944,0.9705627705627705,232,0.09264069264069263,0.7064935064935065,0.20086580086580086
2508,Walton,4598,81,738,2969,4517,4598,1.0,0.0176163549369291,0.9823836450630709,891,0.1605045672031318,0.6457155284906481,0.1937799043062201
2509,Walton,4462,113,605,2616,4349,4462,1.0,0.025324966382787986,0.974675033617212,1241,0.1355894217839534,0.5862841774988794,0.2781264007171672
2510,Walton,4546,100,922,1388,4446,4546,1.0,0.02199736031676199,0.978002639683238,2236,0.20281566212054553,0.30532336119665643,0.49186097668279805
2511,Walton,2113,39,239,1425,2074,2113,1.0,0.018457169900615238,0.9815428300993848,449,0.11310932323710364,0.6743965925224799,0.21249408424041646
2512,Walton,1196,23,131,896,1173,1196,1.0,0.019230769230769232,0.9807692307692307,169,0.10953177257525083,0.7491638795986622,0.14130434782608695
2513,Walton,2061,43,155,1412,2018,2061,1.0,0.020863658418243572,0.9791363415817564,494,0.07520621057738962,0.6851043182920912,0.23968947113051917
2514,Walton,5655,122,993,2559,5533,5655,1.0,0.021573828470380193,0.9784261715296199,2103,0.17559681697612733,0.4525198938992042,0.37188328912466845
2515,Walton,3943,89,830,1797,3854,3943,1.0,0.02257164595485671,0.9774283540451433,1316,0.21049961957900076,0.4557443570885113,0.33375602333248794
2516,Walton,1788,38,182,1026,1750,1788,1.0,0.021252796420581657,0.9787472035794184,580,0.1017897091722595,0.5738255033557047,0.3243847874720358
2517,Walton,5214,110,1512,1311,5104,5214,1.0,0.02109704641350211,0.9789029535864979,2391,0.2899884925201381,0.25143843498273877,0.45857307249712315
2518,Walton,5010,121,928,2347,4889,5010,1.0,0.024151696606786427,0.9758483033932136,1735,0.18522954091816368,0.4684630738522954,0.3463073852295409
2519,Walton,4558,64,755,1779,4494,4558,1.0,0.014041246160596753,0.9859587538394032,2024,0.16564282580078982,0.39030276437033784,0.4440544098288723
2520,Walton,4029,92,1382,1633,3937,4029,1.0,0.022834450235790518,0.9771655497642094,1014,0.34301315462894016,0.4053114916852817,0.2516753536857781
2521,Walton,2067,46,313,1276,2021,2067,1.0,0.022254475084663765,0.9777455249153363,478,0.1514271891630382,0.6173197871311079,0.2312530237058539
2522,Walton,4237,91,499,2348,4146,4237,1.0,0.021477460467311776,0.9785225395326882,1390,0.11777200849657776,0.5541656832664621,0.3280623082369601
2523,Walton,2841,74,295,1629,2767,2841,1.0,0.026047166490672298,0.9739528335093277,917,0.10383667722632876,0.573389651531151,0.32277367124252027
2524,Walton,4216,77,703,2564,4139,4216,1.0,0.018263757115749527,0.9817362428842504,949,0.16674573055028463,0.6081593927893738,0.22509487666034156
2525,Walton,1253,24,132,874,1229,1253,1.0,0.019154030327214685,0.9808459696727854,247,0.10534716679968077,0.6975259377494014,0.1971268954509178
2526,Ware,6374,83,630,2087,6291,6374,1.0,0.013021650454973329,0.9869783495450267,3657,0.09883903357389394,0.3274239096328836,0.5737370567932225
2527,Ware,1568,22,113,679,1546,1568,1.0,0.01403061224489796,0.985969387755102,776,0.07206632653061225,0.4330357142857143,0.49489795918367346
2528,Ware,3978,86,364,2212,3892,3978,1.0,0.021618903971845148,0.9783810960281548,1402,0.0915032679738562,0.5560583207642031,0.3524384112619407
2529,Ware,466,12,24,263,454,466,1.0,0.02575107296137339,0.9742489270386266,179,0.05150214592274678,0.5643776824034334,0.38412017167381973
2530,Ware,4675,56,2001,479,4619,4675,1.0,0.011978609625668449,0.9880213903743316,2195,0.42802139037433157,0.10245989304812834,0.46951871657754013
2531,Ware,3050,51,574,1062,2999,3050,1.0,0.016721311475409836,0.9832786885245902,1414,0.1881967213114754,0.3481967213114754,0.4636065573770492
2532,Ware,2227,51,290,206,2176,2227,1.0,0.022900763358778626,0.9770992366412213,1731,0.13022002694207455,0.09250112258643915,0.7772788504714863
2533,Ware,754,10,23,454,744,754,1.0,0.013262599469496022,0.986737400530504,277,0.03050397877984085,0.6021220159151194,0.3673740053050398
2534,Ware,2265,37,104,1067,2228,2265,1.0,0.016335540838852098,0.9836644591611479,1094,0.045916114790286976,0.47108167770419423,0.48300220750551875
2535,Ware,624,8,17,339,616,624,1.0,0.01282051282051282,0.9871794871794872,268,0.027243589743589744,0.5432692307692307,0.42948717948717946
2536,Ware,641,7,19,359,634,641,1.0,0.0109204368174727,0.9890795631825273,263,0.029641185647425898,0.5600624024960998,0.41029641185647425
2537,Ware,1166,16,52,658,1150,1166,1.0,0.0137221269296741,0.9862778730703259,456,0.044596912521440824,0.5643224699828473,0.3910806174957118
2538,Warren,4159,22,1469,1166,4137,4159,1.0,0.005289733108920414,0.9947102668910796,1524,0.3532099062274585,0.2803558547727819,0.3664342389997596
2539,Washington,2398,18,254,354,2380,2398,1.0,0.007506255212677231,0.9924937447873228,1790,0.10592160133444536,0.14762301918265222,0.7464553794829024
2540,Washington,563,7,111,312,556,563,1.0,0.012433392539964476,0.9875666074600356,140,0.19715808170515098,0.5541740674955595,0.24866785079928952
2541,Washington,1078,17,252,494,1061,1078,1.0,0.015769944341372914,0.9842300556586271,332,0.23376623376623376,0.4582560296846011,0.3079777365491651
2542,Washington,579,6,208,227,573,579,1.0,0.010362694300518135,0.9896373056994818,144,0.3592400690846287,0.3920552677029361,0.24870466321243523
2543,Washington,648,11,149,281,637,648,1.0,0.016975308641975308,0.9830246913580247,218,0.22993827160493827,0.43364197530864196,0.33641975308641975
2544,Washington,6809,57,2486,1942,6752,6809,1.0,0.008371273314730504,0.9916287266852695,2381,0.3651050080775444,0.2852107504773094,0.34968424144514615
2545,Washington,2916,30,1024,726,2886,2916,1.0,0.0102880658436214,0.9897119341563786,1166,0.3511659807956104,0.24897119341563786,0.3998628257887517
2546,Washington,718,7,246,327,711,718,1.0,0.009749303621169917,0.9902506963788301,145,0.3426183844011142,0.4554317548746518,0.201949860724234
2547,Wayne,3559,72,408,1379,3487,3559,1.0,0.020230401798257937,0.979769598201742,1772,0.11463894352346164,0.38746838999719024,0.49789266647934816
2548,Wayne,1262,23,73,795,1239,1262,1.0,0.018225039619651346,0.9817749603803486,394,0.05784469096671949,0.6299524564183835,0.312202852614897
2549,Wayne,1282,19,78,737,1263,1282,1.0,0.014820592823712949,0.985179407176287,467,0.060842433697347896,0.5748829953198128,0.36427457098283933
2550,Wayne,1358,14,64,845,1344,1358,1.0,0.010309278350515464,0.9896907216494846,449,0.047128129602356406,0.6222385861561119,0.33063328424153166
2551,Wayne,1393,41,89,906,1352,1393,1.0,0.029432878679109833,0.9705671213208902,398,0.06389088298636038,0.6503948312993539,0.2857142857142857
2552,Wayne,1920,29,168,1092,1891,1920,1.0,0.015104166666666667,0.9848958333333333,660,0.0875,0.56875,0.34375
2553,Wayne,1782,21,337,395,1761,1782,1.0,0.011784511784511785,0.9882154882154882,1050,0.18911335578002245,0.22166105499438832,0.5892255892255892
2554,Wayne,3108,44,282,960,3064,3108,1.0,0.014157014157014158,0.9858429858429858,1866,0.09073359073359073,0.3088803088803089,0.6003861003861004
2555,Wayne,1269,16,130,565,1253,1269,1.0,0.01260835303388495,0.987391646966115,574,0.1024428684003152,0.44523246650906223,0.4523246650906225
2556,Wayne,2137,45,195,1190,2092,2137,1.0,0.02105755732335049,0.9789424426766495,752,0.09124941506785213,0.5568554047730463,0.35189518015910154
2557,Wayne,2509,30,363,967,2479,2509,1.0,0.011956954962136309,0.9880430450378637,1179,0.14467915504184933,0.3854125149461937,0.469908330011957
2558,Wayne,1526,39,500,156,1487,1526,1.0,0.025557011795543906,0.9744429882044561,870,0.32765399737876805,0.10222804718217562,0.5701179554390564
2559,Webster,1847,36,639,748,1811,1847,1.0,0.01949106659447753,0.9805089334055225,460,0.3459664320519762,0.40498105035192206,0.24905251759610178
2560,Wheeler,4421,31,452,906,4390,4421,1.0,0.007011988237955214,0.9929880117620448,3063,0.10223931237276634,0.2049310110834653,0.6928296765437684
2561,Wheeler,1796,46,237,677,1750,1796,1.0,0.025612472160356347,0.9743875278396437,882,0.1319599109131403,0.3769487750556793,0.4910913140311804
2562,White,2538,90,359,1412,2448,2538,1.0,0.03546099290780142,0.9645390070921985,767,0.14144996059889678,0.5563435776201734,0.30220646178092986
2563,White,984,33,89,559,951,984,1.0,0.03353658536585366,0.9664634146341463,336,0.09044715447154472,0.568089430894309,0.34146341463414637
2564,White,562,13,112,307,549,562,1.0,0.023131672597864767,0.9768683274021353,143,0.199288256227758,0.5462633451957295,0.25444839857651247
2565,White,3457,111,253,1977,3346,3457,1.0,0.032108764824992767,0.9678912351750072,1227,0.07318484234885739,0.5718831356667631,0.3549320219843795
2566,White,5412,190,544,2549,5222,5412,1.0,0.03510716925351072,0.9648928307464892,2319,0.10051736881005174,0.47099039172209906,0.4284922394678492
2567,White,1386,45,365,866,1341,1386,1.0,0.032467532467532464,0.9675324675324676,155,0.26334776334776333,0.6248196248196248,0.11183261183261184
2568,White,388,5,69,245,383,388,1.0,0.01288659793814433,0.9871134020618557,74,0.17783505154639176,0.6314432989690721,0.19072164948453607
2569,White,2893,113,181,1464,2780,2893,1.0,0.03905979951607328,0.9609402004839267,1248,0.06256481161424127,0.506049083995852,0.43138610438990665
2570,White,1232,40,158,743,1192,1232,1.0,0.032467532467532464,0.9675324675324676,331,0.12824675324675325,0.6030844155844156,0.26866883116883117
2571,White,1708,56,169,948,1652,1708,1.0,0.03278688524590164,0.9672131147540983,591,0.09894613583138173,0.5550351288056206,0.34601873536299765
2572,White,1922,74,112,1152,1848,1922,1.0,0.03850156087408949,0.9614984391259105,658,0.05827263267429761,0.5993756503642039,0.34235171696149846
2573,Whitfield,4983,233,689,651,4750,4983,1.0,0.04675898053381497,0.953241019466185,3643,0.13827011840256873,0.13064419024683926,0.731085691350592
2574,Whitfield,3856,103,678,1451,3753,3856,1.0,0.02671161825726141,0.9732883817427386,1727,0.1758298755186722,0.3762966804979253,0.4478734439834025
2575,Whitfield,2577,72,559,974,2505,2577,1.0,0.027939464493597205,0.9720605355064028,1044,0.21691889794334498,0.37795886689949554,0.4051222351571595
2576,Whitfield,3037,135,710,1169,2902,3037,1.0,0.04445176160684886,0.9555482383931512,1158,0.23378333882120514,0.38491932828449127,0.38129733289430356
2577,Whitfield,4223,260,782,346,3963,4223,1.0,0.06156760596732181,0.9384323940326782,3095,0.18517641487094483,0.08193227563343594,0.7328913094956192
2578,Whitfield,4144,349,565,259,3795,4144,1.0,0.08421814671814672,0.9157818532818532,3320,0.13634169884169883,0.0625,0.8011583011583011
2579,Whitfield,4324,204,618,693,4120,4324,1.0,0.04717853839037928,0.9528214616096207,3013,0.1429232192414431,0.16026827012025902,0.6968085106382979
2580,Whitfield,2759,113,240,980,2646,2759,1.0,0.04095686843059079,0.9590431315694092,1539,0.08698803914461761,0.3552011598405219,0.5578108010148605
2581,Whitfield,1785,50,177,844,1735,1785,1.0,0.028011204481792718,0.9719887955182073,764,0.09915966386554621,0.47282913165266105,0.4280112044817927
2582,Whitfield,4699,169,698,1542,4530,4699,1.0,0.03596509895722494,0.964034901042775,2459,0.148542243030432,0.3281549265801234,0.5233028303894446
2583,Whitfield,2834,115,343,618,2719,2834,1.0,0.040578687367678196,0.9594213126323218,1873,0.12103034580098801,0.2180663373323924,0.6609033168666196
2584,Whitfield,2949,98,395,983,2851,2949,1.0,0.033231603933536795,0.9667683960664633,1571,0.1339437097321126,0.3333333333333333,0.5327229569345541
2585,Whitfield,3858,140,616,1004,3718,3858,1.0,0.036288232244686365,0.9637117677553136,2238,0.15966822187662,0.26023846552617935,0.5800933125972006
2586,Whitfield,1360,31,111,758,1329,1360,1.0,0.022794117647058822,0.9772058823529411,491,0.08161764705882353,0.5573529411764706,0.3610294117647059
2587,Whitfield,1884,55,164,1061,1829,1884,1.0,0.029193205944798302,0.9708067940552016,659,0.0870488322717622,0.5631634819532909,0.3497876857749469
2588,Whitfield,3303,101,278,1430,3202,3303,1.0,0.030578262185891613,0.9694217378141083,1595,0.0841659097789888,0.43293975174084165,0.48289433848016955
2589,Whitfield,6139,161,911,2376,5978,6139,1.0,0.026225769669327253,0.9737742303306728,2852,0.14839550415377098,0.3870337188467177,0.4645707769995113
2590,Whitfield,4703,115,546,2072,4588,4703,1.0,0.02445247714224963,0.9755475228577504,2085,0.11609610886668084,0.44056984903253243,0.44333404210078675
2591,Whitfield,1077,31,76,430,1046,1077,1.0,0.028783658310120707,0.9712163416898792,571,0.07056638811513463,0.39925719591457753,0.5301764159702879
2592,Whitfield,1430,34,132,900,1396,1430,1.0,0.023776223776223775,0.9762237762237762,398,0.09230769230769231,0.6293706293706294,0.2783216783216783
2593,Whitfield,1247,32,104,683,1215,1247,1.0,0.02566158781074579,0.9743384121892542,460,0.08340016038492382,0.5477145148356054,0.3688853247794707
2594,Whitfield,6140,154,838,2919,5986,6140,1.0,0.0250814332247557,0.9749185667752444,2383,0.13648208469055376,0.4754071661237785,0.38811074918566774
2595,Whitfield,2951,79,440,1493,2872,2951,1.0,0.02677058624195188,0.9732294137580482,1018,0.14910199932226365,0.5059301931548628,0.3449678075228736
2596,Wilcox,585,10,109,272,575,585,1.0,0.017094017094017096,0.9829059829059829,204,0.18632478632478633,0.46495726495726497,0.3487179487179487
2597,Wilcox,3037,17,149,554,3020,3037,1.0,0.005597629239380968,0.994402370760619,2334,0.04906157392163319,0.18241685874217978,0.768521567336187
2598,Wilcox,779,10,194,264,769,779,1.0,0.012836970474967908,0.9871630295250321,321,0.2490372272143774,0.33889602053915274,0.4120667522464698
2599,Wilcox,1057,14,76,563,1043,1057,1.0,0.013245033112582781,0.9867549668874173,418,0.07190160832544938,0.532639545884579,0.3954588457899716
2600,Wilcox,544,5,235,92,539,544,1.0,0.009191176470588236,0.9908088235294118,217,0.4319852941176471,0.16911764705882354,0.39889705882352944
2601,Wilcox,1216,10,99,658,1206,1216,1.0,0.008223684210526315,0.9917763157894737,459,0.08141447368421052,0.5411184210526315,0.3774671052631579
2602,Wilkes,1054,15,255,498,1039,1054,1.0,0.014231499051233396,0.9857685009487666,301,0.24193548387096775,0.47248576850094876,0.2855787476280835
2603,Wilkes,1096,6,484,192,1090,1096,1.0,0.005474452554744526,0.9945255474452555,420,0.4416058394160584,0.17518248175182483,0.38321167883211676
2604,Wilkes,700,15,132,328,685,700,1.0,0.02142857142857143,0.9785714285714285,240,0.18857142857142858,0.4685714285714286,0.34285714285714286
2605,Wilkes,701,16,136,275,685,701,1.0,0.02282453637660485,0.9771754636233951,290,0.19400855920114124,0.39229671897289586,0.4136947218259629
2606,Wilkes,1849,26,677,389,1823,1849,1.0,0.014061654948620876,0.9859383450513791,783,0.366143861546782,0.21038399134667388,0.4234721471065441
2607,Wilkes,1024,31,260,431,993,1024,1.0,0.0302734375,0.9697265625,333,0.25390625,0.4208984375,0.3251953125
2608,Wilkes,1227,23,216,710,1204,1227,1.0,0.018744906275468622,0.9812550937245313,301,0.17603911980440098,0.5786471067644662,0.24531377343113284
2609,Wilkinson,476,12,36,315,464,476,1.0,0.025210084033613446,0.9747899159663865,125,0.07563025210084033,0.6617647058823529,0.26260504201680673
2610,Wilkinson,190,4,31,125,186,190,1.0,0.021052631578947368,0.9789473684210527,34,0.1631578947368421,0.6578947368421053,0.17894736842105263
2611,Wilkinson,197,2,27,110,195,197,1.0,0.01015228426395939,0.9898477157360406,60,0.13705583756345177,0.5583756345177665,0.30456852791878175
2612,Wilkinson,933,23,360,295,910,933,1.0,0.02465166130760986,0.9753483386923901,278,0.3858520900321543,0.3161843515541265,0.2979635584137192
2613,Wilkinson,1152,31,89,549,1121,1152,1.0,0.026909722222222224,0.9730902777777778,514,0.07725694444444445,0.4765625,0.4461805555555556
2614,Wilkinson,858,19,233,317,839,858,1.0,0.022144522144522144,0.9778554778554779,308,0.2715617715617716,0.36946386946386944,0.358974358974359
2615,Wilkinson,956,9,534,121,947,956,1.0,0.009414225941422594,0.9905857740585774,301,0.5585774058577406,0.12656903765690378,0.3148535564853556
2616,Wilkinson,1859,18,667,585,1841,1859,1.0,0.009682625067240451,0.9903173749327595,607,0.3587950511027434,0.3146853146853147,0.3265196342119419
2617,Wilkinson,405,22,98,247,383,405,1.0,0.05432098765432099,0.945679012345679,60,0.2419753086419753,0.6098765432098765,0.14814814814814814
2618,Worth,1439,25,134,689,1414,1439,1.0,0.017373175816539264,0.9826268241834607,616,0.09312022237665045,0.4788047255038221,0.42807505211952745
2619,Worth,995,6,83,415,989,995,1.0,0.006030150753768844,0.9939698492462311,497,0.08341708542713568,0.41708542713567837,0.4994974874371859
2620,Worth,497,20,30,284,477,497,1.0,0.04024144869215292,0.959758551307847,183,0.060362173038229376,0.5714285714285714,0.3682092555331992
2621,Worth,1503,30,126,879,1473,1503,1.0,0.01996007984031936,0.9800399201596807,498,0.08383233532934131,0.5848303393213573,0.3313373253493014
2622,Worth,608,5,29,383,603,608,1.0,0.008223684210526315,0.9917763157894737,196,0.047697368421052634,0.6299342105263158,0.3223684210526316
2623,Worth,208,5,47,104,203,208,1.0,0.02403846153846154,0.9759615384615384,57,0.22596153846153846,0.5,0.27403846153846156
2624,Worth,363,13,83,127,350,363,1.0,0.03581267217630854,0.9641873278236914,153,0.22865013774104684,0.349862258953168,0.4214876033057851
2625,Worth,955,30,112,485,925,955,1.0,0.031413612565445025,0.9685863874345549,358,0.11727748691099477,0.5078534031413613,0.374869109947644
2626,Worth,1337,14,152,585,1323,1337,1.0,0.010471204188481676,0.9895287958115183,600,0.11368735976065819,0.43754674644727,0.4487658937920718
2627,Worth,753,2,28,380,751,753,1.0,0.0026560424966799467,0.99734395750332,345,0.03718459495351926,0.5046480743691899,0.4581673306772908
2628,Worth,597,13,45,375,584,597,1.0,0.021775544388609715,0.9782244556113903,177,0.07537688442211055,0.628140703517588,0.2964824120603015
2629,Worth,975,24,113,462,951,975,1.0,0.024615384615384615,0.9753846153846154,400,0.1158974358974359,0.47384615384615386,0.41025641025641024
2630,Worth,1625,26,225,709,1599,1625,1.0,0.016,0.984,691,0.13846153846153847,0.4363076923076923,0.42523076923076925
2631,Worth,3243,35,1045,616,3208,3243,1.0,0.010792476102374344,0.9892075238976257,1582,0.32223250077089116,0.18994757940178847,0.48781991982732037
2632,Worth,1346,6,143,337,1340,1346,1.0,0.004457652303120356,0.9955423476968797,866,0.1062407132243685,0.25037147102526003,0.6433878157503715
