,COUNTY,VAP,AMINVAP,PRES20D,PRES20R,OVAP,TOT_VOTES,factor,AMINVAP_pct,OVAP_pct,PRES20None,PRES20D_pct,PRES20R_pct,PRES20None_pct
30,Appling,1433,4,116,870,1429,1433,1.0,0.0027913468248429866,0.9972086531751571,447,0.08094905792044661,0.6071179344033496,0.31193300767620374
31,Appling,1192,0,44,594,1192,1192,1.0,0.0,1.0,554,0.03691275167785235,0.4983221476510067,0.46476510067114096
32,Appling,2639,8,908,531,2631,2639,1.0,0.0030314513073133762,0.9969685486926866,1200,0.3440697233800682,0.20121258052292534,0.45471769609700646
33,Appling,865,8,20,587,857,865,1.0,0.009248554913294798,0.9907514450867052,258,0.023121387283236993,0.6786127167630058,0.29826589595375724
34,Appling,1920,15,288,843,1905,1920,1.0,0.0078125,0.9921875,789,0.15,0.4390625,0.4109375
35,Appling,990,3,23,647,987,990,1.0,0.0030303030303030303,0.996969696969697,320,0.023232323232323233,0.6535353535353535,0.32323232323232326
36,Appling,1880,7,130,1048,1873,1880,1.0,0.003723404255319149,0.9962765957446809,702,0.06914893617021277,0.5574468085106383,0.37340425531914895
37,Appling,1624,10,118,697,1614,1624,1.0,0.006157635467980296,0.9938423645320197,809,0.07266009852216748,0.4291871921182266,0.4981527093596059
38,Appling,1415,13,132,709,1402,1415,1.0,0.009187279151943463,0.9908127208480565,574,0.09328621908127209,0.5010600706713781,0.4056537102473498
39,Atkinson,973,12,45,479,961,973,1.0,0.012332990750256937,0.987667009249743,449,0.046248715313463515,0.49229188078108943,0.4614594039054471
40,Atkinson,1316,10,329,229,1306,1316,1.0,0.007598784194528876,0.9924012158054711,758,0.25,0.17401215805471124,0.5759878419452887
41,Atkinson,2289,16,160,1026,2273,2289,1.0,0.0069899519440803845,0.9930100480559196,1103,0.06989951944080385,0.44823066841415465,0.4818698121450415
42,Atkinson,1551,13,291,566,1538,1551,1.0,0.008381689232753063,0.9916183107672469,694,0.18762088974854932,0.3649258542875564,0.44745325596389424
43,Bacon,8310,14,625,4018,8296,8310,1.0,0.0016847172081829122,0.9983152827918171,3667,0.07521058965102287,0.4835138387484958,0.44127557160048136
44,Baker,186,0,31,93,186,186,1.0,0.0,1.0,62,0.16666666666666666,0.5,0.3333333333333333
45,Baker,388,0,148,141,388,388,1.0,0.0,1.0,99,0.38144329896907214,0.3634020618556701,0.2551546391752577
46,Baker,327,0,111,120,327,327,1.0,0.0,1.0,96,0.3394495412844037,0.3669724770642202,0.29357798165137616
47,Baker,286,0,69,137,286,286,1.0,0.0,1.0,80,0.24125874125874125,0.479020979020979,0.27972027972027974
48,Baker,1088,0,293,406,1088,1088,1.0,0.0,1.0,389,0.2693014705882353,0.37316176470588236,0.35753676470588236
49,Baldwin,1325,4,547,134,1321,1325,1.0,0.0030188679245283017,0.9969811320754717,644,0.41283018867924526,0.10113207547169811,0.48603773584905663
50,Baldwin,3295,2,331,153,3293,3295,1.0,0.0006069802731411229,0.9993930197268589,2811,0.10045523520485584,0.0464339908952959,0.8531107738998482
51,Baldwin,1682,0,320,784,1682,1682,1.0,0.0,1.0,578,0.1902497027348395,0.4661117717003567,0.3436385255648038
52,Baldwin,2953,7,169,113,2946,2953,1.0,0.0023704707077548256,0.9976295292922451,2671,0.05722993565865222,0.038266169996613614,0.9045038943447342
53,Baldwin,4077,13,1159,1581,4064,4077,1.0,0.003188619082658818,0.9968113809173412,1337,0.2842776551385823,0.387785136129507,0.32793720873191073
54,Baldwin,1545,6,520,140,1539,1545,1.0,0.003883495145631068,0.996116504854369,885,0.3365695792880259,0.09061488673139159,0.5728155339805825
55,Baldwin,1383,3,711,212,1380,1383,1.0,0.0021691973969631237,0.9978308026030369,460,0.5140997830802603,0.15328994938539406,0.33261026753434564
56,Baldwin,2926,4,831,1366,2922,2926,1.0,0.001367053998632946,0.9986329460013671,729,0.28400546821599454,0.46684894053315107,0.24914559125085442
57,Baldwin,3929,1,810,1891,3928,3929,1.0,0.00025451768897938407,0.9997454823110206,1228,0.2061593280733011,0.48129294986001525,0.31254772206668363
58,Baldwin,2567,8,859,793,2559,2567,1.0,0.0031164783794312427,0.9968835216205687,915,0.3346318659914297,0.3089209193611219,0.3564472146474484
59,Baldwin,1354,3,275,426,1351,1354,1.0,0.0022156573116691287,0.9977843426883308,653,0.20310192023633677,0.31462333825701627,0.48227474150664695
60,Baldwin,3058,6,583,179,3052,3058,1.0,0.001962066710268149,0.9980379332897319,2296,0.1906474820143885,0.05853499018966645,0.750817527795945
61,Baldwin,2208,3,604,731,2205,2208,1.0,0.001358695652173913,0.998641304347826,873,0.27355072463768115,0.33106884057971014,0.3953804347826087
62,Baldwin,3420,11,1421,400,3409,3420,1.0,0.003216374269005848,0.9967836257309941,1599,0.4154970760233918,0.11695906432748537,0.4675438596491228
63,Banks,1628,5,100,901,1623,1628,1.0,0.003071253071253071,0.9969287469287469,627,0.06142506142506143,0.5534398034398035,0.38513513513513514
64,Banks,951,4,103,528,947,951,1.0,0.004206098843322818,0.9957939011566772,320,0.10830704521556257,0.555205047318612,0.33648790746582546
65,Banks,425,2,29,266,423,425,1.0,0.004705882352941176,0.9952941176470588,130,0.06823529411764706,0.6258823529411764,0.3058823529411765
66,Banks,894,2,42,468,892,894,1.0,0.0022371364653243847,0.9977628635346756,384,0.04697986577181208,0.5234899328859061,0.42953020134228187
67,Banks,399,1,20,258,398,399,1.0,0.002506265664160401,0.9974937343358395,121,0.05012531328320802,0.6466165413533834,0.3032581453634085
68,Banks,2052,19,166,1107,2033,2052,1.0,0.009259259259259259,0.9907407407407407,779,0.08089668615984405,0.5394736842105263,0.37962962962962965
69,Banks,1236,10,80,538,1226,1236,1.0,0.008090614886731391,0.9919093851132686,618,0.06472491909385113,0.43527508090614886,0.5
70,Banks,598,10,33,387,588,598,1.0,0.016722408026755852,0.9832775919732442,178,0.05518394648829431,0.6471571906354515,0.2976588628762542
71,Banks,735,5,53,432,730,735,1.0,0.006802721088435374,0.9931972789115646,250,0.07210884353741497,0.5877551020408164,0.3401360544217687
72,Banks,1619,5,108,957,1614,1619,1.0,0.0030883261272390363,0.9969116738727609,554,0.06670784434836319,0.5911056207535516,0.34218653489808526
73,Banks,1913,10,113,1121,1903,1913,1.0,0.005227391531625719,0.9947726084683742,679,0.05906952430737062,0.5859905906952431,0.3549398849973863
74,Banks,783,3,53,438,780,783,1.0,0.0038314176245210726,0.9961685823754789,292,0.06768837803320563,0.5593869731800766,0.37292464878671777
75,Banks,654,2,32,394,652,654,1.0,0.0030581039755351682,0.9969418960244648,228,0.04892966360856269,0.6024464831804281,0.3486238532110092
76,Barrow,3784,24,560,1728,3760,3784,1.0,0.006342494714587738,0.9936575052854123,1496,0.14799154334038056,0.45665961945031713,0.3953488372093023
77,Barrow,7641,25,966,4033,7616,7641,1.0,0.0032718230598089257,0.9967281769401911,2642,0.12642324303101687,0.5278104960083758,0.34576626096060725
78,Barrow,6992,38,943,3098,6954,6992,1.0,0.005434782608695652,0.9945652173913043,2951,0.13486842105263158,0.4430778032036613,0.4220537757437071
79,Barrow,4582,22,624,1904,4560,4582,1.0,0.004801396769969445,0.9951986032300305,2054,0.13618507202095154,0.41553906591008294,0.4482758620689655
80,Barrow,9044,28,1743,4198,9016,9044,1.0,0.0030959752321981426,0.9969040247678018,3103,0.19272445820433437,0.4641751437417072,0.3431003980539584
81,Barrow,7577,39,1114,3784,7538,7577,1.0,0.0051471558664379045,0.9948528441335621,2679,0.1470238880823545,0.4994060974000264,0.3535700145176191
82,Barrow,10492,45,2036,3664,10447,10492,1.0,0.00428898208158597,0.995711017918414,4792,0.19405261151353412,0.3492184521540221,0.45672893633244377
83,Barrow,12083,65,2467,4395,12018,12083,1.0,0.005379458743689481,0.9946205412563105,5221,0.20417114954895307,0.363734171977158,0.43209467847388894
84,Bartow,7759,35,908,3819,7724,7759,1.0,0.00451089057868282,0.9954891094213172,3032,0.11702538986982859,0.4922026034282768,0.39077200670189455
85,Bartow,5228,53,696,1997,5175,5228,1.0,0.010137719969395562,0.9898622800306044,2535,0.1331293037490436,0.3819816373374139,0.48488905891354245
86,Bartow,9166,51,1527,2810,9115,9166,1.0,0.005564041021165176,0.9944359589788349,4829,0.16659393410429849,0.30656775038184597,0.5268383155138555
87,Bartow,8597,36,1776,4030,8561,8597,1.0,0.0041875072699778994,0.9958124927300221,2791,0.20658369198557636,0.46876817494474815,0.3246481330696755
88,Bartow,12578,45,1940,5487,12533,12578,1.0,0.0035776753060899986,0.99642232469391,5151,0.15423755764032437,0.43623787565590716,0.40952456670376847
89,Bartow,4032,24,568,2312,4008,4032,1.0,0.005952380952380952,0.9940476190476191,1152,0.14087301587301587,0.5734126984126984,0.2857142857142857
90,Bartow,3599,24,414,1582,3575,3599,1.0,0.0066685190330647405,0.9933314809669352,1603,0.11503195332036677,0.4395665462628508,0.44540150041678245
91,Bartow,5582,18,853,2859,5564,5582,1.0,0.0032246506628448583,0.9967753493371552,1870,0.1528126119670369,0.5121820136151917,0.3350053744177714
92,Bartow,1609,4,113,897,1605,1609,1.0,0.002486016159105034,0.997513983840895,599,0.07022995649471722,0.5574891236793039,0.3722809198259789
93,Bartow,3180,15,305,1550,3165,3180,1.0,0.0047169811320754715,0.9952830188679245,1325,0.0959119496855346,0.48742138364779874,0.4166666666666667
94,Bartow,4452,30,711,2070,4422,4452,1.0,0.006738544474393531,0.9932614555256065,1671,0.1597035040431267,0.46495956873315364,0.3753369272237197
95,Bartow,2267,3,189,1369,2264,2267,1.0,0.0013233348037053375,0.9986766651962946,709,0.08337009263343625,0.603881782090869,0.31274812527569473
96,Bartow,3058,11,206,1861,3047,3058,1.0,0.0035971223021582736,0.9964028776978417,991,0.06736429038587312,0.6085676913015042,0.3240680183126226
97,Bartow,2752,7,275,1648,2745,2752,1.0,0.002543604651162791,0.9974563953488372,829,0.09992732558139535,0.5988372093023255,0.3012354651162791
98,Bartow,1985,10,297,961,1975,1985,1.0,0.005037783375314861,0.9949622166246851,727,0.14962216624685137,0.4841309823677582,0.3662468513853904
99,Bartow,7726,28,1314,2422,7698,7726,1.0,0.0036241263266891016,0.9963758736733109,3990,0.1700750711881957,0.3134869272586073,0.516438001553197
100,Ben Hill,5226,30,1182,1249,5196,5226,1.0,0.0057405281285878304,0.9942594718714122,2795,0.2261768082663605,0.23899732108687333,0.5348258706467661
101,Ben Hill,7939,28,1210,2861,7911,7939,1.0,0.0035268925557374983,0.9964731074442625,3868,0.1524121425872276,0.3603728429273208,0.48721501448545157
102,Berrien,1201,0,206,622,1201,1201,1.0,0.0,1.0,373,0.17152373022481265,0.517901748542881,0.3105745212323064
103,Berrien,1449,4,86,636,1445,1449,1.0,0.0027605244996549345,0.9972394755003451,727,0.05935127674258109,0.4389233954451346,0.5017253278122843
104,Berrien,7532,22,694,3393,7510,7532,1.0,0.0029208709506107276,0.9970791290493892,3445,0.09214020180562932,0.45047796070100904,0.45738183749336164
105,Berrien,2281,7,216,1062,2274,2281,1.0,0.003068829460762823,0.9969311705392372,1003,0.09469530907496712,0.4655852696185883,0.43971942130644454
106,Berrien,1227,1,67,706,1226,1227,1.0,0.0008149959250203749,0.9991850040749797,454,0.05460472697636512,0.5753871230643847,0.3700081499592502
107,Bibb,2140,11,929,47,2129,2140,1.0,0.0051401869158878505,0.9948598130841122,1164,0.43411214953271027,0.021962616822429906,0.5439252336448598
108,Bibb,3994,4,2169,157,3990,3994,1.0,0.00100150225338007,0.99899849774662,1668,0.543064596895343,0.03930896344516775,0.41762643965948926
109,Bibb,3862,21,1563,570,3841,3862,1.0,0.0054375970999482135,0.9945624029000518,1729,0.4047125841532884,0.14759192128430865,0.4476954945624029
110,Bibb,2586,4,1309,95,2582,2586,1.0,0.0015467904098994587,0.9984532095901005,1182,0.5061871616395979,0.036736272235112145,0.45707656612529
111,Bibb,2629,1,1264,379,2628,2629,1.0,0.0003803727653100038,0.99961962723469,986,0.4807911753518448,0.14416127805249143,0.37504754659566375
112,Bibb,8865,5,2987,326,8860,8865,1.0,0.0005640157924421884,0.9994359842075579,5552,0.3369430344049633,0.03677382966723068,0.6262831359278059
113,Bibb,2424,15,795,98,2409,2424,1.0,0.006188118811881188,0.9938118811881188,1531,0.327970297029703,0.040429042904290426,0.6316006600660066
114,Bibb,3314,16,1543,175,3298,3314,1.0,0.004828002414001207,0.9951719975859988,1596,0.4656004828002414,0.0528062764031382,0.4815932407966204
115,Bibb,2561,4,826,139,2557,2561,1.0,0.0015618898867629833,0.998438110113237,1596,0.322530261616556,0.054275673565013664,0.6231940648184303
116,Bibb,4809,14,2328,301,4795,4809,1.0,0.002911208151382824,0.9970887918486172,2180,0.4840923268870867,0.06259097525473072,0.45331669785818257
117,Bibb,3702,12,1676,232,3690,3702,1.0,0.0032414910858995136,0.9967585089141004,1794,0.45272825499729874,0.06266882766072393,0.4846029173419773
118,Bibb,4632,14,1606,1215,4618,4632,1.0,0.0030224525043177895,0.9969775474956822,1811,0.34671848013816925,0.2623056994818653,0.3909758203799655
119,Bibb,7711,15,3284,1201,7696,7711,1.0,0.0019452729866424588,0.9980547270133575,3226,0.4258850992089223,0.15575152379717286,0.4183633769939048
120,Bibb,3731,9,1618,2112,3722,3731,1.6548358473824312,0.0024122219244170464,0.997587778075583,1,0.4336638970785312,0.5660680782632003,0.0002680246582685607
121,Bibb,4850,22,992,1727,4828,4850,1.0,0.004536082474226804,0.9954639175257732,2131,0.2045360824742268,0.3560824742268041,0.43938144329896905
122,Bibb,4427,15,929,1734,4412,4427,1.0,0.00338829907386492,0.996611700926135,1764,0.2098486559747007,0.39168737293878475,0.39846397108651455
123,Bibb,9877,18,2233,2397,9859,9877,1.0,0.0018224157132732612,0.9981775842867268,5247,0.22608079376328843,0.24268502581755594,0.5312341804191556
124,Bibb,1902,4,625,577,1898,1902,1.0,0.002103049421661409,0.9978969505783386,700,0.3286014721345952,0.30336487907465826,0.36803364879074657
125,Bibb,1735,1,917,535,1734,1735,1.0,0.0005763688760806917,0.9994236311239193,283,0.5285302593659942,0.30835734870317005,0.16311239193083574
126,Bibb,2315,0,736,878,2315,2315,1.0,0.0,1.0,701,0.31792656587473,0.3792656587473002,0.30280777537796977
127,Bibb,2519,1,851,1421,2518,2519,1.0,0.0003969829297340214,0.999603017070266,247,0.33783247320365223,0.5641127431520445,0.0980547836443033
128,Bibb,6343,19,1784,2559,6324,6343,1.0,0.0029954280309002048,0.9970045719690998,2000,0.2812549266908403,0.40343685953019076,0.31530821377896895
129,Bibb,3698,14,863,1590,3684,3698,1.0,0.0037858301784748512,0.9962141698215251,1245,0.23336938885884262,0.42996214169821523,0.33666846944294215
130,Bibb,4995,17,1509,670,4978,4995,1.0,0.0034034034034034033,0.9965965965965966,2816,0.3021021021021021,0.13413413413413414,0.5637637637637638
131,Bibb,2293,4,939,291,2289,2293,1.0,0.0017444395987788923,0.9982555604012211,1063,0.40950719581334494,0.12690798081116442,0.4635848233754906
132,Bibb,3293,17,1601,153,3276,3293,1.0,0.00516246583662314,0.9948375341633768,1539,0.48618281202550867,0.04646219252960826,0.46735499544488307
133,Bibb,4185,3,2042,283,4182,4185,1.0,0.0007168458781362007,0.9992831541218637,1860,0.4879330943847073,0.06762246117084826,0.4444444444444444
134,Bibb,2418,0,818,913,2418,2418,1.0,0.0,1.0,687,0.33829611248966085,0.3775847808105873,0.2841191066997519
135,Bibb,3398,7,1180,937,3391,3398,1.0,0.0020600353148911123,0.9979399646851089,1281,0.3472630959387875,0.2757504414361389,0.37698646262507357
136,Bibb,2717,7,675,1300,2710,2717,1.0,0.002576370997423629,0.9974236290025764,742,0.24843577475156423,0.4784688995215311,0.27309532572690465
137,Bibb,4437,4,877,1573,4433,4437,1.0,0.000901510029299076,0.9990984899707009,1987,0.1976560739238224,0.3545188190218616,0.447825107054316
138,Bleckley,9613,13,1311,4328,9600,9613,1.0,0.0013523353791740351,0.998647664620826,3974,0.13637782169978155,0.4502236554665557,0.41339852283366274
139,Brantley,3852,7,164,2210,3845,3852,1.0,0.0018172377985462098,0.9981827622014537,1478,0.04257528556593977,0.5737279335410177,0.3836967808930426
140,Brantley,4787,24,268,2522,4763,4787,1.0,0.005013578441612701,0.9949864215583873,1997,0.055984959264675165,0.5268435345728013,0.4171715061625235
141,Brantley,5053,24,267,2259,5029,5053,1.0,0.004749653671086484,0.9952503463289135,2527,0.052839897090837126,0.44706115179101524,0.5000989511181476
142,Brooks,396,3,67,181,393,396,1.0,0.007575757575757576,0.9924242424242424,148,0.1691919191919192,0.45707070707070707,0.37373737373737376
143,Brooks,2726,5,315,1148,2721,2726,1.0,0.001834189288334556,0.9981658107116654,1263,0.11555392516507704,0.42112986060161406,0.4633162142333089
144,Brooks,1170,3,395,363,1167,1170,1.0,0.002564102564102564,0.9974358974358974,412,0.33760683760683763,0.31025641025641026,0.35213675213675216
145,Brooks,2255,7,399,925,2248,2255,1.0,0.0031042128603104213,0.9968957871396896,931,0.17694013303769401,0.41019955654101997,0.412860310421286
146,Brooks,868,5,86,421,863,868,1.0,0.00576036866359447,0.9942396313364056,361,0.09907834101382489,0.48502304147465436,0.41589861751152074
147,Brooks,693,2,122,314,691,693,1.0,0.002886002886002886,0.9971139971139971,257,0.17604617604617603,0.4531024531024531,0.3708513708513709
148,Brooks,4639,16,1406,908,4623,4639,1.0,0.0034490191851692174,0.9965509808148307,2325,0.303082560896745,0.1957318387583531,0.5011856003449019
149,Bryan,3117,14,393,1442,3103,3117,1.0,0.004491498235482836,0.9955085017645172,1282,0.1260827718960539,0.4626243182547321,0.41129290984921396
150,Bryan,2208,3,435,1213,2205,2208,1.0,0.001358695652173913,0.998641304347826,560,0.19701086956521738,0.5493659420289855,0.2536231884057971
151,Bryan,2351,6,302,1300,2345,2351,1.0,0.002552105487026797,0.9974478945129732,749,0.1284559761803488,0.552956188855806,0.3185878349638452
152,Bryan,6186,40,1393,2528,6146,6186,1.0,0.006466214031684449,0.9935337859683155,2265,0.22518590365341093,0.40866472680245713,0.3661493695441319
153,Bryan,2818,10,573,1654,2808,2818,1.0,0.0035486160397444995,0.9964513839602555,591,0.20333569907735982,0.5869410929737402,0.20972320794889993
154,Bryan,3881,14,1017,2205,3867,3881,1.0,0.003607317701623293,0.9963926822983767,659,0.26204586446792066,0.5681525380056687,0.16980159752641072
155,Bryan,2844,8,567,1111,2836,2844,1.0,0.0028129395218002813,0.9971870604781997,1166,0.19936708860759494,0.3906469760900141,0.409985935302391
156,Bryan,2616,10,635,937,2606,2616,1.0,0.00382262996941896,0.996177370030581,1044,0.24273700305810397,0.3581804281345566,0.39908256880733944
157,Bryan,3660,7,888,1137,3653,3660,1.0,0.001912568306010929,0.9980874316939891,1635,0.24262295081967214,0.31065573770491806,0.44672131147540983
158,Bryan,2147,10,536,717,2137,2147,1.0,0.004657661853749418,0.9953423381462506,894,0.2496506753609688,0.33395435491383324,0.41639496972519796
159,Bulloch,1795,6,203,987,1789,1795,1.0,0.003342618384401114,0.9966573816155989,605,0.11309192200557103,0.5498607242339832,0.3370473537604457
160,Bulloch,1946,3,398,1129,1943,1946,1.0,0.001541623843782117,0.9984583761562179,419,0.20452209660842754,0.5801644398766701,0.21531346351490235
161,Bulloch,3545,10,565,1880,3535,3545,1.0,0.0028208744710860366,0.997179125528914,1100,0.15937940761636107,0.5303244005641748,0.31029619181946405
162,Bulloch,7185,6,1988,1737,7179,7185,1.0,0.0008350730688935282,0.9991649269311065,3460,0.27668754349338903,0.24175365344467642,0.4815588030619346
163,Bulloch,4276,16,757,1620,4260,4276,1.0,0.0037418147801683817,0.9962581852198317,1899,0.17703461178671656,0.37885874649204865,0.4441066417212348
164,Bulloch,10397,43,1705,2559,10354,10397,1.0,0.00413580840627104,0.995864191593729,6133,0.1639896123881889,0.2461286909685486,0.5898816966432625
165,Bulloch,2646,2,575,1079,2644,2646,1.0,0.0007558578987150416,0.999244142101285,992,0.21730914588057446,0.40778533635676495,0.3749055177626606
166,Bulloch,1084,0,112,630,1084,1084,1.0,0.0,1.0,342,0.1033210332103321,0.5811808118081181,0.3154981549815498
167,Bulloch,767,1,150,385,766,767,1.0,0.001303780964797914,0.9986962190352021,232,0.19556714471968709,0.5019556714471969,0.30247718383311606
168,Bulloch,1395,3,169,740,1392,1395,1.0,0.002150537634408602,0.9978494623655914,486,0.12114695340501792,0.5304659498207885,0.34838709677419355
169,Bulloch,14780,24,1725,992,14756,14780,1.0,0.0016238159675236806,0.9983761840324763,12063,0.11671177266576455,0.06711772665764547,0.81617050067659
170,Bulloch,2018,4,309,839,2014,2018,1.0,0.0019821605550049554,0.998017839444995,870,0.1531219028741328,0.4157581764122894,0.4311199207135778
171,Bulloch,1101,11,217,411,1090,1101,1.0,0.009990917347865577,0.9900090826521344,473,0.19709355131698456,0.37329700272479566,0.4296094459582198
172,Bulloch,543,2,60,298,541,543,1.0,0.003683241252302026,0.996316758747698,185,0.11049723756906077,0.5488029465930019,0.3406998158379374
173,Bulloch,8543,23,2074,1907,8520,8543,1.0,0.0026922626711927892,0.9973077373288072,4562,0.2427718600023411,0.22322369191150648,0.5340044480861524
174,Bulloch,2473,13,236,1193,2460,2473,1.0,0.005256773150020219,0.9947432268499797,1044,0.09543065103113627,0.48241002830570157,0.42215932066316214
175,Burke,475,3,113,158,472,475,1.0,0.00631578947368421,0.9936842105263158,204,0.23789473684210527,0.33263157894736844,0.42947368421052634
176,Burke,694,1,237,165,693,694,1.0,0.001440922190201729,0.9985590778097982,292,0.3414985590778098,0.2377521613832853,0.4207492795389049
177,Burke,2809,11,503,1086,2798,2809,1.0,0.003915984336062656,0.9960840156639373,1220,0.17906728373086508,0.3866144535421858,0.43431826272694907
178,Burke,828,2,242,232,826,828,1.0,0.0024154589371980675,0.9975845410628019,354,0.2922705314009662,0.28019323671497587,0.427536231884058
179,Burke,453,0,189,116,453,453,1.0,0.0,1.0,148,0.41721854304635764,0.2560706401766004,0.32671081677704195
180,Burke,1216,3,271,412,1213,1216,1.0,0.0024671052631578946,0.9975328947368421,533,0.22286184210526316,0.33881578947368424,0.43832236842105265
181,Burke,597,0,141,119,597,597,1.0,0.0,1.0,337,0.23618090452261306,0.19932998324958123,0.5644891122278057
182,Burke,530,0,181,122,530,530,1.0,0.0,1.0,227,0.34150943396226413,0.23018867924528302,0.42830188679245285
183,Burke,243,0,81,116,243,243,1.0,0.0,1.0,46,0.3333333333333333,0.4773662551440329,0.18930041152263374
184,Burke,3297,16,1296,482,3281,3297,1.0,0.004852896572641796,0.9951471034273582,1519,0.39308462238398545,0.1461935092508341,0.4607218683651805
185,Burke,1262,4,257,392,1258,1262,1.0,0.003169572107765452,0.9968304278922345,613,0.20364500792393028,0.31061806656101426,0.4857369255150555
186,Burke,251,0,128,63,251,251,1.0,0.0,1.0,60,0.5099601593625498,0.250996015936255,0.23904382470119523
187,Burke,3804,8,1007,1281,3796,3804,1.0,0.002103049421661409,0.9978969505783386,1516,0.2647213459516299,0.33675078864353314,0.39852786540483703
188,Burke,460,2,143,173,458,460,1.0,0.004347826086956522,0.9956521739130435,144,0.3108695652173913,0.3760869565217391,0.3130434782608696
189,Burke,1492,2,315,378,1490,1492,1.0,0.0013404825737265416,0.9986595174262735,799,0.2111260053619303,0.25335120643431636,0.5355227882037533
190,Burke,367,1,105,105,366,367,1.0,0.0027247956403269754,0.997275204359673,157,0.28610354223433243,0.28610354223433243,0.42779291553133514
191,Butts,20360,39,3274,8406,20321,20360,1.0,0.0019155206286836934,0.9980844793713163,8680,0.16080550098231827,0.41286836935166993,0.4263261296660118
192,Calhoun,607,2,348,121,605,607,1.0,0.0032948929159802307,0.9967051070840197,138,0.5733113673805601,0.19934102141680396,0.2273476112026359
193,Calhoun,804,0,243,64,804,804,1.0,0.0,1.0,497,0.30223880597014924,0.07960199004975124,0.6181592039800995
194,Calhoun,630,0,234,161,630,630,1.0,0.0,1.0,235,0.37142857142857144,0.25555555555555554,0.373015873015873
195,Calhoun,581,4,291,227,577,581,1.0,0.0068846815834767644,0.9931153184165232,63,0.5008605851979346,0.39070567986230637,0.10843373493975904
196,Calhoun,2065,2,144,350,2063,2065,1.0,0.0009685230024213075,0.9990314769975787,1571,0.06973365617433414,0.1694915254237288,0.7607748184019371
197,Camden,938,3,74,384,935,938,1.0,0.0031982942430703624,0.9968017057569296,480,0.07889125799573561,0.4093816631130064,0.511727078891258
198,Camden,7567,54,1604,2825,7513,7567,1.0,0.007136249504427118,0.9928637504955728,3138,0.2119730408352055,0.37333157129641864,0.41469538786837584
199,Camden,2038,7,299,1075,2031,2038,1.0,0.0034347399411187437,0.9965652600588812,664,0.1467124631992149,0.52747791952895,0.3258096172718351
200,Camden,2512,14,485,763,2498,2512,1.0,0.005573248407643312,0.9944267515923567,1264,0.1930732484076433,0.3037420382165605,0.5031847133757962
201,Camden,4247,29,845,1222,4218,4247,1.0,0.006828349423122204,0.9931716505768778,2180,0.19896397457028492,0.28773251707087355,0.5133035083588415
202,Camden,3214,22,639,1308,3192,3214,1.0,0.006845052893590542,0.9931549471064095,1267,0.19881767268201617,0.40696950840074675,0.3942128189172371
203,Camden,2770,10,804,747,2760,2770,1.0,0.0036101083032490976,0.9963898916967509,1219,0.29025270758122745,0.2696750902527076,0.44007220216606496
204,Camden,5094,13,387,555,5081,5094,1.0,0.002552021986650962,0.9974479780133491,4152,0.07597173144876325,0.10895170789163722,0.8150765606595995
205,Camden,2352,7,546,1013,2345,2352,1.0,0.002976190476190476,0.9970238095238095,793,0.23214285714285715,0.4306972789115646,0.33715986394557823
206,Camden,1099,3,192,490,1096,1099,1.0,0.00272975432211101,0.997270245677889,417,0.17470427661510465,0.445859872611465,0.3794358507734304
207,Camden,1531,5,347,886,1526,1531,1.0,0.0032658393207054214,0.9967341606792945,298,0.22664924885695623,0.5787067276290007,0.1946440235140431
208,Camden,3084,7,497,1355,3077,3084,1.0,0.002269779507133593,0.9977302204928664,1232,0.1611543450064851,0.4393644617380026,0.39948119325551235
209,Camden,3356,11,708,1786,3345,3356,1.0,0.0032777115613825984,0.9967222884386174,862,0.21096543504171633,0.5321811680572109,0.25685339690107273
210,Camden,2006,12,540,842,1994,2006,1.0,0.005982053838484547,0.9940179461615155,624,0.2691924227318046,0.419740777666999,0.31106679960119643
211,Candler,8241,30,1269,3133,8211,8241,1.0,0.0036403349108117948,0.9963596650891882,3839,0.15398616672733892,0.38017230918577843,0.4658415240868827
212,Carroll,4838,22,1066,1585,4816,4838,1.0,0.0045473336089293095,0.9954526663910707,2187,0.22033898305084745,0.3276147168251344,0.4520463001240182
213,Carroll,4432,38,1035,1327,4394,4432,1.0,0.008574007220216607,0.9914259927797834,2070,0.23352888086642598,0.299413357400722,0.46705776173285196
214,Carroll,3461,11,493,1483,3450,3461,1.0,0.003178272175671771,0.9968217278243282,1485,0.14244438023692574,0.42848887604738517,0.4290667437156891
215,Carroll,1510,11,227,738,1499,1510,1.0,0.00728476821192053,0.9927152317880795,545,0.15033112582781458,0.48874172185430464,0.3609271523178808
216,Carroll,1698,10,337,638,1688,1698,1.0,0.005889281507656066,0.9941107184923439,723,0.19846878680800942,0.375736160188457,0.42579505300353354
217,Carroll,1569,2,188,886,1567,1569,1.0,0.0012746972594008922,0.9987253027405991,495,0.11982154238368388,0.5646908859145953,0.3154875717017208
218,Carroll,1839,7,163,1188,1832,1839,1.0,0.0038064165307232192,0.9961935834692768,488,0.08863512778684067,0.6460032626427407,0.2653616095704187
219,Carroll,3704,8,617,2095,3696,3704,1.0,0.0021598272138228943,0.9978401727861771,992,0.1665766738660907,0.5656047516198704,0.2678185745140389
220,Carroll,2951,13,739,994,2938,2951,1.0,0.004405286343612335,0.9955947136563876,1218,0.25042358522534736,0.3368349711962047,0.412741443578448
221,Carroll,3514,15,782,2151,3499,3514,1.0,0.0042686397268070575,0.995731360273193,581,0.22253841775754127,0.612122936824132,0.16533864541832669
222,Carroll,2442,4,309,1401,2438,2442,1.0,0.001638001638001638,0.9983619983619983,732,0.12653562653562653,0.5737100737100738,0.29975429975429974
223,Carroll,1215,2,68,787,1213,1215,1.0,0.0016460905349794238,0.9983539094650206,360,0.05596707818930041,0.6477366255144033,0.2962962962962963
224,Carroll,1851,8,440,590,1843,1851,1.0,0.004321988114532685,0.9956780118854673,821,0.23770934629929769,0.3187466234467855,0.4435440302539168
225,Carroll,2812,13,293,1452,2799,2812,1.0,0.004623044096728307,0.9953769559032717,1067,0.10419630156472262,0.5163584637268848,0.3794452347083926
226,Carroll,1792,4,254,847,1788,1792,1.0,0.002232142857142857,0.9977678571428571,691,0.14174107142857142,0.47265625,0.38560267857142855
227,Carroll,2262,9,437,1216,2253,2262,1.0,0.003978779840848806,0.9960212201591512,609,0.1931918656056587,0.537577365163572,0.2692307692307692
228,Carroll,3240,4,334,1865,3236,3240,1.0,0.0012345679012345679,0.9987654320987654,1041,0.10308641975308643,0.5756172839506173,0.3212962962962963
229,Carroll,4791,34,765,2053,4757,4791,1.0,0.00709663953245669,0.9929033604675433,1973,0.1596743894802755,0.4285117929451054,0.4118138175746191
230,Carroll,1790,9,407,708,1781,1790,1.0,0.005027932960893855,0.9949720670391061,675,0.22737430167597766,0.39553072625698327,0.3770949720670391
231,Carroll,3625,8,774,1527,3617,3625,1.0,0.002206896551724138,0.9977931034482759,1324,0.21351724137931036,0.42124137931034483,0.36524137931034484
232,Carroll,4552,19,506,2154,4533,4552,1.0,0.0041739894551845345,0.9958260105448155,1892,0.11115992970123023,0.47319859402460457,0.4156414762741652
233,Carroll,1932,4,188,1168,1928,1932,1.0,0.002070393374741201,0.9979296066252588,576,0.09730848861283643,0.6045548654244306,0.2981366459627329
234,Carroll,4607,12,596,667,4595,4607,1.0,0.002604731929672238,0.9973952680703277,3344,0.12936835250705447,0.14477968309094855,0.725851964401997
235,Carroll,5684,28,1030,2358,5656,5684,1.0,0.0049261083743842365,0.9950738916256158,2296,0.181210415200563,0.41484869809992964,0.4039408866995074
236,Carroll,3056,21,417,1490,3035,3056,1.0,0.0068717277486911,0.993128272251309,1149,0.13645287958115182,0.487565445026178,0.37598167539267013
237,Carroll,7020,18,2140,2067,7002,7020,1.0,0.002564102564102564,0.9974358974358974,2813,0.30484330484330485,0.29444444444444445,0.4007122507122507
238,Carroll,6571,34,1429,802,6537,6571,1.0,0.005174250494597474,0.9948257495054025,4340,0.2174707046111703,0.12205143813726982,0.6604778572515598
239,Carroll,2259,11,204,1239,2248,2259,1.0,0.004869411243913236,0.9951305887560867,816,0.0903054448871182,0.548472775564409,0.3612217795484728
240,Catoosa,2500,11,208,1088,2489,2500,1.0,0.0044,0.9956,1204,0.0832,0.4352,0.4816
241,Catoosa,6331,7,996,3501,6324,6331,1.0,0.001105670510187964,0.998894329489812,1834,0.15732111830674458,0.5529932080240089,0.2896856736692466
242,Catoosa,2978,11,329,1532,2967,2978,1.0,0.0036937541974479517,0.996306245802552,1117,0.11047683008730692,0.5144392209536601,0.3750839489590329
243,Catoosa,2602,18,351,1641,2584,2602,1.0,0.006917755572636433,0.9930822444273636,610,0.13489623366641046,0.6306687163720215,0.23443504996156803
244,Catoosa,5141,13,701,1989,5128,5141,1.0,0.0025286909161641702,0.9974713090838359,2451,0.1363547947870064,0.3868897101731181,0.4767554950398755
245,Catoosa,5067,15,658,2439,5052,5067,1.0,0.002960331557134399,0.9970396684428656,1970,0.12985987763962897,0.48134991119005327,0.38879021117031776
246,Catoosa,4676,31,485,1654,4645,4676,1.0,0.006629597946963216,0.9933704020530368,2537,0.10372112917023096,0.35372112917023096,0.5425577416595381
247,Catoosa,4428,8,582,2433,4420,4428,1.0,0.0018066847335140017,0.998193315266486,1413,0.13143631436314362,0.5494579945799458,0.31910569105691056
248,Catoosa,8267,38,1327,4080,8229,8267,1.0,0.0045965888472239026,0.9954034111527761,2860,0.1605177210596347,0.49352848675456634,0.34595379218579897
249,Catoosa,7328,40,902,2958,7288,7328,1.0,0.0054585152838427945,0.9945414847161572,3468,0.12308951965065502,0.4036572052401747,0.4732532751091703
250,Catoosa,3130,4,393,1852,3126,3130,1.0,0.0012779552715654952,0.9987220447284345,885,0.1255591054313099,0.5916932907348242,0.2827476038338658
251,Charlton,829,8,54,535,821,829,1.0,0.009650180940892641,0.9903498190591074,240,0.06513872135102533,0.6453558504221955,0.28950542822677927
252,Charlton,5094,7,844,711,5087,5094,1.0,0.0013741656851197488,0.9986258343148803,3539,0.165685119748724,0.13957597173144876,0.6947389085198272
253,Charlton,899,3,60,486,896,899,1.0,0.0033370411568409346,0.996662958843159,353,0.06674082313681869,0.5406006674082313,0.39265850945494996
254,Charlton,846,1,21,332,845,846,1.0,0.001182033096926714,0.9988179669030733,493,0.024822695035460994,0.39243498817966904,0.58274231678487
255,Charlton,960,13,64,538,947,960,1.0,0.013541666666666667,0.9864583333333333,358,0.06666666666666667,0.5604166666666667,0.3729166666666667
256,Charlton,307,1,20,194,306,307,1.0,0.003257328990228013,0.996742671009772,93,0.06514657980456026,0.6319218241042345,0.30293159609120524
257,Charlton,873,5,22,418,868,873,1.0,0.0057273768613974796,0.9942726231386025,433,0.025200458190148912,0.47880870561282934,0.4959908361970218
258,Charlton,327,2,18,205,325,327,1.0,0.0061162079510703364,0.9938837920489296,104,0.05504587155963303,0.6269113149847095,0.3180428134556575
259,Chatham,3155,10,1597,952,3145,3155,1.0,0.003169572107765452,0.9968304278922345,606,0.5061806656101426,0.301743264659271,0.19207606973058636
260,Chatham,2530,3,949,595,2527,2530,1.0,0.0011857707509881424,0.9988142292490119,986,0.375098814229249,0.23517786561264822,0.3897233201581028
261,Chatham,2017,5,704,854,2012,2017,1.0,0.002478929102627665,0.9975210708973723,459,0.3490332176499752,0.42340109072880516,0.22756569162121965
262,Chatham,1930,1,587,628,1929,1930,1.0,0.0005181347150259067,0.9994818652849741,715,0.30414507772020727,0.32538860103626943,0.3704663212435233
263,Chatham,870,4,265,181,866,870,1.0,0.004597701149425287,0.9954022988505747,424,0.3045977011494253,0.20804597701149424,0.48735632183908045
264,Chatham,1049,1,300,626,1048,1049,1.0,0.0009532888465204957,0.9990467111534795,123,0.2859866539561487,0.5967588179218303,0.11725452812202097
265,Chatham,1780,0,544,1080,1780,1780,1.0,0.0,1.0,156,0.3056179775280899,0.6067415730337079,0.08764044943820225
266,Chatham,1477,2,414,589,1475,1477,1.0,0.0013540961408259986,0.998645903859174,474,0.28029790115098174,0.3987813134732566,0.3209207853757617
267,Chatham,1858,12,488,785,1846,1858,1.0,0.006458557588805167,0.9935414424111948,585,0.26264800861141013,0.422497308934338,0.3148546824542519
268,Chatham,3425,31,589,1497,3394,3425,1.0,0.009051094890510949,0.9909489051094891,1339,0.17197080291970804,0.4370802919708029,0.39094890510948904
269,Chatham,3314,7,860,1666,3307,3314,1.0,0.002112251056125528,0.9978877489438744,788,0.2595051297525649,0.5027157513578757,0.23777911888955944
270,Chatham,2045,15,713,161,2030,2045,1.0,0.007334963325183374,0.9926650366748166,1171,0.3486552567237164,0.07872860635696821,0.5726161369193155
271,Chatham,1936,5,707,115,1931,1936,1.0,0.0025826446280991736,0.9974173553719008,1114,0.36518595041322316,0.059400826446280995,0.5754132231404959
272,Chatham,3262,10,1647,129,3252,3262,1.0,0.0030656039239730227,0.996934396076027,1486,0.5049049662783568,0.039546290619251995,0.4555487431023912
273,Chatham,2006,5,1123,135,2001,2006,1.0,0.0024925224327018943,0.9975074775672981,748,0.5598205383848455,0.06729810568295115,0.3728813559322034
274,Chatham,680,9,335,65,671,680,1.0,0.013235294117647059,0.986764705882353,280,0.49264705882352944,0.09558823529411764,0.4117647058823529
275,Chatham,2933,9,1347,220,2924,2933,1.0,0.003068530514831231,0.9969314694851688,1366,0.4592567337197409,0.07500852369587453,0.4657347425843846
276,Chatham,3391,6,1742,256,3385,3391,1.0,0.0017693895606015924,0.9982306104393984,1393,0.5137127690946623,0.07549395458566795,0.4107932763196697
277,Chatham,1943,2,839,163,1941,1943,1.0,0.001029336078229542,0.9989706639217705,941,0.43180648481729283,0.08389089037570767,0.4843026248069995
278,Chatham,2115,2,823,123,2113,2115,1.0,0.0009456264775413711,0.9990543735224586,1169,0.38912529550827424,0.05815602836879433,0.5527186761229315
279,Chatham,822,3,176,122,819,822,1.0,0.0036496350364963502,0.9963503649635036,524,0.2141119221411192,0.14841849148418493,0.6374695863746959
280,Chatham,2148,4,709,410,2144,2148,1.0,0.00186219739292365,0.9981378026070763,1029,0.330074487895717,0.1908752327746741,0.4790502793296089
281,Chatham,1291,5,537,64,1286,1291,1.0,0.0038729666924864447,0.9961270333075135,690,0.4159566227730441,0.049573973663826494,0.5344694035631293
282,Chatham,1455,1,798,63,1454,1455,1.0,0.0006872852233676976,0.9993127147766323,594,0.5484536082474227,0.04329896907216495,0.40824742268041236
283,Chatham,2227,11,884,300,2216,2227,1.0,0.004939380332285586,0.9950606196677144,1043,0.3969465648854962,0.1347103726986978,0.46834306241580603
284,Chatham,1235,4,565,217,1231,1235,1.0,0.0032388663967611335,0.9967611336032388,453,0.4574898785425101,0.1757085020242915,0.3668016194331984
285,Chatham,686,4,222,296,682,686,1.0,0.0058309037900874635,0.9941690962099126,168,0.3236151603498542,0.4314868804664723,0.24489795918367346
286,Chatham,3589,3,1369,220,3586,3589,1.0,0.0008358874338255781,0.9991641125661744,2000,0.38144329896907214,0.061298411813875735,0.5572582892170521
287,Chatham,1505,3,707,162,1502,1505,1.0,0.0019933554817275745,0.9980066445182725,636,0.4697674418604651,0.10764119601328903,0.4225913621262459
288,Chatham,2724,2,629,528,2722,2724,1.0,0.0007342143906020558,0.9992657856093979,1567,0.23091042584434654,0.19383259911894274,0.5752569750367107
289,Chatham,2296,4,845,525,2292,2296,1.0,0.0017421602787456446,0.9982578397212544,926,0.3680313588850174,0.22865853658536586,0.40331010452961674
290,Chatham,2370,1,1186,344,2369,2370,1.0,0.0004219409282700422,0.9995780590717299,840,0.5004219409282701,0.1451476793248945,0.35443037974683544
291,Chatham,1388,3,361,278,1385,1388,1.0,0.002161383285302594,0.9978386167146974,749,0.2600864553314121,0.20028818443804033,0.5396253602305475
292,Chatham,2640,6,647,1044,2634,2640,1.0,0.0022727272727272726,0.9977272727272727,949,0.24507575757575759,0.39545454545454545,0.359469696969697
293,Chatham,2333,7,608,1222,2326,2333,1.0,0.0030004286326618087,0.9969995713673382,503,0.26060865837976854,0.5237891127303901,0.2156022288898414
294,Chatham,2345,4,601,1125,2341,2345,1.0,0.0017057569296375266,0.9982942430703625,619,0.2562899786780384,0.47974413646055436,0.26396588486140726
295,Chatham,2135,3,531,1226,2132,2135,1.0,0.001405152224824356,0.9985948477751756,378,0.248711943793911,0.5742388758782201,0.17704918032786884
296,Chatham,3802,11,907,1568,3791,3802,1.0,0.0028932140978432403,0.9971067859021567,1327,0.23855865334034718,0.4124145186743819,0.3490268279852709
297,Chatham,2475,0,669,1497,2475,2475,1.0,0.0,1.0,309,0.2703030303030303,0.6048484848484849,0.12484848484848485
298,Chatham,1536,3,471,674,1533,1536,1.0,0.001953125,0.998046875,391,0.306640625,0.4388020833333333,0.2545572916666667
299,Chatham,1588,12,489,772,1576,1588,1.0,0.007556675062972292,0.9924433249370277,327,0.3079345088161209,0.48614609571788414,0.20591939546599497
300,Chatham,2137,1,618,1353,2136,2137,1.0,0.0004679457182966776,0.9995320542817033,166,0.28919045390734677,0.6331305568554048,0.07767898923724847
301,Chatham,2338,0,739,1375,2338,2338,1.0,0.0,1.0,224,0.316082121471343,0.588109495295124,0.09580838323353294
302,Chatham,1719,2,554,948,1717,1719,1.0,0.0011634671320535194,0.9988365328679465,217,0.3222803955788249,0.5514834205933682,0.12623618382780685
303,Chatham,1816,0,572,992,1816,1816,1.0,0.0,1.0,252,0.31497797356828194,0.5462555066079295,0.13876651982378854
304,Chatham,1182,1,456,155,1181,1182,1.0,0.0008460236886632825,0.9991539763113367,571,0.38578680203045684,0.1311336717428088,0.48307952622673433
305,Chatham,1474,12,350,51,1462,1474,1.0,0.008141112618724558,0.9918588873812755,1073,0.23744911804613297,0.03459972862957938,0.7279511533242876
306,Chatham,1508,4,550,22,1504,1508,1.0,0.002652519893899204,0.9973474801061007,936,0.3647214854111406,0.014588859416445624,0.6206896551724138
307,Chatham,2290,3,1593,54,2287,2290,1.0,0.0013100436681222707,0.9986899563318777,643,0.6956331877729257,0.023580786026200874,0.28078602620087334
308,Chatham,3496,19,1054,197,3477,3496,1.0,0.005434782608695652,0.9945652173913043,2245,0.301487414187643,0.05635011441647597,0.642162471395881
309,Chatham,2562,7,791,261,2555,2562,1.0,0.00273224043715847,0.9972677595628415,1510,0.3087431693989071,0.10187353629976581,0.5893832943013271
310,Chatham,2191,9,817,304,2182,2191,1.0,0.004107713372889092,0.9958922866271109,1070,0.372889091738932,0.13874942948425376,0.48836147877681424
311,Chatham,3349,13,1910,102,3336,3349,1.0,0.003881755747984473,0.9961182442520156,1337,0.5703194983577187,0.030456852791878174,0.3992236488504031
312,Chatham,3659,1,1332,398,3658,3659,1.0,0.00027329871549603714,0.9997267012845039,1929,0.3640338890407215,0.10877288876742279,0.5271932221918557
313,Chatham,2209,10,754,402,2199,2209,1.0,0.004526935264825713,0.9954730647351743,1053,0.3413309189678588,0.18198279764599365,0.4766862833861476
314,Chatham,2224,2,771,996,2222,2224,1.0,0.0008992805755395684,0.9991007194244604,457,0.3466726618705036,0.447841726618705,0.20548561151079137
315,Chatham,2896,10,1170,772,2886,2896,1.0,0.003453038674033149,0.9965469613259669,954,0.40400552486187846,0.26657458563535913,0.3294198895027624
316,Chatham,2191,5,790,436,2186,2191,1.0,0.0022820629849383844,0.9977179370150616,965,0.3605659516202647,0.19899589228662712,0.44043815609310816
317,Chatham,1781,2,474,442,1779,1781,1.0,0.0011229646266142617,0.9988770353733858,865,0.26614261650758003,0.24817518248175183,0.48568220101066817
318,Chatham,2814,24,912,334,2790,2814,1.0,0.008528784648187633,0.9914712153518124,1568,0.32409381663113007,0.11869225302061123,0.5572139303482587
319,Chatham,4299,7,1261,977,4292,4299,1.0,0.0016282856478250756,0.998371714352175,2061,0.2933240288439172,0.22726215398929983,0.479413817166783
320,Chatham,4493,18,1557,1367,4475,4493,1.0,0.0040062319163142665,0.9959937680836858,1569,0.34653906076118407,0.30425105720008905,0.3492098820387269
321,Chatham,6294,46,2091,994,6248,6294,1.0,0.0073085478233238,0.9926914521766762,3209,0.33222116301239274,0.1579281855735621,0.5098506514140452
322,Chatham,1891,10,408,496,1881,1891,1.0,0.005288207297726071,0.994711792702274,987,0.2157588577472237,0.26229508196721313,0.5219460602855632
323,Chatham,1622,6,244,510,1616,1622,1.0,0.0036991368680641184,0.9963008631319359,868,0.1504315659679408,0.31442663378545005,0.5351418002466092
324,Chatham,5000,17,1464,441,4983,5000,1.0,0.0034,0.9966,3095,0.2928,0.0882,0.619
325,Chatham,1802,12,433,311,1790,1802,1.0,0.006659267480577136,0.9933407325194229,1058,0.24028856825749167,0.17258601553829078,0.5871254162042175
326,Chatham,4030,30,1087,1030,4000,4030,1.0,0.007444168734491315,0.9925558312655087,1913,0.269727047146402,0.2555831265508685,0.47468982630272955
327,Chatham,8052,40,2187,2581,8012,8052,1.0,0.004967709885742673,0.9950322901142573,3284,0.2716095380029806,0.32054148037754593,0.4078489816194734
328,Chatham,3793,17,366,1387,3776,3793,1.0,0.004481940416556815,0.9955180595834432,2040,0.09649354073292908,0.3656736092802531,0.5378328499868178
329,Chatham,4316,47,979,705,4269,4316,1.0,0.010889712696941613,0.9891102873030584,2632,0.2268303985171455,0.1633456904541242,0.6098239110287303
330,Chatham,4934,32,1652,900,4902,4934,1.0,0.0064856100526955816,0.9935143899473045,2382,0.3348196189704094,0.18240778273206323,0.4827725982975274
331,Chatham,9448,26,2508,1464,9422,9448,1.0,0.00275190516511431,0.9972480948348857,5476,0.26545300592718035,0.15495342929720576,0.5795935647756139
332,Chatham,7658,13,2600,2370,7645,7658,1.0,0.0016975711674066336,0.9983024288325933,2688,0.3395142334813267,0.30948028205797856,0.3510054844606947
333,Chatham,2343,10,775,1289,2333,2343,1.0,0.004268032437046522,0.9957319675629535,279,0.3307725138711054,0.5501493811352967,0.11907810499359796
334,Chatham,8229,30,3374,1629,8199,8229,1.0,0.0036456434560699965,0.99635435654393,3226,0.4100133673593389,0.1979584396646008,0.3920281929760603
335,Chatham,1521,4,974,546,1517,1521,1.1377245508982037,0.0026298487836949377,0.997370151216305,1,0.6403681788297173,0.358974358974359,0.0006574621959237344
336,Chatham,4751,33,267,64,4718,4751,1.0,0.0069459061250263104,0.9930540938749737,4420,0.05619869501157651,0.013470848242475268,0.9303304567459483
337,Chatham,2351,4,827,172,2347,2351,1.0,0.0017014036580178648,0.9982985963419821,1352,0.35176520629519353,0.07316035729476818,0.5750744364100383
338,Chatham,1253,6,164,304,1247,1253,1.0,0.004788507581803671,0.9952114924181963,785,0.13088587390263368,0.24261771747805266,0.6264964086193137
339,Chatham,1604,9,639,36,1595,1604,1.0,0.005610972568578554,0.9943890274314214,929,0.3983790523690773,0.022443890274314215,0.5791770573566085
340,Chatham,1122,10,509,26,1112,1122,1.0,0.008912655971479501,0.9910873440285205,587,0.4536541889483066,0.023172905525846704,0.5231729055258467
341,Chatham,611,0,320,17,611,611,1.0,0.0,1.0,274,0.5237315875613748,0.027823240589198037,0.44844517184942717
342,Chatham,1611,5,867,36,1606,1611,1.0,0.0031036623215394167,0.9968963376784605,708,0.5381750465549349,0.0223463687150838,0.43947858472998136
343,Chatham,1250,2,672,23,1248,1250,1.0,0.0016,0.9984,555,0.5376,0.0184,0.444
344,Chatham,1685,1,989,14,1684,1685,1.0,0.0005934718100890207,0.9994065281899109,682,0.5869436201780416,0.00830860534124629,0.40474777448071214
345,Chatham,1204,2,938,17,1202,1204,1.0,0.0016611295681063123,0.9983388704318937,249,0.7790697674418605,0.014119601328903655,0.20681063122923588
346,Chatham,3581,11,526,114,3570,3581,1.0,0.0030717676626640603,0.996928232337336,2941,0.14688634459648142,0.031834683049427534,0.8212789723540911
347,Chatham,2027,43,140,268,1984,2027,1.0,0.021213616181549086,0.978786383818451,1619,0.06906758756783424,0.1322150962012827,0.798717316230883
348,Chatham,1983,16,745,78,1967,1983,1.0,0.008068582955118508,0.9919314170448815,1160,0.3756933938477055,0.039334341906202726,0.5849722642460918
349,Chattahoochee,1957,6,667,880,1951,1957,1.0,0.0030659172202350538,0.9969340827797649,410,0.34082779764946347,0.44966785896780787,0.20950434338272866
350,Chattooga,952,4,109,551,948,952,1.0,0.004201680672268907,0.9957983193277311,292,0.11449579831932773,0.5787815126050421,0.3067226890756303
351,Chattooga,1194,4,116,637,1190,1194,1.0,0.0033500837520938024,0.9966499162479062,441,0.09715242881072027,0.533500837520938,0.3693467336683417
352,Chattooga,325,2,62,131,323,325,1.0,0.006153846153846154,0.9938461538461538,132,0.19076923076923077,0.40307692307692305,0.40615384615384614
353,Chattooga,185,1,19,113,184,185,1.0,0.005405405405405406,0.9945945945945946,53,0.10270270270270271,0.6108108108108108,0.2864864864864865
354,Chattooga,1014,3,114,598,1011,1014,1.0,0.0029585798816568047,0.9970414201183432,302,0.11242603550295859,0.5897435897435898,0.2978303747534517
355,Chattooga,190,1,15,100,189,190,1.0,0.005263157894736842,0.9947368421052631,75,0.07894736842105263,0.5263157894736842,0.39473684210526316
356,Chattooga,1124,7,108,537,1117,1124,1.0,0.006227758007117438,0.9937722419928826,479,0.09608540925266904,0.4777580071174377,0.4261565836298932
357,Chattooga,1648,10,51,305,1638,1648,1.0,0.006067961165048544,0.9939320388349514,1292,0.030946601941747573,0.18507281553398058,0.7839805825242718
358,Chattooga,202,0,10,94,202,202,1.0,0.0,1.0,98,0.04950495049504951,0.46534653465346537,0.48514851485148514
359,Chattooga,560,3,37,348,557,560,1.0,0.005357142857142857,0.9946428571428572,175,0.06607142857142857,0.6214285714285714,0.3125
360,Chattooga,7115,12,845,2643,7103,7115,1.0,0.0016865776528460997,0.9983134223471539,3627,0.11876317638791287,0.3714687280393535,0.5097680955727336
361,Chattooga,4907,22,368,2007,4885,4907,1.0,0.004483391073975953,0.995516608926024,2532,0.07499490523741593,0.4090075402486244,0.5159975545139597
362,Cherokee,3218,28,943,1512,3190,3218,1.0,0.00870105655686762,0.9912989434431324,763,0.2930391547545059,0.4698570540708515,0.23710379117464264
363,Cherokee,4968,23,1099,2796,4945,4968,1.0,0.004629629629629629,0.9953703703703703,1073,0.2212157809983897,0.5628019323671497,0.21598228663446054
364,Cherokee,3341,8,580,2302,3333,3341,1.0,0.002394492666866208,0.9976055073331338,459,0.17360071834780005,0.6890152648907513,0.13738401676144868
365,Cherokee,3958,12,489,2549,3946,3958,1.0,0.003031834259727135,0.9969681657402729,920,0.12354724608388075,0.6440121273370389,0.23244062657908035
366,Cherokee,4158,11,981,2158,4147,4158,1.0,0.0026455026455026454,0.9973544973544973,1019,0.23593073593073594,0.518999518999519,0.24506974506974508
367,Cherokee,6538,36,1816,2262,6502,6538,1.0,0.005506271030896299,0.9944937289691037,2460,0.2777607831141022,0.3459773631079841,0.3762618537779137
368,Cherokee,4189,2,1009,2049,4187,4189,1.0,0.00047744091668656003,0.9995225590833134,1131,0.24086894246836954,0.48913821914538075,0.2699928383862497
369,Cherokee,4279,19,958,2674,4260,4279,1.0,0.004440289787333489,0.9955597102126665,647,0.22388408506660434,0.6249123627015658,0.15120355223182988
370,Cherokee,4750,14,1123,2996,4736,4750,1.0,0.0029473684210526317,0.9970526315789474,631,0.23642105263157895,0.6307368421052632,0.1328421052631579
371,Cherokee,10111,139,1894,3814,9972,10111,1.0,0.01374740381762437,0.9862525961823756,4403,0.18732073978834932,0.3772129364058946,0.4354663238057561
372,Cherokee,5346,15,1316,1723,5331,5346,1.0,0.0028058361391694723,0.9971941638608305,2307,0.24616535727646838,0.3222970445192667,0.43153759820426485
373,Cherokee,4928,17,790,2864,4911,4928,1.0,0.0034496753246753245,0.9965503246753247,1274,0.16030844155844157,0.5811688311688312,0.2585227272727273
374,Cherokee,1046,6,64,616,1040,1046,1.0,0.0057361376673040155,0.994263862332696,366,0.06118546845124283,0.5889101338432122,0.34990439770554493
375,Cherokee,3194,14,836,1488,3180,3194,1.0,0.004383218534752661,0.9956167814652473,870,0.2617407639323732,0.4658735128365686,0.27238572323105825
376,Cherokee,6683,25,1607,2313,6658,6683,1.0,0.0037408349543618137,0.9962591650456382,2763,0.24046087086637738,0.346102049977555,0.41343707915606764
377,Cherokee,5580,21,1016,3596,5559,5580,1.0,0.003763440860215054,0.9962365591397849,968,0.182078853046595,0.6444444444444445,0.17347670250896058
378,Cherokee,7100,22,1813,4012,7078,7100,1.0,0.0030985915492957746,0.9969014084507042,1275,0.25535211267605634,0.5650704225352112,0.1795774647887324
379,Cherokee,3442,6,438,2308,3436,3442,1.0,0.0017431725740848344,0.9982568274259151,696,0.1272515979081929,0.6705403834979663,0.2022080185938408
380,Cherokee,2849,4,735,1799,2845,2849,1.0,0.001404001404001404,0.9985959985959986,315,0.257985257985258,0.6314496314496314,0.11056511056511056
381,Cherokee,3798,34,579,1579,3764,3798,1.0,0.008952080042127435,0.9910479199578726,1640,0.1524486571879937,0.4157451290152712,0.4318062137967351
382,Cherokee,6495,33,1268,2380,6462,6495,1.0,0.005080831408775982,0.994919168591224,2847,0.19522709776751349,0.36643571978444955,0.43833718244803693
383,Cherokee,8908,29,1996,3870,8879,8908,1.0,0.0032555006735518633,0.9967444993264482,3042,0.22406825325550067,0.4344409519533004,0.3414907947911989
384,Cherokee,7774,12,2310,3584,7762,7774,1.0,0.0015436068947774634,0.9984563931052225,1880,0.29714432724466167,0.461023925906869,0.24183174684846925
385,Cherokee,4685,7,889,3016,4678,4685,1.0,0.0014941302027748132,0.9985058697972252,780,0.18975453575240128,0.6437566702241195,0.1664887940234792
386,Cherokee,3229,3,653,1755,3226,3229,1.0,0.0009290802105915144,0.9990709197894085,821,0.20222979250541964,0.5435119231960359,0.25425828429854447
387,Cherokee,8649,20,2179,3295,8629,8649,1.0,0.002312406058503873,0.9976875939414961,3175,0.251936640073997,0.38096889813851315,0.3670944617874899
388,Cherokee,3971,22,770,1847,3949,3971,1.0,0.00554016620498615,0.9944598337950139,1354,0.19390581717451524,0.4651221354822463,0.3409720473432385
389,Cherokee,3970,29,332,2237,3941,3970,1.0,0.007304785894206549,0.9926952141057934,1401,0.0836272040302267,0.5634760705289672,0.352896725440806
390,Cherokee,3685,50,513,1021,3635,3685,1.0,0.013568521031207599,0.9864314789687924,2151,0.13921302578018996,0.27706919945725916,0.5837177747625509
391,Cherokee,3601,7,922,1971,3594,3601,1.0,0.0019439044709802832,0.9980560955290197,708,0.25603998889197443,0.5473479589003055,0.19661205220772007
392,Cherokee,705,1,69,454,704,705,1.0,0.0014184397163120568,0.9985815602836879,182,0.09787234042553192,0.6439716312056738,0.2581560283687943
393,Cherokee,3015,4,708,1787,3011,3015,1.0,0.0013266998341625207,0.9986733001658374,520,0.23482587064676616,0.5927031509121061,0.1724709784411277
394,Cherokee,2563,12,324,1696,2551,2563,1.0,0.0046820132657042525,0.9953179867342957,543,0.12641435817401483,0.6617245415528678,0.21186110027311744
395,Cherokee,9173,125,1663,4326,9048,9173,1.0,0.013626948653657473,0.9863730513463426,3184,0.18129292488825902,0.47160143900577783,0.3471056361059632
396,Cherokee,6906,18,1599,3429,6888,6906,1.0,0.0026064291920069507,0.9973935708079931,1878,0.2315377932232841,0.4965247610773241,0.2719374456993918
397,Cherokee,4109,4,712,2693,4105,4109,1.0,0.0009734728644439036,0.9990265271355561,704,0.17327816987101485,0.6553906059868582,0.17133122414212704
398,Cherokee,6225,24,863,3167,6201,6225,1.0,0.0038554216867469878,0.996144578313253,2195,0.13863453815261045,0.5087550200803213,0.3526104417670683
399,Cherokee,2930,24,599,1677,2906,2930,1.0,0.008191126279863481,0.9918088737201365,654,0.2044368600682594,0.5723549488054608,0.22320819112627988
400,Cherokee,3057,5,524,1709,3052,3057,1.0,0.0016355904481517827,0.9983644095518482,824,0.17140987896630683,0.5590448151782793,0.2695453058554138
401,Cherokee,3511,18,613,1756,3493,3511,1.0,0.005126744517231558,0.9948732554827684,1142,0.17459413272571916,0.5001424095699231,0.3252634577043577
402,Cherokee,3798,7,1078,1553,3791,3798,1.0,0.0018430753027909425,0.9981569246972091,1167,0.2838335966298052,0.408899420747762,0.30726698262243285
403,Cherokee,8493,16,2124,2954,8477,8493,1.0,0.0018839043918521135,0.9981160956081478,3415,0.25008830801836807,0.34781584834569645,0.4020958436359355
404,Clarke,3813,24,1202,714,3789,3813,1.0,0.006294256490952006,0.993705743509048,1897,0.3152373459218463,0.1872541306058222,0.4975085234723315
405,Clarke,4132,28,1689,807,4104,4132,1.0,0.006776379477250726,0.9932236205227493,1636,0.40876089060987414,0.19530493707647628,0.3959341723136496
406,Clarke,2530,7,1244,561,2523,2530,1.0,0.002766798418972332,0.9972332015810277,725,0.491699604743083,0.2217391304347826,0.2865612648221344
407,Clarke,2803,5,1464,811,2798,2803,1.0,0.0017838030681412772,0.9982161969318587,528,0.522297538351766,0.28933285765251515,0.18836960399571887
408,Clarke,5428,27,1864,460,5401,5428,1.0,0.004974207811348563,0.9950257921886514,3104,0.34340456890198967,0.0847457627118644,0.5718496683861459
409,Clarke,6968,19,2334,327,6949,6968,1.0,0.0027267508610792192,0.9972732491389208,4307,0.3349598163030999,0.04692881745120551,0.6181113662456946
410,Clarke,3517,14,1309,178,3503,3517,1.0,0.00398066533977822,0.9960193346602217,2030,0.37219220926926355,0.05061131646289451,0.5771964742678419
411,Clarke,8933,53,1842,430,8880,8933,1.0,0.005933057203627001,0.994066942796373,6661,0.2062017239449233,0.0481361244822568,0.7456621515728199
412,Clarke,3879,8,967,319,3871,3879,1.0,0.0020623872131992783,0.9979376127868007,2593,0.24929105439546276,0.08223769012632122,0.6684712554782161
413,Clarke,11684,55,1972,735,11629,11684,1.0,0.0047072920232796986,0.9952927079767203,8977,0.1687778158165012,0.06290653885655598,0.7683156453269429
414,Clarke,3458,25,1654,665,3433,3458,1.0,0.007229612492770388,0.9927703875072296,1139,0.4783111625216888,0.19230769230769232,0.32938114517061884
415,Clarke,3193,37,1538,600,3156,3193,1.0,0.011587848418415283,0.9884121515815847,1055,0.48167867209520826,0.18791105543376135,0.3304102724710304
416,Clarke,2157,5,1422,157,2152,2157,1.0,0.0023180343069077423,0.9976819656930923,578,0.6592489568845619,0.0727862772369031,0.267964765878535
417,Clarke,3972,19,1427,430,3953,3972,1.0,0.004783484390735146,0.9952165156092648,2115,0.3592648539778449,0.10825780463242698,0.5324773413897281
418,Clarke,3935,14,1453,1211,3921,3935,1.0,0.0035578144853875477,0.9964421855146125,1271,0.3692503176620076,0.3077509529860229,0.3229987293519695
419,Clarke,4434,19,1760,921,4415,4434,1.0,0.004285069914298602,0.9957149300857014,1753,0.3969327920613442,0.20771312584573748,0.39535408209291834
420,Clarke,4325,21,1367,882,4304,4325,1.0,0.004855491329479769,0.9951445086705202,2076,0.3160693641618497,0.2039306358381503,0.48
421,Clarke,2360,11,979,311,2349,2360,1.0,0.004661016949152543,0.9953389830508474,1070,0.41483050847457625,0.13177966101694916,0.4533898305084746
422,Clarke,3942,13,1374,782,3929,3942,1.0,0.003297818366311517,0.9967021816336885,1786,0.3485540334855403,0.19837645865043124,0.4530695078640284
423,Clarke,4551,5,1397,773,4546,4551,1.0,0.001098659635245001,0.998901340364755,2381,0.3069655020874533,0.16985277960887718,0.5231817183036696
424,Clarke,4400,8,1344,665,4392,4400,1.0,0.0018181818181818182,0.9981818181818182,2391,0.3054545454545455,0.15113636363636362,0.543409090909091
425,Clarke,3943,4,1543,601,3939,3943,1.0,0.001014455997971088,0.9989855440020289,1799,0.3913264012173472,0.15242201369515598,0.4562515850874968
426,Clarke,2531,2,1098,431,2529,2531,1.0,0.0007902015013828526,0.9992097984986171,1002,0.4338206242591861,0.17028842354800475,0.3958909521928092
427,Clarke,5942,11,1805,675,5931,5942,1.0,0.0018512285425782565,0.9981487714574218,3462,0.30376977448670484,0.11359811511275665,0.5826321104005385
428,Clay,403,0,91,173,403,403,1.0,0.0,1.0,139,0.22580645161290322,0.4292803970223325,0.34491315136476425
429,Clay,392,0,199,53,392,392,1.0,0.0,1.0,140,0.5076530612244898,0.13520408163265307,0.35714285714285715
430,Clay,462,0,150,200,462,462,1.0,0.0,1.0,112,0.3246753246753247,0.4329004329004329,0.24242424242424243
431,Clay,521,0,179,130,521,521,1.0,0.0,1.0,212,0.3435700575815739,0.2495201535508637,0.4069097888675624
432,Clay,468,0,171,81,468,468,1.0,0.0,1.0,216,0.36538461538461536,0.17307692307692307,0.46153846153846156
433,Clayton,6744,29,4173,288,6715,6744,1.0,0.00430011862396204,0.9956998813760379,2283,0.6187722419928826,0.042704626334519574,0.33852313167259784
434,Clayton,5278,65,1227,314,5213,5278,1.0,0.012315270935960592,0.9876847290640394,3737,0.23247442212959454,0.05949223190602501,0.7080333459643805
435,Clayton,3932,63,1195,271,3869,3932,1.0,0.01602238046795524,0.9839776195320448,2466,0.30391658189216686,0.06892166836215666,0.6271617497456765
436,Clayton,3786,30,1069,275,3756,3786,1.0,0.00792393026941363,0.9920760697305864,2442,0.28235604860010566,0.07263602746962493,0.6450079239302694
437,Clayton,2462,32,655,347,2430,2462,1.0,0.012997562956945572,0.9870024370430545,1460,0.2660438667749797,0.14094232331437856,0.5930138099106418
438,Clayton,6080,96,1507,383,5984,6080,1.0,0.015789473684210527,0.9842105263157894,4190,0.24786184210526316,0.06299342105263157,0.6891447368421053
439,Clayton,1955,29,519,303,1926,1955,1.0,0.014833759590792838,0.9851662404092072,1133,0.26547314578005116,0.15498721227621484,0.579539641943734
440,Clayton,10023,34,5031,500,9989,10023,1.0,0.0033921979447271277,0.9966078020552729,4492,0.5019455252918288,0.049885263893046,0.44816921081512523
441,Clayton,3773,17,1397,209,3756,3773,1.0,0.004505698383249403,0.9954943016167506,2167,0.37026239067055394,0.05539358600583091,0.5743440233236151
442,Clayton,4008,26,2059,524,3982,4008,1.0,0.006487025948103792,0.9935129740518962,1425,0.5137225548902196,0.13073852295409183,0.3555389221556886
443,Clayton,3258,15,1575,142,3243,3258,1.0,0.004604051565377533,0.9953959484346224,1541,0.48342541436464087,0.04358502148557397,0.47298956414978516
444,Clayton,2122,3,1219,216,2119,2122,1.0,0.001413760603204524,0.9985862393967955,687,0.5744580584354383,0.10179076343072573,0.323751178133836
445,Clayton,4146,19,2149,829,4127,4146,1.0,0.004582730342498794,0.9954172696575012,1168,0.5183309213699951,0.19995176073323687,0.28171731789676796
446,Clayton,3297,45,1154,144,3252,3297,1.0,0.01364877161055505,0.986351228389445,1999,0.3500151653017895,0.04367606915377616,0.6063087655444344
447,Clayton,2731,17,1133,203,2714,2731,1.0,0.006224826071036251,0.9937751739289638,1395,0.4148663493225925,0.07433174661296228,0.5108019040644453
448,Clayton,3885,13,1621,253,3872,3885,1.0,0.0033462033462033462,0.9966537966537966,2011,0.4172458172458172,0.06512226512226513,0.5176319176319176
449,Clayton,4440,5,2385,155,4435,4440,1.0,0.0011261261261261261,0.9988738738738738,1900,0.5371621621621622,0.03490990990990991,0.42792792792792794
450,Clayton,4710,23,2178,460,4687,4710,1.0,0.004883227176220807,0.9951167728237792,2072,0.4624203821656051,0.09766454352441614,0.4399150743099788
451,Clayton,2925,18,974,208,2907,2925,1.0,0.006153846153846154,0.9938461538461538,1743,0.332991452991453,0.07111111111111111,0.5958974358974359
452,Clayton,2123,12,1023,306,2111,2123,1.0,0.005652378709373528,0.9943476212906265,794,0.48186528497409326,0.14413565708902495,0.37399905793688176
453,Clayton,2696,12,1101,874,2684,2696,1.0,0.004451038575667656,0.9955489614243324,721,0.40838278931750743,0.3241839762611276,0.26743323442136496
454,Clayton,3598,18,1618,379,3580,3598,1.0,0.005002779321845469,0.9949972206781545,1601,0.44969427459699834,0.10533629794330183,0.4449694274596998
455,Clayton,5015,28,1761,178,4987,5015,1.0,0.0055832502492522435,0.9944167497507478,3076,0.35114656031904284,0.035493519441674976,0.6133599202392822
456,Clayton,2567,23,622,154,2544,2567,1.0,0.008959875340864823,0.9910401246591352,1791,0.24230619400077913,0.05999220880405142,0.6977015971951694
457,Clayton,4306,30,1443,248,4276,4306,1.0,0.006967022758941012,0.993032977241059,2615,0.3351137947050627,0.057594054807245706,0.6072921504876916
458,Clayton,4256,14,2249,352,4242,4256,1.0,0.003289473684210526,0.9967105263157895,1655,0.5284304511278195,0.08270676691729323,0.3888627819548872
459,Clayton,3864,27,1771,266,3837,3864,1.0,0.006987577639751553,0.9930124223602484,1827,0.4583333333333333,0.06884057971014493,0.47282608695652173
460,Clayton,9824,34,4352,700,9790,9824,1.0,0.0034609120521172636,0.9965390879478827,4772,0.44299674267100975,0.07125407166123779,0.48574918566775244
461,Clayton,3907,13,2429,253,3894,3907,1.0,0.0033273611466598414,0.9966726388533401,1225,0.6217046327105196,0.06475556693114921,0.3135398003583312
462,Clayton,3712,30,1800,179,3682,3712,1.0,0.008081896551724138,0.9919181034482759,1733,0.4849137931034483,0.04822198275862069,0.46686422413793105
463,Clayton,4004,54,1478,202,3950,4004,1.0,0.013486513486513486,0.9865134865134865,2324,0.3691308691308691,0.05044955044955045,0.5804195804195804
464,Clayton,2876,34,789,468,2842,2876,1.0,0.011821974965229486,0.9881780250347705,1619,0.2743393602225313,0.1627260083449235,0.5629346314325452
465,Clayton,5605,22,2243,557,5583,5605,1.0,0.00392506690454951,0.9960749330954505,2805,0.400178412132025,0.09937555753791258,0.5004460303300624
466,Clayton,2421,18,892,260,2403,2421,1.0,0.007434944237918215,0.9925650557620818,1269,0.3684427922346138,0.107393638992152,0.5241635687732342
467,Clayton,5723,24,3089,488,5699,5723,1.0,0.0041936047527520535,0.9958063952472479,2146,0.5397518783854621,0.08526996330595842,0.3749781583085794
468,Clayton,3461,29,1597,335,3432,3461,1.0,0.008379081190407396,0.9916209188095926,1529,0.46142733314071077,0.09679283444091304,0.4417798324183762
469,Clayton,2463,19,928,218,2444,2463,1.0,0.007714169711733658,0.9922858302882663,1317,0.37677628907835975,0.08850994721883881,0.5347137637028014
470,Clayton,3763,21,1888,173,3742,3763,1.0,0.005580653733723093,0.9944193462662769,1702,0.5017273452032952,0.045973956949242625,0.45229869784746213
471,Clayton,1587,3,718,139,1584,1587,1.0,0.001890359168241966,0.998109640831758,730,0.4524259609325772,0.08758664146187775,0.4599873976055451
472,Clayton,3026,12,1332,76,3014,3026,1.0,0.0039656311962987445,0.9960343688037012,1618,0.4401850627891606,0.02511566424322538,0.534699272967614
473,Clayton,2130,4,885,78,2126,2130,1.0,0.0018779342723004694,0.9981220657276996,1167,0.4154929577464789,0.036619718309859155,0.547887323943662
474,Clayton,5407,15,2021,118,5392,5407,1.0,0.0027741816164231553,0.9972258183835768,3268,0.37377473645274645,0.021823562049195486,0.604401701498058
475,Clayton,4326,10,2031,137,4316,4326,1.0,0.002311604253351826,0.9976883957466481,2158,0.4694868238557559,0.031668978270920016,0.49884419787332407
476,Clayton,2793,10,1817,228,2783,2793,1.0,0.0035803795202291443,0.9964196204797708,748,0.6505549588256355,0.08163265306122448,0.26781238811314
477,Clayton,3494,13,1852,490,3481,3494,1.0,0.003720663995420721,0.9962793360045793,1152,0.5300515168860904,0.14024041213508873,0.3297080709788208
478,Clayton,2397,2,1440,124,2395,2397,1.0,0.0008343763037129745,0.999165623696287,833,0.6007509386733417,0.051731330830204425,0.3475177304964539
479,Clayton,3999,13,1321,59,3986,3999,1.0,0.003250812703175794,0.9967491872968242,2619,0.33033258314578645,0.014753688422105527,0.654913728432108
480,Clayton,1933,11,1101,71,1922,1933,1.0,0.005690636316606311,0.9943093636833937,761,0.5695809622348681,0.03673047077082255,0.3936885669943094
481,Clayton,3200,16,1694,175,3184,3200,1.0,0.005,0.995,1331,0.529375,0.0546875,0.4159375
482,Clayton,3995,23,1772,124,3972,3995,1.0,0.005757196495619525,0.9942428035043804,2099,0.44355444305381725,0.031038798498122654,0.5254067584480601
483,Clayton,3537,20,2033,145,3517,3537,1.0,0.005654509471303365,0.9943454905286966,1359,0.574780887757987,0.04099519366694939,0.3842239185750636
484,Clayton,4995,42,2058,225,4953,4995,1.0,0.008408408408408409,0.9915915915915916,2712,0.412012012012012,0.04504504504504504,0.542942942942943
485,Clayton,3192,23,1552,163,3169,3192,1.0,0.0072055137844611525,0.9927944862155389,1477,0.48621553884711777,0.05106516290726817,0.46271929824561403
486,Clayton,4618,33,1357,235,4585,4618,1.0,0.00714595062797748,0.9928540493720225,3026,0.2938501515807709,0.05088783022953659,0.6552620181896925
487,Clayton,4166,43,1122,213,4123,4166,1.0,0.010321651464234277,0.9896783485357658,2831,0.26932309169467117,0.05112818050888142,0.6795487277964475
488,Clayton,3009,12,1722,205,2997,3009,1.0,0.003988035892323031,0.996011964107677,1082,0.5722831505483549,0.06812894649385177,0.3595879029577933
489,Clayton,2944,12,1355,194,2932,2944,1.0,0.004076086956521739,0.9959239130434783,1395,0.460258152173913,0.06589673913043478,0.47384510869565216
490,Clinch,152,2,12,68,150,152,1.0,0.013157894736842105,0.9868421052631579,72,0.07894736842105263,0.4473684210526316,0.47368421052631576
491,Clinch,529,6,39,220,523,529,1.0,0.011342155009451797,0.9886578449905482,270,0.07372400756143667,0.4158790170132325,0.5103969754253308
492,Clinch,398,1,54,184,397,398,1.0,0.002512562814070352,0.9974874371859297,160,0.135678391959799,0.4623115577889447,0.4020100502512563
493,Clinch,282,3,22,169,279,282,1.0,0.010638297872340425,0.9893617021276596,91,0.07801418439716312,0.599290780141844,0.32269503546099293
494,Clinch,3673,8,620,1464,3665,3673,1.0,0.0021780560849441874,0.9978219439150559,1589,0.16879934658317453,0.39858426354478627,0.4326163898720392
495,Cobb,5781,39,2037,1919,5742,5781,1.0,0.006746237675142709,0.9932537623248573,1825,0.35236118318629994,0.331949489707663,0.31568932710603703
496,Cobb,5925,26,1682,1941,5899,5925,1.0,0.004388185654008439,0.9956118143459916,2302,0.2838818565400844,0.32759493670886075,0.38852320675105484
497,Cobb,5343,30,2249,1183,5313,5343,1.0,0.005614823133071308,0.9943851768669287,1911,0.4209245742092457,0.22141119221411193,0.35766423357664234
498,Cobb,2532,8,990,930,2524,2532,1.0,0.00315955766192733,0.9968404423380727,612,0.3909952606635071,0.36729857819905215,0.24170616113744076
499,Cobb,5764,62,2683,638,5702,5764,1.0,0.010756419153365717,0.9892435808466343,2443,0.46547536433032616,0.11068702290076336,0.42383761276891047
500,Cobb,5535,11,1984,1319,5524,5535,1.0,0.001987353206865402,0.9980126467931346,2232,0.35844625112917794,0.23830171635049685,0.4032520325203252
501,Cobb,3246,20,1127,1127,3226,3246,1.0,0.0061614294516327784,0.9938385705483672,992,0.3471965495995071,0.3471965495995071,0.30560690080098585
502,Cobb,6654,42,2051,2214,6612,6654,1.0,0.0063119927862939585,0.9936880072137061,2389,0.3082356477306883,0.3327321911632101,0.3590321611061016
503,Cobb,3135,11,747,827,3124,3135,1.0,0.0035087719298245615,0.9964912280701754,1561,0.23827751196172248,0.2637958532695375,0.49792663476874005
504,Cobb,3301,12,1229,1231,3289,3301,1.0,0.0036352620418055137,0.9963647379581945,841,0.37231142078158136,0.37291729778854893,0.2547712814298697
505,Cobb,3211,49,1152,641,3162,3211,1.0,0.015260043600124572,0.9847399563998754,1418,0.358766739333541,0.19962628464652757,0.4416069760199315
506,Cobb,4107,22,1970,929,4085,4107,1.0,0.005356708059410762,0.9946432919405892,1208,0.4796688580472364,0.2261991721451181,0.2941319698076455
507,Cobb,2918,5,1113,908,2913,2918,1.0,0.0017135023989033585,0.9982864976010967,897,0.3814256339958876,0.3111720356408499,0.30740233036326253
508,Cobb,2267,22,1377,101,2245,2267,1.0,0.009704455227172474,0.9902955447728276,789,0.6074106749007498,0.04455227172474636,0.34803705337450375
509,Cobb,7946,51,2816,244,7895,7946,1.0,0.006418323684872892,0.9935816763151271,4886,0.35439214699219734,0.03070727410017619,0.6149005789076265
510,Cobb,9930,40,2467,1349,9890,9930,1.0,0.004028197381671702,0.9959718026183283,6114,0.2484390735146022,0.13585095669687813,0.6157099697885197
511,Cobb,9086,29,2860,986,9057,9086,1.0,0.0031917235307065816,0.9968082764692934,5240,0.31476997578692495,0.10851860004402378,0.5767114241690513
512,Cobb,2956,1,1062,1408,2955,2956,1.0,0.00033829499323410016,0.9996617050067659,486,0.35926928281461434,0.476319350473613,0.16441136671177267
513,Cobb,3869,8,1645,1599,3861,3869,1.0,0.002067717756526234,0.9979322822434737,625,0.4251744636857069,0.413285086585681,0.16154044972861203
514,Cobb,2889,0,1215,1446,2889,2889,1.0,0.0,1.0,228,0.4205607476635514,0.5005192107995846,0.07892004153686397
515,Cobb,2133,24,764,478,2109,2133,1.0,0.011251758087201125,0.9887482419127989,891,0.35818096577590247,0.22409751523675575,0.4177215189873418
516,Cobb,5383,12,2596,1030,5371,5383,1.0,0.002229240200631618,0.9977707597993684,1757,0.4822589634033067,0.19134311722088054,0.32639791937581275
517,Cobb,6482,19,2611,694,6463,6482,1.0,0.0029311940759024994,0.9970688059240975,3177,0.40280777537796975,0.10706572045664918,0.49012650416538106
518,Cobb,2055,8,807,857,2047,2055,1.0,0.0038929440389294406,0.9961070559610705,391,0.3927007299270073,0.4170316301703163,0.1902676399026764
519,Cobb,2791,4,1149,1209,2787,2791,1.0,0.0014331780723754925,0.9985668219276245,433,0.4116804012898603,0.43317807237549266,0.1551415263346471
520,Cobb,10186,56,2839,977,10130,10186,1.0,0.005497741998821913,0.9945022580011781,6370,0.278715884547418,0.09591596308658944,0.6253681523659925
521,Cobb,2025,3,810,921,2022,2025,1.0,0.0014814814814814814,0.9985185185185185,294,0.4,0.45481481481481484,0.1451851851851852
522,Cobb,3254,19,1385,1071,3235,3254,1.0,0.005838967424708051,0.994161032575292,798,0.4256299938537185,0.32913337430854334,0.24523663183773817
523,Cobb,3877,12,1179,2283,3865,3877,1.0,0.003095176683002321,0.9969048233169977,415,0.30410110910497806,0.5888573639411916,0.10704152695383028
524,Cobb,3186,26,1077,782,3160,3186,1.0,0.008160703075957313,0.9918392969240427,1327,0.3380414312617702,0.24544883866917766,0.4165097300690521
525,Cobb,2918,1,1200,1335,2917,2918,1.0,0.0003427004797806717,0.9996572995202193,383,0.41124057573680606,0.4575051405071967,0.13125428375599726
526,Cobb,3990,7,1601,1698,3983,3990,1.0,0.0017543859649122807,0.9982456140350877,691,0.4012531328320802,0.4255639097744361,0.17318295739348372
527,Cobb,4674,21,1721,722,4653,4674,1.0,0.004492939666238768,0.9955070603337612,2231,0.36820710312366284,0.15447154471544716,0.47732135216089006
528,Cobb,2606,10,864,1022,2596,2606,1.0,0.003837298541826554,0.9961627014581734,720,0.33154259401381425,0.39217191097467385,0.2762854950115119
529,Cobb,2898,3,1014,1226,2895,2898,1.0,0.0010351966873706005,0.9989648033126294,658,0.3498964803312629,0.4230503795721187,0.22705314009661837
530,Cobb,3443,20,1317,715,3423,3443,1.0,0.005808887598024978,0.994191112401975,1411,0.3825152483299448,0.20766773162939298,0.4098170200406622
531,Cobb,3023,17,1168,1103,3006,3023,1.0,0.005623552762156798,0.9943764472378432,752,0.38637115448230236,0.3648693350975852,0.24875951042011246
532,Cobb,7119,77,2551,956,7042,7119,1.0,0.010816125860373648,0.9891838741396264,3612,0.3583368450625088,0.13428852366905464,0.5073746312684366
533,Cobb,8891,139,1825,856,8752,8891,1.0,0.015633786975593297,0.9843662130244067,6210,0.2052637498594084,0.09627713418063209,0.6984591159599595
534,Cobb,2866,0,866,1664,2866,2866,1.0,0.0,1.0,336,0.30216329378925333,0.5806001395673412,0.11723656664340544
535,Cobb,2454,5,732,1287,2449,2454,1.0,0.002037489812550937,0.9979625101874491,435,0.2982885085574572,0.5244498777506112,0.17726161369193155
536,Cobb,3502,3,1374,1436,3499,3502,1.0,0.0008566533409480297,0.999143346659052,692,0.3923472301541976,0.41005139920045686,0.19760137064534553
537,Cobb,2706,4,1105,1211,2702,2706,1.0,0.0014781966001478197,0.9985218033998522,390,0.40835181079083516,0.4475240206947524,0.14412416851441243
538,Cobb,4281,40,1359,1578,4241,4281,1.0,0.00934361130576968,0.9906563886942303,1344,0.3174491941135249,0.3686054660126139,0.31394533987386125
539,Cobb,7217,59,3817,705,7158,7217,1.0,0.008175142025772481,0.9918248579742275,2695,0.5288901205487044,0.09768601912151864,0.3734238603297769
540,Cobb,2993,1,816,1665,2992,2993,1.0,0.0003341129301703976,0.9996658870698296,512,0.2726361510190444,0.556298028733712,0.17106582024724357
541,Cobb,3977,16,1216,2014,3961,3977,1.0,0.004023133014835303,0.9959768669851647,747,0.305758109127483,0.5064118682423938,0.18783002263012322
542,Cobb,4012,2,1640,1858,4010,4012,1.0,0.0004985044865403788,0.9995014955134596,514,0.4087736789631107,0.46311066799601197,0.12811565304087738
543,Cobb,2005,19,690,853,1986,2005,1.0,0.009476309226932668,0.9905236907730673,462,0.34413965087281795,0.42543640897755614,0.23042394014962594
544,Cobb,1793,1,546,1023,1792,1793,1.0,0.0005577244841048522,0.9994422755158952,224,0.3045175683212493,0.5705521472392638,0.1249302844394869
545,Cobb,4060,4,1429,1765,4056,4060,1.0,0.0009852216748768472,0.9990147783251232,866,0.3519704433497537,0.43472906403940886,0.21330049261083744
546,Cobb,3612,1,1005,2187,3611,3612,1.0,0.0002768549280177187,0.9997231450719822,420,0.2782392026578073,0.6054817275747508,0.11627906976744186
547,Cobb,3770,18,876,750,3752,3770,1.0,0.004774535809018567,0.9952254641909815,2144,0.2323607427055703,0.1989389920424403,0.5687002652519894
548,Cobb,4385,31,1379,1329,4354,4385,1.0,0.007069555302166477,0.9929304446978335,1677,0.3144811858608894,0.303078677309008,0.38244013683010264
549,Cobb,7654,28,2665,1554,7626,7654,1.0,0.0036582179252678338,0.9963417820747321,3435,0.3481839561013849,0.20303109485236479,0.4487849490462503
550,Cobb,4280,11,1396,1251,4269,4280,1.0,0.0025700934579439253,0.9974299065420561,1633,0.32616822429906545,0.29228971962616823,0.3815420560747664
551,Cobb,5933,22,2509,1936,5911,5933,1.0,0.003708073487274566,0.9962919265127255,1488,0.42288892634417663,0.3263104668801618,0.25080060677566157
552,Cobb,3457,6,1316,1613,3451,3457,1.0,0.0017356089094590686,0.9982643910905409,528,0.38067688747468903,0.4665895284929129,0.15273358403239803
553,Cobb,5429,24,2942,769,5405,5429,1.0,0.004420703628660895,0.9955792963713391,1718,0.5419045864800147,0.14164671210167618,0.3164487014183091
554,Cobb,3385,4,1259,1711,3381,3385,1.0,0.0011816838995568684,0.9988183161004431,415,0.3719350073855244,0.5054652880354505,0.12259970457902511
555,Cobb,3793,6,1227,2305,3787,3793,1.0,0.0015818613234906407,0.9984181386765094,261,0.32349064065383604,0.6076983917743212,0.06881096757184287
556,Cobb,5086,13,1735,2588,5073,5086,1.0,0.0025560361777428233,0.9974439638222572,763,0.34113252064490757,0.5088478175383405,0.15001966181675186
557,Cobb,2463,9,794,1313,2454,2463,1.0,0.0036540803897685747,0.9963459196102314,356,0.3223710921640276,0.5330897279740154,0.14453917986195697
558,Cobb,5589,40,2498,1045,5549,5589,1.0,0.007156915369475756,0.9928430846305243,2046,0.44694936482376096,0.18697441402755413,0.36607622114868493
559,Cobb,4202,27,1416,534,4175,4202,1.0,0.006425511661113755,0.9935744883388863,2252,0.3369823893384103,0.1270823417420276,0.5359352689195621
560,Cobb,3192,16,1247,890,3176,3192,1.0,0.005012531328320802,0.9949874686716792,1055,0.3906641604010025,0.27882205513784464,0.33051378446115287
561,Cobb,1585,1,710,549,1584,1585,1.0,0.0006309148264984228,0.9993690851735015,326,0.4479495268138801,0.3463722397476341,0.2056782334384858
562,Cobb,1492,4,538,833,1488,1492,1.0,0.002680965147453083,0.9973190348525469,121,0.3605898123324397,0.5583109919571045,0.08109919571045576
563,Cobb,4219,38,2183,759,4181,4219,1.0,0.009006873666745675,0.9909931263332543,1277,0.517421189855416,0.17990045034368335,0.3026783598009007
564,Cobb,8168,133,1624,706,8035,8168,1.0,0.01628305582761998,0.98371694417238,5838,0.19882468168462292,0.08643486777668952,0.7147404505386875
565,Cobb,1963,7,755,943,1956,1963,1.0,0.003565970453387672,0.9964340295466123,265,0.38461538461538464,0.4803871625063678,0.13499745287824758
566,Cobb,4572,34,1921,1145,4538,4572,1.0,0.0074365704286964126,0.9925634295713036,1506,0.42016622922134733,0.2504374453193351,0.3293963254593176
567,Cobb,7037,37,2854,1696,7000,7037,1.0,0.005257922410117948,0.9947420775898821,2487,0.40557055563450334,0.24101179479892,0.3534176495665767
568,Cobb,2155,4,568,1080,2151,2155,1.0,0.0018561484918793504,0.9981438515081207,507,0.2635730858468677,0.5011600928074246,0.23526682134570764
569,Cobb,2672,23,831,683,2649,2672,1.0,0.008607784431137725,0.9913922155688623,1158,0.31100299401197606,0.2556137724550898,0.4333832335329341
570,Cobb,2562,3,950,1294,2559,2562,1.0,0.00117096018735363,0.9988290398126464,318,0.3708040593286495,0.5050741608118657,0.12412177985948478
571,Cobb,3505,37,1479,589,3468,3505,1.0,0.010556348074179744,0.9894436519258203,1437,0.42196861626248217,0.1680456490727532,0.4099857346647646
572,Cobb,3855,21,1240,385,3834,3855,1.0,0.005447470817120622,0.9945525291828794,2230,0.3216601815823606,0.09987029831387809,0.5784695201037614
573,Cobb,3599,47,1184,374,3552,3599,1.0,0.013059183106418449,0.9869408168935816,2041,0.32898027229786053,0.10391775493192554,0.5671019727702139
574,Cobb,3037,9,1283,970,3028,3037,1.0,0.0029634507737899243,0.9970365492262101,784,0.42245637141916365,0.3193941389529141,0.2581494896279223
575,Cobb,5304,127,1461,359,5177,5304,1.0,0.023944193061840122,0.9760558069381599,3484,0.2754524886877828,0.06768476621417797,0.6568627450980392
576,Cobb,3907,20,743,1983,3887,3907,1.0,0.005119017148707448,0.9948809828512926,1181,0.1901714870744817,0.5075505502943435,0.3022779626311748
577,Cobb,3118,14,943,1119,3104,3118,1.0,0.004490057729313663,0.9955099422706863,1056,0.3024374599101988,0.35888389993585634,0.33867864015394483
578,Cobb,1764,2,609,810,1762,1764,1.0,0.0011337868480725624,0.9988662131519275,345,0.34523809523809523,0.45918367346938777,0.195578231292517
579,Cobb,3130,10,991,1593,3120,3130,1.0,0.003194888178913738,0.9968051118210862,546,0.31661341853035146,0.5089456869009584,0.1744408945686901
580,Cobb,3512,13,1636,1053,3499,3512,1.0,0.003701594533029613,0.9962984054669703,823,0.46583143507972663,0.29982915717539865,0.23433940774487472
581,Cobb,3888,4,1626,1760,3884,3888,1.0,0.00102880658436214,0.9989711934156379,502,0.4182098765432099,0.45267489711934156,0.12911522633744857
582,Cobb,3432,12,1344,1299,3420,3432,1.0,0.0034965034965034965,0.9965034965034965,789,0.3916083916083916,0.3784965034965035,0.2298951048951049
583,Cobb,2808,3,1094,1305,2805,2808,1.0,0.0010683760683760685,0.9989316239316239,409,0.3896011396011396,0.46474358974358976,0.14565527065527065
584,Cobb,3897,1,1598,1722,3896,3897,1.0,0.00025660764690787786,0.9997433923530922,577,0.41005901975878883,0.44187836797536567,0.14806261226584552
585,Cobb,2515,11,843,969,2504,2515,1.0,0.00437375745526839,0.9956262425447316,703,0.3351888667992048,0.3852882703777336,0.27952286282306166
586,Cobb,5108,10,2706,781,5098,5108,1.0,0.001957713390759593,0.9980422866092404,1621,0.5297572435395458,0.1528974158183242,0.31734534064213
587,Cobb,2520,12,864,796,2508,2520,1.0,0.004761904761904762,0.9952380952380953,860,0.34285714285714286,0.31587301587301586,0.3412698412698413
588,Cobb,5811,48,1980,1142,5763,5811,1.0,0.008260196179659268,0.9917398038203408,2689,0.34073309241094474,0.19652383410772672,0.46274307348132854
589,Cobb,3729,6,1891,1130,3723,3729,1.0,0.0016090104585679806,0.998390989541432,708,0.5071064628586752,0.30303030303030304,0.1898632341110217
590,Cobb,1489,1,567,767,1488,1489,1.0,0.000671591672263264,0.9993284083277367,155,0.38079247817327067,0.5151108126259234,0.10409670920080591
591,Cobb,6312,84,2812,989,6228,6312,1.0,0.013307984790874524,0.9866920152091255,2511,0.44550063371356147,0.15668567807351078,0.39781368821292773
592,Cobb,9841,119,2274,868,9722,9841,1.0,0.012092267046031908,0.987907732953968,6699,0.23107407783761813,0.0882024184534092,0.6807235037089726
593,Cobb,5057,52,2325,895,5005,5057,1.0,0.010282776349614395,0.9897172236503856,1837,0.4597587502471821,0.17698240063278622,0.36325884912003165
594,Cobb,3602,5,1835,1217,3597,3602,1.0,0.00138811771238201,0.998611882287618,550,0.5094392004441977,0.3378678511937812,0.1526929483620211
595,Cobb,2903,2,859,1138,2901,2903,1.0,0.0006889424733034792,0.9993110575266965,906,0.2959007922838443,0.39200826730967964,0.31209094040647606
596,Cobb,6080,76,2673,629,6004,6080,1.0,0.0125,0.9875,2778,0.43963815789473687,0.10345394736842105,0.4569078947368421
597,Cobb,3255,7,1041,1779,3248,3255,1.0,0.002150537634408602,0.9978494623655914,435,0.31981566820276497,0.5465437788018433,0.1336405529953917
598,Cobb,3003,5,859,1750,2998,3003,1.0,0.001665001665001665,0.9983349983349983,394,0.286047286047286,0.5827505827505828,0.1312021312021312
599,Cobb,2840,5,966,1111,2835,2840,1.0,0.0017605633802816902,0.9982394366197183,763,0.3401408450704225,0.3911971830985915,0.2686619718309859
600,Cobb,3034,10,1173,1349,3024,3034,1.0,0.0032959789057350032,0.996704021094265,512,0.38661832564271587,0.4446275543836519,0.16875411997363216
601,Cobb,3475,15,1289,1680,3460,3475,1.0,0.004316546762589928,0.99568345323741,506,0.3709352517985611,0.48345323741007196,0.14561151079136692
602,Cobb,4833,21,2592,987,4812,4833,1.0,0.004345127250155183,0.9956548727498448,1254,0.5363128491620112,0.2042209807572936,0.2594661700806952
603,Cobb,3795,25,1806,463,3770,3795,1.0,0.006587615283267457,0.9934123847167325,1526,0.4758893280632411,0.1220026350461133,0.40210803689064556
604,Cobb,4104,18,1972,731,4086,4104,1.0,0.0043859649122807015,0.9956140350877193,1401,0.48050682261208577,0.1781189083820663,0.34137426900584794
605,Cobb,4300,43,1287,1213,4257,4300,1.0,0.01,0.99,1800,0.29930232558139536,0.282093023255814,0.4186046511627907
606,Cobb,2716,35,997,119,2681,2716,1.0,0.01288659793814433,0.9871134020618557,1600,0.36708394698085417,0.04381443298969072,0.5891016200294551
607,Cobb,3374,17,1234,1441,3357,3374,1.0,0.005038529934795495,0.9949614700652045,699,0.3657379964433906,0.42708950800237105,0.2071724955542383
608,Cobb,4982,4,2141,2387,4978,4982,1.0,0.0008028904054596548,0.9991971095945403,454,0.4297470895222802,0.47912484945804895,0.09112806101967082
609,Cobb,3427,4,1518,1545,3423,3427,1.0,0.0011672016340822876,0.9988327983659178,364,0.4429530201342282,0.45083163116428365,0.10621534870148819
610,Cobb,2937,18,1192,1117,2919,2937,1.0,0.006128702757916241,0.9938712972420838,628,0.4058563159686755,0.38032005447735784,0.21382362955396664
611,Cobb,3572,8,1481,1334,3564,3572,1.0,0.0022396416573348264,0.9977603583426652,757,0.41461366181410975,0.3734602463605823,0.21192609182530794
612,Cobb,5564,30,1859,1249,5534,5564,1.0,0.005391804457225018,0.994608195542775,2456,0.3341121495327103,0.22447879223580158,0.4414090582314881
613,Cobb,3215,6,1294,1487,3209,3215,1.0,0.0018662519440124418,0.9981337480559875,434,0.40248833592534994,0.4625194401244168,0.13499222395023328
614,Cobb,1788,2,756,738,1786,1788,1.0,0.0011185682326621924,0.9988814317673378,294,0.4228187919463087,0.412751677852349,0.1644295302013423
615,Cobb,5765,30,1931,554,5735,5765,1.0,0.005203816131830009,0.99479618386817,3280,0.33495229835212487,0.09609713790112749,0.5689505637467476
616,Cobb,6669,31,2791,849,6638,6669,1.0,0.004648373069425701,0.9953516269305743,3029,0.41850352376668165,0.1273054430949168,0.45419103313840153
617,Cobb,7586,37,3374,1675,7549,7586,1.0,0.0048774057474294755,0.9951225942525705,2537,0.44476667545478515,0.22080147640390194,0.33443184814131294
618,Cobb,6098,12,2815,1853,6086,6098,1.0,0.0019678583142013774,0.9980321416857986,1430,0.46162676287307314,0.30387012135126273,0.23450311577566416
619,Cobb,5380,55,2006,811,5325,5380,1.0,0.010223048327137546,0.9897769516728625,2563,0.3728624535315985,0.1507434944237918,0.47639405204460966
620,Cobb,6250,25,2808,1706,6225,6250,1.0,0.004,0.996,1736,0.44928,0.27296,0.27776
621,Cobb,5814,9,3785,1367,5805,5814,1.0,0.0015479876160990713,0.9984520123839009,662,0.651014791881665,0.2351221190230478,0.11386308909528724
622,Cobb,2027,0,835,970,2027,2027,1.0,0.0,1.0,222,0.4119388258510113,0.4785397138628515,0.10952146028613714
623,Cobb,4863,23,1963,1632,4840,4863,1.0,0.004729590787579683,0.9952704092124203,1268,0.40366029200082254,0.33559531153608885,0.2607443964630886
624,Cobb,3213,8,1089,1213,3205,3213,1.0,0.0024898848428260194,0.997510115157174,911,0.3389355742296919,0.37752878929349515,0.28353563647681296
625,Cobb,3255,12,1439,867,3243,3255,1.0,0.003686635944700461,0.9963133640552996,949,0.44208909370199695,0.2663594470046083,0.29155145929339477
626,Cobb,4065,24,1517,444,4041,4065,1.0,0.005904059040590406,0.9940959409594096,2104,0.37318573185731857,0.10922509225092251,0.5175891758917589
627,Cobb,7645,29,2477,1030,7616,7645,1.0,0.0037933289731850884,0.9962066710268149,4138,0.32400261608894704,0.13472858077174624,0.5412688031393067
628,Cobb,2224,3,1016,1025,2221,2224,1.0,0.0013489208633093526,0.9986510791366906,183,0.4568345323741007,0.4608812949640288,0.0822841726618705
629,Cobb,2944,10,877,1630,2934,2944,1.0,0.0033967391304347825,0.9966032608695652,437,0.29789402173913043,0.5536684782608695,0.1484375
630,Cobb,4067,5,1598,700,4062,4067,1.0,0.0012294074256208507,0.9987705925743792,1769,0.3929186132284239,0.1721170395869191,0.434964347184657
631,Cobb,8295,19,2962,1441,8276,8295,1.0,0.0022905364677516574,0.9977094635322483,3892,0.35708257986739,0.17371910789632308,0.46919831223628694
632,Cobb,4839,5,2236,1002,4834,4839,1.0,0.0010332713370531101,0.9989667286629469,1601,0.46207894193015087,0.20706757594544328,0.33085348212440585
633,Cobb,3479,4,1350,1296,3475,3479,1.0,0.0011497556769186547,0.9988502443230813,833,0.388042540960046,0.37252083932164415,0.23943661971830985
634,Cobb,4982,26,1859,1605,4956,4982,1.0,0.005218787635487756,0.9947812123645122,1518,0.37314331593737454,0.32215977519068645,0.30469690887193895
635,Cobb,2601,10,1079,1270,2591,2601,1.0,0.0038446751249519417,0.9961553248750481,252,0.4148404459823145,0.4882737408688966,0.09688581314878893
636,Coffee,2415,8,264,1104,2407,2415,1.0,0.0033126293995859213,0.9966873706004141,1047,0.1093167701863354,0.45714285714285713,0.4335403726708075
637,Coffee,339,2,60,190,337,339,1.0,0.0058997050147492625,0.9941002949852508,89,0.17699115044247787,0.56047197640118,0.26253687315634217
638,Coffee,2698,13,378,1200,2685,2698,1.0,0.004818383988139363,0.9951816160118606,1120,0.14010378057820608,0.4447739065974796,0.41512231282431433
639,Coffee,20978,111,3485,6510,20867,20978,1.0,0.005291257507865383,0.9947087424921346,10983,0.16612641815235007,0.3103251024883211,0.5235484793593288
640,Coffee,4852,12,288,963,4840,4852,1.0,0.00247320692497939,0.9975267930750206,3601,0.05935696619950536,0.19847485572959606,0.7421681780708986
641,Coffee,1137,9,36,611,1128,1137,1.0,0.0079155672823219,0.9920844327176781,490,0.0316622691292876,0.5373790677220757,0.4309586631486368
642,Colquitt,2501,29,202,746,2472,2501,1.0,0.011595361855257898,0.9884046381447421,1553,0.08076769292283087,0.29828068772491,0.6209516193522591
643,Colquitt,1622,3,99,795,1619,1622,1.0,0.0018495684340320592,0.9981504315659679,728,0.06103575832305795,0.49013563501849566,0.44882860665844637
644,Colquitt,397,5,51,137,392,397,1.0,0.012594458438287154,0.9874055415617129,209,0.12846347607052896,0.345088161209068,0.5264483627204031
645,Colquitt,759,6,140,294,753,759,1.0,0.007905138339920948,0.9920948616600791,325,0.1844532279314888,0.38735177865612647,0.4281949934123847
646,Colquitt,1318,8,107,613,1310,1318,1.0,0.006069802731411229,0.9939301972685888,598,0.08118361153262518,0.4650986342943854,0.4537177541729894
647,Colquitt,884,3,55,512,881,884,1.0,0.003393665158371041,0.996606334841629,317,0.06221719457013575,0.579185520361991,0.3585972850678733
648,Colquitt,448,4,27,291,444,448,1.0,0.008928571428571428,0.9910714285714286,130,0.060267857142857144,0.6495535714285714,0.29017857142857145
649,Colquitt,2138,10,187,971,2128,2138,1.0,0.004677268475210477,0.9953227315247896,980,0.08746492048643592,0.45416276894293733,0.4583723105706268
650,Colquitt,1787,19,108,558,1768,1787,1.0,0.010632344711807499,0.9893676552881925,1121,0.0604364857302742,0.31225517627308336,0.6273083379966424
651,Colquitt,537,1,27,281,536,537,1.0,0.00186219739292365,0.9981378026070763,229,0.05027932960893855,0.5232774674115456,0.4264432029795158
652,Colquitt,2019,13,170,888,2006,2019,1.0,0.0064388311045071814,0.9935611688954928,961,0.08420009905894008,0.4398216939078752,0.4759782070331847
653,Colquitt,6656,41,1169,1799,6615,6656,1.0,0.006159855769230769,0.9938401442307693,3688,0.1756310096153846,0.2702824519230769,0.5540865384615384
654,Colquitt,1148,7,96,676,1141,1148,1.0,0.006097560975609756,0.9939024390243902,376,0.08362369337979095,0.5888501742160279,0.32752613240418116
655,Colquitt,3331,40,372,1226,3291,3331,1.0,0.012008405884118884,0.9879915941158811,1733,0.11167817472230561,0.3680576403482438,0.5202641849294506
656,Colquitt,1302,7,93,480,1295,1302,1.0,0.005376344086021506,0.9946236559139785,729,0.07142857142857142,0.3686635944700461,0.5599078341013825
657,Colquitt,4648,46,1152,429,4602,4648,1.0,0.009896729776247849,0.9901032702237521,3067,0.24784853700516352,0.09229776247848537,0.6598537005163512
658,Colquitt,283,4,17,159,279,283,1.0,0.014134275618374558,0.9858657243816255,107,0.06007067137809187,0.5618374558303887,0.37809187279151946
659,Colquitt,932,11,31,328,921,932,1.0,0.011802575107296138,0.9881974248927039,573,0.033261802575107295,0.351931330472103,0.6148068669527897
660,Colquitt,1483,16,84,594,1467,1483,1.0,0.01078894133513149,0.9892110586648685,805,0.056641942009440324,0.4005394470667566,0.5428186109238031
661,Columbia,2197,11,464,963,2186,2197,1.0,0.005006827492034593,0.9949931725079654,770,0.21119708693673192,0.4383249886208466,0.3504779244424215
662,Columbia,2347,6,605,1003,2341,2347,1.0,0.0025564550489987218,0.9974435449510013,739,0.2577758841073711,0.4273540690242863,0.3148700468683426
663,Columbia,2476,16,677,1109,2460,2476,1.0,0.006462035541195477,0.9935379644588045,690,0.2734248788368336,0.44789983844911146,0.27867528271405495
664,Columbia,2237,6,88,531,2231,2237,1.0,0.002682163611980331,0.9973178363880196,1618,0.03933839964237819,0.2373714796602593,0.7232901206973625
665,Columbia,4212,15,596,796,4197,4212,1.0,0.0035612535612535613,0.9964387464387464,2820,0.14150047483380818,0.1889838556505223,0.6695156695156695
666,Columbia,2380,2,618,1018,2378,2380,1.0,0.0008403361344537816,0.9991596638655462,744,0.2596638655462185,0.42773109243697477,0.3126050420168067
667,Columbia,2031,8,499,1138,2023,2031,1.0,0.003938946331856229,0.9960610536681438,394,0.24569177744953224,0.5603151157065485,0.19399310684391924
668,Columbia,2702,8,570,1268,2694,2702,1.0,0.0029607698001480384,0.997039230199852,864,0.21095484826054775,0.4692820133234641,0.31976313841598814
669,Columbia,2168,5,565,1186,2163,2168,1.0,0.0023062730627306273,0.9976937269372693,417,0.2606088560885609,0.5470479704797048,0.19234317343173432
670,Columbia,2606,11,649,984,2595,2606,1.0,0.00422102839600921,0.9957789716039908,973,0.24904067536454336,0.3775901765157329,0.3733691481197237
671,Columbia,2351,8,570,1068,2343,2351,1.0,0.0034028073160357296,0.9965971926839643,713,0.24245002126754572,0.4542747766907699,0.3032752020416844
672,Columbia,2078,8,559,1003,2070,2078,1.0,0.0038498556304138597,0.9961501443695862,516,0.26900866217516844,0.48267564966313764,0.24831568816169394
673,Columbia,1100,2,99,720,1098,1100,1.0,0.0018181818181818182,0.9981818181818182,281,0.09,0.6545454545454545,0.25545454545454543
674,Columbia,1601,7,277,947,1594,1601,1.0,0.004372267332916927,0.995627732667083,377,0.17301686445971268,0.5915053091817614,0.23547782635852593
675,Columbia,1866,19,471,737,1847,1866,1.0,0.010182207931404072,0.9898177920685959,658,0.25241157556270094,0.394962486602358,0.35262593783494106
676,Columbia,1841,2,478,937,1839,1841,1.0,0.0010863661053775121,0.9989136338946225,426,0.25964149918522544,0.5089625203693645,0.2313959804454101
677,Columbia,2465,3,378,1007,2462,2465,1.0,0.0012170385395537525,0.9987829614604462,1080,0.15334685598377282,0.40851926977687625,0.4381338742393509
678,Columbia,2097,4,654,1012,2093,2097,1.0,0.0019074868860276585,0.9980925131139723,431,0.31187410586552217,0.4825941821649976,0.2055317119694802
679,Columbia,3262,11,1171,1526,3251,3262,1.0,0.003372164316370325,0.9966278356836297,565,0.35898221949724096,0.4678111587982833,0.1732066217044758
680,Columbia,3407,9,793,1871,3398,3407,1.0,0.0026416201937188143,0.9973583798062812,743,0.23275609040211329,0.5491634869386557,0.218080422659231
681,Columbia,3546,13,1051,607,3533,3546,1.0,0.0036661026508742244,0.9963338973491258,1888,0.29639029892837,0.17117879300620417,0.5324309080654258
682,Columbia,4298,32,1423,1021,4266,4298,1.0,0.007445323406235459,0.9925546765937645,1854,0.33108422522103303,0.23755234993020008,0.4313634248487669
683,Columbia,4458,19,1159,2855,4439,4458,1.0,0.004262000897263347,0.9957379991027366,444,0.2599820547330641,0.6404217137729924,0.09959623149394348
684,Columbia,1198,5,238,808,1193,1198,1.0,0.004173622704507512,0.9958263772954925,152,0.1986644407345576,0.674457429048414,0.12687813021702837
685,Columbia,2778,8,295,1782,2770,2778,1.0,0.0028797696184305254,0.9971202303815695,701,0.10619150467962563,0.6414686825053996,0.2523398128149748
686,Columbia,1936,5,512,825,1931,1936,1.0,0.0025826446280991736,0.9974173553719008,599,0.2644628099173554,0.42613636363636365,0.309400826446281
687,Columbia,3877,6,1116,1721,3871,3877,1.0,0.0015475883415011606,0.9984524116584989,1040,0.2878514315192159,0.4438999226205829,0.2682486458602012
688,Columbia,3952,22,1149,1064,3930,3952,1.0,0.005566801619433198,0.9944331983805668,1739,0.2907388663967611,0.2692307692307692,0.4400303643724696
689,Columbia,2133,10,528,767,2123,2133,1.0,0.0046882325363338025,0.9953117674636662,838,0.24753867791842477,0.3595874355368026,0.3928738865447726
690,Columbia,2165,8,532,832,2157,2165,1.0,0.003695150115473441,0.9963048498845266,801,0.24572748267898384,0.3842956120092379,0.3699769053117783
691,Columbia,1503,9,321,507,1494,1503,1.0,0.005988023952095809,0.9940119760479041,675,0.21357285429141717,0.3373253493013972,0.4491017964071856
692,Columbia,4818,33,1692,1433,4785,4818,1.0,0.00684931506849315,0.9931506849315068,1693,0.35118306351183065,0.29742631797426317,0.3513906185139062
693,Columbia,4268,13,1148,1834,4255,4268,1.0,0.0030459231490159327,0.996954076850984,1286,0.2689784442361762,0.42970946579194,0.3013120899718838
694,Columbia,2979,10,739,935,2969,2979,1.0,0.003356831151393085,0.9966431688486069,1305,0.24806982208794898,0.3138637126552534,0.4380664652567976
695,Columbia,4715,5,1269,2324,4710,4715,1.0,0.0010604453870625664,0.9989395546129375,1122,0.2691410392364793,0.49289501590668083,0.23796394485683986
696,Columbia,1220,2,378,683,1218,1220,1.0,0.001639344262295082,0.9983606557377049,159,0.30983606557377047,0.5598360655737705,0.130327868852459
697,Columbia,701,4,284,268,697,701,1.0,0.005706134094151213,0.9942938659058488,149,0.4051355206847361,0.38231098430813126,0.21255349500713266
698,Columbia,2617,6,736,1543,2611,2617,1.0,0.0022927015666794038,0.9977072984333206,338,0.2812380588460069,0.5896064195643868,0.12915552158960641
699,Columbia,1611,1,380,998,1610,1611,1.0,0.0006207324643078833,0.9993792675356921,233,0.23587833643699566,0.6194909993792675,0.1446306641837368
700,Columbia,2057,2,573,1483,2055,2057,1.7161936560934892,0.0009722897423432182,0.9990277102576568,1,0.27856101118133203,0.7209528439474964,0.0004861448711716091
701,Columbia,3552,16,1163,782,3536,3552,1.0,0.0045045045045045045,0.9954954954954955,1607,0.32742117117117114,0.22015765765765766,0.45242117117117114
702,Columbia,2519,2,578,1304,2517,2519,1.0,0.0007939658594680428,0.999206034140532,637,0.2294561333862644,0.5176657403731639,0.25287812624057165
703,Columbia,2568,9,570,1232,2559,2568,1.0,0.0035046728971962616,0.9964953271028038,766,0.2219626168224299,0.4797507788161994,0.2982866043613707
704,Columbia,1478,6,346,855,1472,1478,1.0,0.0040595399188092015,0.9959404600811907,277,0.23410013531799728,0.5784844384303113,0.18741542625169147
705,Columbia,1311,6,275,726,1305,1311,1.0,0.004576659038901602,0.9954233409610984,310,0.20976353928299007,0.5537757437070938,0.23646071700991608
706,Cook,2364,19,514,637,2345,2364,1.0,0.008037225042301184,0.9919627749576988,1213,0.21742808798646363,0.2694585448392555,0.5131133671742809
707,Cook,3065,12,404,1249,3053,3065,1.0,0.003915171288743882,0.9960848287112561,1412,0.13181076672104405,0.4075040783034258,0.4606851549755302
708,Cook,661,0,260,17,661,661,1.0,0.0,1.0,384,0.39334341906202724,0.025718608169440244,0.5809379727685325
709,Cook,1494,1,180,702,1493,1494,1.0,0.0006693440428380187,0.999330655957162,612,0.12048192771084337,0.46987951807228917,0.40963855421686746
710,Cook,1062,1,119,521,1061,1062,1.0,0.0009416195856873823,0.9990583804143126,422,0.1120527306967985,0.4905838041431262,0.3973634651600753
711,Cook,1447,11,113,761,1436,1447,1.0,0.007601935038009675,0.9923980649619903,573,0.07809260539046303,0.5259156876295784,0.39599170697995856
712,Cook,1455,1,127,799,1454,1455,1.0,0.0006872852233676976,0.9993127147766323,529,0.08728522336769759,0.5491408934707904,0.363573883161512
713,Cook,1390,2,342,214,1388,1390,1.0,0.0014388489208633094,0.9985611510791367,834,0.2460431654676259,0.1539568345323741,0.6
714,Coweta,3700,8,689,2188,3692,3700,1.0,0.002162162162162162,0.9978378378378379,823,0.18621621621621623,0.5913513513513513,0.22243243243243244
715,Coweta,5196,24,1025,3258,5172,5196,1.0,0.004618937644341801,0.9953810623556582,913,0.1972671285604311,0.6270207852193995,0.17571208622016937
716,Coweta,5861,22,1559,868,5839,5861,1.0,0.003753625661149974,0.99624637433885,3434,0.2659955638969459,0.1480975942671899,0.5859068418358642
717,Coweta,1715,7,327,1038,1708,1715,1.0,0.004081632653061225,0.9959183673469387,350,0.19067055393586005,0.6052478134110787,0.20408163265306123
718,Coweta,962,1,119,513,961,962,1.0,0.0010395010395010396,0.998960498960499,330,0.12370062370062371,0.5332640332640333,0.34303534303534305
719,Coweta,2476,6,478,1028,2470,2476,1.0,0.0024232633279483036,0.9975767366720517,970,0.19305331179321486,0.41518578352180935,0.39176090468497576
720,Coweta,4464,31,951,2423,4433,4464,1.0,0.006944444444444444,0.9930555555555556,1090,0.21303763440860216,0.5427867383512545,0.24417562724014336
721,Coweta,2905,14,524,1219,2891,2905,1.0,0.004819277108433735,0.9951807228915662,1162,0.18037865748709123,0.4196213425129088,0.4
722,Coweta,3955,20,795,1227,3935,3955,1.0,0.0050568900126422255,0.9949431099873578,1933,0.20101137800252844,0.3102402022756005,0.48874841972187105
723,Coweta,2348,10,322,1465,2338,2348,1.0,0.004258943781942078,0.995741056218058,561,0.13713798977853492,0.6239352640545145,0.2389267461669506
724,Coweta,4518,19,1225,2282,4499,4518,1.0,0.0042054006197432495,0.9957945993802567,1011,0.27113767153607793,0.5050907481186365,0.22377158034528552
725,Coweta,2823,6,420,1768,2817,2823,1.0,0.0021253985122210413,0.997874601487779,635,0.1487778958554729,0.6262840949344669,0.2249380092100602
726,Coweta,4087,34,1317,846,4053,4087,1.0,0.008319060435527282,0.9916809395644727,1924,0.32224125275263027,0.20699779789576706,0.4707609493516026
727,Coweta,23239,62,6428,8479,23177,23239,1.0,0.0026679289126038124,0.9973320710873962,8332,0.2766039846809243,0.3648607943543182,0.35853522096475754
728,Coweta,2377,9,602,1119,2368,2377,1.0,0.0037862852334875894,0.9962137147665124,656,0.2532604122843921,0.4707614640302903,0.2759781236853176
729,Coweta,3524,17,516,1644,3507,3524,1.0,0.004824063564131668,0.9951759364358683,1364,0.14642451759364358,0.46651532349602726,0.3870601589103292
730,Coweta,2342,5,263,1276,2337,2342,1.0,0.002134927412467976,0.997865072587532,803,0.11229718189581554,0.5448334756618275,0.34286934244235695
731,Coweta,2685,8,394,1524,2677,2685,1.0,0.0029795158286778397,0.9970204841713222,767,0.14674115456238362,0.5675977653631284,0.28566108007448787
732,Coweta,6144,14,1183,3423,6130,6144,1.0,0.0022786458333333335,0.9977213541666666,1538,0.19254557291666666,0.55712890625,0.2503255208333333
733,Coweta,4470,19,713,2795,4451,4470,1.0,0.004250559284116331,0.9957494407158837,962,0.15950782997762863,0.6252796420581656,0.2152125279642058
734,Coweta,2774,12,769,949,2762,2774,1.0,0.004325883201153569,0.9956741167988464,1056,0.2772170151405912,0.34210526315789475,0.38067772170151404
735,Coweta,4897,7,904,2945,4890,4897,1.0,0.0014294465999591588,0.9985705534000409,1048,0.18460281805186848,0.6013886052685318,0.21400857667959974
736,Coweta,4559,21,764,2807,4538,4559,1.0,0.004606273305549463,0.9953937266944506,988,0.1675806097828471,0.6157051985084449,0.21671419170870804
737,Coweta,3529,14,494,1849,3515,3529,1.0,0.003967129498441485,0.9960328705015585,1186,0.13998299801643524,0.5239444601870218,0.33607254179654295
738,Coweta,981,3,343,189,978,981,1.0,0.0030581039755351682,0.9969418960244648,449,0.34964322120285424,0.1926605504587156,0.45769622833843016
739,Coweta,4624,16,1086,2379,4608,4624,1.0,0.0034602076124567475,0.9965397923875432,1159,0.23486159169550172,0.5144896193771626,0.25064878892733566
740,Crawford,645,15,138,190,630,645,1.0,0.023255813953488372,0.9767441860465116,317,0.21395348837209302,0.29457364341085274,0.49147286821705427
741,Crawford,1214,1,411,308,1213,1214,1.0,0.0008237232289950577,0.999176276771005,495,0.3385502471169687,0.25370675453047775,0.40774299835255357
742,Crawford,1788,0,535,691,1788,1788,1.0,0.0,1.0,562,0.2992170022371365,0.3864653243847875,0.3143176733780761
743,Crawford,1922,15,184,1043,1907,1922,1.0,0.007804370447450572,0.9921956295525495,695,0.09573361082206035,0.5426638917793964,0.36160249739854317
744,Crawford,2014,9,161,1125,2005,2014,1.0,0.004468718967229395,0.9955312810327706,728,0.07994041708043693,0.5585898709036743,0.3614697120158888
745,Crawford,2023,14,186,1071,2009,2023,1.0,0.006920415224913495,0.9930795847750865,766,0.09194265941670786,0.5294117647058824,0.37864557587740977
746,Crisp,1058,0,112,459,1058,1058,1.0,0.0,1.0,487,0.10586011342155009,0.43383742911153117,0.4603024574669187
747,Crisp,884,3,88,624,881,884,1.0,0.003393665158371041,0.996606334841629,172,0.09954751131221719,0.7058823529411765,0.19457013574660634
748,Crisp,11251,18,2649,2488,11233,11251,1.0,0.0015998577904186295,0.9984001422095814,6114,0.2354457381566083,0.22113589903119724,0.5434183628121945
749,Crisp,1325,1,108,832,1324,1325,1.0,0.0007547169811320754,0.999245283018868,385,0.08150943396226415,0.6279245283018868,0.29056603773584905
750,Crisp,1052,2,29,584,1050,1052,1.0,0.0019011406844106464,0.9980988593155894,439,0.027566539923954372,0.5551330798479087,0.41730038022813687
751,Dade,2492,21,108,1216,2471,2492,1.0,0.008426966292134831,0.9915730337078652,1168,0.04333868378812199,0.48796147672552165,0.46869983948635635
752,Dade,810,5,60,414,805,810,1.0,0.006172839506172839,0.9938271604938271,336,0.07407407407407407,0.5111111111111111,0.4148148148148148
753,Dade,1247,1,198,729,1246,1247,1.0,0.0008019246190858059,0.9991980753809142,320,0.15878107457898957,0.5846030473135525,0.2566158781074579
754,Dade,2220,19,283,946,2201,2220,1.0,0.008558558558558558,0.9914414414414414,991,0.12747747747747748,0.4261261261261261,0.4463963963963964
755,Dade,1062,0,121,533,1062,1062,1.0,0.0,1.0,408,0.11393596986817325,0.5018832391713748,0.384180790960452
756,Dade,3250,10,300,1599,3240,3250,1.0,0.003076923076923077,0.9969230769230769,1351,0.09230769230769231,0.492,0.4156923076923077
757,Dade,1906,6,191,629,1900,1906,1.0,0.0031479538300104933,0.9968520461699895,1086,0.10020986358866736,0.3300104931794334,0.5697796432318992
758,Dawson,9963,39,849,6203,9924,9963,1.0,0.003914483589280337,0.9960855164107196,2911,0.08521529659741042,0.6226036334437418,0.29218106995884774
759,Dawson,9312,29,1133,5561,9283,9312,1.0,0.00311426116838488,0.9968857388316151,2618,0.12167096219931271,0.5971864261168385,0.2811426116838488
760,Dawson,2166,4,504,1634,2162,2166,1.0,0.0018467220683287165,0.9981532779316713,28,0.23268698060941828,0.7543859649122807,0.012927054478301015
761,Decatur,2133,6,795,462,2127,2133,1.0,0.0028129395218002813,0.9971870604781997,876,0.3727144866385373,0.21659634317862167,0.41068917018284107
762,Decatur,7742,22,1601,2345,7720,7742,1.0,0.0028416429863084474,0.9971583570136916,3796,0.20679411004908294,0.30289330922242313,0.49031258072849393
763,Decatur,4394,14,1099,1009,4380,4394,1.0,0.0031861629494765588,0.9968138370505234,2286,0.2501137915339099,0.229631315430132,0.5202548930359582
764,Decatur,1500,8,122,492,1492,1500,1.0,0.005333333333333333,0.9946666666666667,886,0.08133333333333333,0.328,0.5906666666666667
765,Decatur,1228,7,200,558,1221,1228,1.0,0.005700325732899023,0.994299674267101,470,0.16286644951140064,0.4543973941368078,0.38273615635179153
766,Decatur,769,1,98,315,768,769,1.0,0.0013003901170351106,0.9986996098829649,356,0.12743823146944083,0.4096228868660598,0.46293888166449937
767,Decatur,628,8,55,392,620,628,1.0,0.012738853503184714,0.9872611464968153,181,0.0875796178343949,0.6242038216560509,0.28821656050955413
768,Decatur,938,7,115,388,931,938,1.0,0.007462686567164179,0.9925373134328358,435,0.12260127931769722,0.4136460554371002,0.46375266524520253
769,Decatur,3111,12,695,797,3099,3111,1.0,0.003857280617164899,0.996142719382835,1619,0.22340083574413372,0.25618772099003534,0.5204114432658309
770,DeKalb,2844,3,1718,201,2841,2844,1.0,0.0010548523206751054,0.9989451476793249,925,0.6040787623066104,0.07067510548523206,0.3252461322081575
771,DeKalb,2827,6,1469,987,2821,2827,1.0,0.0021223912274495934,0.9978776087725504,371,0.5196321188539087,0.3491333569154581,0.13123452423063317
772,DeKalb,2371,6,1075,890,2365,2371,1.0,0.0025305778152678194,0.9974694221847322,406,0.453395191902151,0.37536904259805987,0.1712357654997891
773,DeKalb,4041,11,1715,1048,4030,4041,1.0,0.002722098490472655,0.9972779015095273,1278,0.42439990101460034,0.2593417470923039,0.31625835189309576
774,DeKalb,2358,2,1077,1104,2356,2358,1.0,0.0008481764206955047,0.9991518235793045,177,0.45674300254452926,0.4681933842239186,0.07506361323155217
775,DeKalb,2335,7,1280,97,2328,2335,1.0,0.0029978586723768737,0.9970021413276231,958,0.5481798715203426,0.041541755888650965,0.4102783725910064
776,DeKalb,2799,6,1970,538,2793,2799,1.0,0.0021436227224008574,0.9978563772775991,291,0.7038227938549482,0.1922115041086102,0.10396570203644159
777,DeKalb,3314,7,2197,278,3307,3314,1.0,0.002112251056125528,0.9978877489438744,839,0.6629450814725407,0.08388654194327097,0.2531683765841883
778,DeKalb,4593,13,2698,138,4580,4593,1.0,0.0028303940779446984,0.9971696059220553,1757,0.5874156324842151,0.030045721750489876,0.382538645765295
779,DeKalb,2009,3,1289,57,2006,2009,1.0,0.0014932802389248383,0.9985067197610752,663,0.6416127426580388,0.028372324539571926,0.33001493280238925
780,DeKalb,4273,14,3341,256,4259,4273,1.0,0.003276386613620407,0.9967236133863796,676,0.7818862625789843,0.05991106950620173,0.15820266791481394
781,DeKalb,3522,16,1784,447,3506,3522,1.0,0.004542873367404884,0.9954571266325951,1291,0.5065303804656445,0.12691652470187392,0.36655309483248155
782,DeKalb,3380,10,1573,745,3370,3380,1.0,0.0029585798816568047,0.9970414201183432,1062,0.4653846153846154,0.22041420118343194,0.31420118343195264
783,DeKalb,1752,3,994,476,1749,1752,1.0,0.0017123287671232876,0.9982876712328768,282,0.567351598173516,0.271689497716895,0.16095890410958905
784,DeKalb,4300,111,1160,615,4189,4300,1.0,0.025813953488372093,0.9741860465116279,2525,0.26976744186046514,0.14302325581395348,0.5872093023255814
785,DeKalb,3035,20,1361,565,3015,3035,1.0,0.006589785831960461,0.9934102141680395,1109,0.4484349258649094,0.18616144975288304,0.3654036243822076
786,DeKalb,3404,26,1387,549,3378,3404,1.0,0.00763807285546416,0.9923619271445359,1468,0.4074618096357227,0.16128084606345475,0.4312573443008226
787,DeKalb,4390,13,1631,1112,4377,4390,1.0,0.00296127562642369,0.9970387243735763,1647,0.3715261958997722,0.2533029612756264,0.3751708428246014
788,DeKalb,3684,6,2660,107,3678,3684,1.0,0.0016286644951140066,0.998371335504886,917,0.7220412595005429,0.029044516829533115,0.248914223669924
789,DeKalb,3002,7,2432,180,2995,3002,1.0,0.002331778814123917,0.9976682211858761,390,0.810126582278481,0.05996002664890073,0.12991339107261826
790,DeKalb,1848,9,1191,64,1839,1848,1.0,0.00487012987012987,0.9951298701298701,593,0.6444805194805194,0.03463203463203463,0.3208874458874459
791,DeKalb,3306,14,1845,136,3292,3306,1.0,0.004234724742891712,0.9957652752571083,1325,0.558076225045372,0.0411373260738052,0.40078644888082277
792,DeKalb,3848,5,2320,181,3843,3848,1.0,0.0012993762993762994,0.9987006237006237,1347,0.6029106029106029,0.04703742203742204,0.35005197505197505
793,DeKalb,4036,7,2532,96,4029,4036,1.0,0.001734390485629336,0.9982656095143707,1408,0.6273538156590683,0.023785926660059464,0.34886025768087214
794,DeKalb,1898,8,884,51,1890,1898,1.0,0.004214963119072708,0.9957850368809273,963,0.4657534246575342,0.026870389884088516,0.5073761854583773
795,DeKalb,3790,6,2586,105,3784,3790,1.0,0.0015831134564643799,0.9984168865435357,1099,0.6823218997361478,0.027704485488126648,0.2899736147757256
796,DeKalb,5520,236,1124,495,5284,5520,1.0,0.042753623188405795,0.9572463768115942,3901,0.2036231884057971,0.08967391304347826,0.7067028985507247
797,DeKalb,3476,10,1652,831,3466,3476,1.0,0.0028768699654775605,0.9971231300345225,993,0.475258918296893,0.23906789413118526,0.2856731875719217
798,DeKalb,3113,4,2161,79,3109,3113,1.0,0.00128493414712496,0.9987150658528751,873,0.6941856729842596,0.025377449405717956,0.2804368776100225
799,DeKalb,2911,4,1262,420,2907,2911,1.0,0.0013740982480247338,0.9986259017519753,1229,0.4335279972518035,0.14428031604259706,0.4221916867055994
800,DeKalb,3228,3,2370,332,3225,3228,1.0,0.0009293680297397769,0.9990706319702602,526,0.7342007434944238,0.10285006195786865,0.16294919454770757
801,DeKalb,3178,6,2404,363,3172,3178,1.0,0.0018879798615481435,0.9981120201384519,411,0.7564505978602895,0.11422278162366269,0.12932662051604782
802,DeKalb,4062,3,1918,455,4059,4062,1.0,0.0007385524372230429,0.9992614475627769,1689,0.47218119153126537,0.1120137863121615,0.4158050221565731
803,DeKalb,9770,23,2952,408,9747,9770,1.0,0.002354145342886387,0.9976458546571136,6410,0.3021494370522006,0.041760491299897645,0.6560900716479018
804,DeKalb,1815,1,1000,48,1814,1815,1.0,0.0005509641873278236,0.9994490358126722,767,0.5509641873278237,0.026446280991735537,0.4225895316804408
805,DeKalb,4123,3,2680,236,4120,4123,1.0,0.0007276255154014067,0.9992723744845986,1207,0.6500121270919234,0.057239873878243995,0.2927479990298327
806,DeKalb,2514,5,1280,61,2509,2514,1.0,0.001988862370723946,0.9980111376292761,1173,0.5091487669053302,0.02426412092283214,0.4665871121718377
807,DeKalb,1572,0,730,28,1572,1572,1.0,0.0,1.0,814,0.4643765903307888,0.017811704834605598,0.5178117048346056
808,DeKalb,1997,8,1102,57,1989,1997,1.0,0.00400600901352028,0.9959939909864797,838,0.5518277416124187,0.028542814221331998,0.41962944416624937
809,DeKalb,3043,4,1961,699,3039,3043,1.0,0.0013144922773578706,0.9986855077226421,383,0.6444298389746961,0.22970752546828788,0.1258626355570161
810,DeKalb,2284,2,1157,143,2282,2284,1.0,0.0008756567425569177,0.999124343257443,984,0.5065674255691769,0.06260945709281962,0.4308231173380035
811,DeKalb,583,0,220,12,583,583,1.0,0.0,1.0,351,0.37735849056603776,0.02058319039451115,0.6020583190394511
812,DeKalb,3764,67,1107,479,3697,3764,1.0,0.017800212539851222,0.9821997874601488,2178,0.29410201912858663,0.12725823591923485,0.5786397449521785
813,DeKalb,2674,9,1738,91,2665,2674,1.0,0.0033657442034405387,0.9966342557965595,845,0.649962602842184,0.034031413612565446,0.31600598354525056
814,DeKalb,5819,238,1398,473,5581,5819,1.0,0.04090049836741708,0.959099501632583,3948,0.24024746520020623,0.08128544423440454,0.6784670905653892
815,DeKalb,2004,66,589,240,1938,2004,1.0,0.03293413173652695,0.9670658682634731,1175,0.2939121756487026,0.11976047904191617,0.5863273453093812
816,DeKalb,9950,192,2466,866,9758,9950,1.0,0.019296482412060303,0.9807035175879397,6618,0.2478391959798995,0.08703517587939698,0.6651256281407035
817,DeKalb,4658,5,1431,285,4653,4658,1.0,0.00107342206955775,0.9989265779304423,2942,0.30721339630742805,0.061185057964791754,0.6316015457277802
818,DeKalb,2314,13,1215,178,2301,2314,1.0,0.0056179775280898875,0.9943820224719101,921,0.5250648228176318,0.07692307692307693,0.3980121002592913
819,DeKalb,5644,15,1497,705,5629,5644,1.0,0.002657689581856839,0.9973423104181431,3442,0.2652374202693125,0.12491141034727143,0.609851169383416
820,DeKalb,2004,0,936,794,2004,2004,1.0,0.0,1.0,274,0.46706586826347307,0.3962075848303393,0.13672654690618763
821,DeKalb,2407,1,1129,1071,2406,2407,1.0,0.0004154549231408392,0.9995845450768591,207,0.46904860822600747,0.4449522226838388,0.08599916909015372
822,DeKalb,3632,0,2679,260,3632,3632,1.0,0.0,1.0,693,0.7376101321585903,0.07158590308370044,0.19080396475770925
823,DeKalb,2527,80,917,434,2447,2527,1.0,0.031658092599920855,0.9683419074000792,1176,0.3628808864265928,0.17174515235457063,0.46537396121883656
824,DeKalb,4157,7,1206,148,4150,4157,1.0,0.0016839066634592255,0.9983160933365408,2803,0.29011306230454653,0.035602598027423625,0.6742843396680298
825,DeKalb,3928,4,2031,436,3924,3928,1.0,0.0010183299389002036,0.9989816700610998,1461,0.5170570264765784,0.1109979633401222,0.3719450101832994
826,DeKalb,3763,3,3123,300,3760,3763,1.0,0.0007972362476747276,0.9992027637523253,340,0.8299229338293914,0.07972362476747276,0.0903534414031358
827,DeKalb,4175,38,1723,759,4137,4175,1.0,0.00910179640718563,0.9908982035928143,1693,0.4126946107784431,0.18179640718562876,0.40550898203592817
828,DeKalb,5513,9,2692,103,5504,5513,1.0,0.0016325049882096863,0.9983674950117903,2718,0.48830038091783057,0.018683112642844186,0.4930165064393252
829,DeKalb,2001,0,1523,340,2001,2001,1.0,0.0,1.0,138,0.7611194402798601,0.16991504247876063,0.06896551724137931
830,DeKalb,2062,5,1292,71,2057,2062,1.0,0.0024248302618816685,0.9975751697381183,699,0.6265761396702231,0.03443258971871969,0.3389912706110572
831,DeKalb,3048,1,2098,95,3047,3048,1.0,0.00032808398950131233,0.9996719160104987,855,0.6883202099737533,0.031167979002624673,0.28051181102362205
832,DeKalb,2418,1,1300,56,2417,2418,1.0,0.00041356492969396195,0.9995864350703061,1062,0.5376344086021505,0.02315963606286187,0.4392059553349876
833,DeKalb,2542,6,1276,45,2536,2542,1.0,0.0023603461841070024,0.997639653815893,1221,0.5019669551534225,0.01770259638080252,0.480330448465775
834,DeKalb,2719,6,1391,55,2713,2719,1.0,0.002206693637366679,0.9977933063626333,1273,0.5115851415961751,0.02022802500919456,0.46818683339463035
835,DeKalb,3368,10,2283,77,3358,3368,1.0,0.0029691211401425177,0.9970308788598575,1008,0.6778503562945368,0.022862232779097387,0.2992874109263658
836,DeKalb,3110,22,1683,193,3088,3110,1.0,0.00707395498392283,0.9929260450160772,1234,0.5411575562700964,0.06205787781350482,0.3967845659163987
837,DeKalb,5104,12,1939,893,5092,5104,1.0,0.0023510971786833857,0.9976489028213166,2272,0.37989811912225707,0.17496081504702193,0.445141065830721
838,DeKalb,1885,12,999,123,1873,1885,1.0,0.00636604774535809,0.9936339522546419,763,0.529973474801061,0.06525198938992043,0.40477453580901857
839,DeKalb,2598,3,1764,227,2595,2598,1.0,0.0011547344110854503,0.9988452655889145,607,0.6789838337182448,0.0873749037721324,0.23364126250962278
840,DeKalb,2179,6,1122,101,2173,2179,1.0,0.0027535566773749425,0.997246443322625,956,0.5149150986691142,0.0463515374024782,0.4387333639284075
841,DeKalb,3465,13,2181,115,3452,3465,1.0,0.003751803751803752,0.9962481962481963,1169,0.6294372294372295,0.03318903318903319,0.3373737373737374
842,DeKalb,4431,7,1947,374,4424,4431,1.0,0.001579778830963665,0.9984202211690363,2110,0.43940419769803657,0.08440532611148725,0.47619047619047616
843,DeKalb,2338,9,896,168,2329,2338,1.0,0.003849443969204448,0.9961505560307955,1274,0.38323353293413176,0.0718562874251497,0.5449101796407185
844,DeKalb,3833,10,2537,91,3823,3833,1.0,0.0026089225150013043,0.9973910774849987,1205,0.661883642055831,0.02374119488651187,0.31437516305765717
845,DeKalb,5580,22,2034,624,5558,5580,1.0,0.003942652329749104,0.9960573476702509,2922,0.36451612903225805,0.11182795698924732,0.5236559139784946
846,DeKalb,3602,9,1671,687,3593,3602,1.0,0.002498611882287618,0.9975013881177124,1244,0.4639089394780677,0.19072737368128817,0.3453636868406441
847,DeKalb,1701,4,910,516,1697,1701,1.0,0.0023515579071134627,0.9976484420928865,275,0.5349794238683128,0.30335097001763667,0.16166960611405057
848,DeKalb,4350,46,1819,595,4304,4350,1.0,0.010574712643678161,0.9894252873563218,1936,0.4181609195402299,0.1367816091954023,0.44505747126436784
849,DeKalb,2889,13,1307,332,2876,2889,1.0,0.004499826929733472,0.9955001730702665,1250,0.45240567670474213,0.11491865697473175,0.4326756663205261
850,DeKalb,4436,12,1005,215,4424,4436,1.0,0.002705139765554554,0.9972948602344455,3216,0.22655545536519386,0.048467087466185756,0.7249774571686204
851,DeKalb,1392,7,1122,269,1385,1392,1.1505376344086022,0.005028735632183908,0.9949712643678161,1,0.8060344827586207,0.1932471264367816,0.0007183908045977011
852,DeKalb,4710,15,1753,427,4695,4710,1.0,0.0031847133757961785,0.9968152866242038,2530,0.3721868365180467,0.09065817409766454,0.5371549893842887
853,DeKalb,1161,0,897,41,1161,1161,1.0,0.0,1.0,223,0.772609819121447,0.03531438415159346,0.1920757967269595
854,DeKalb,2684,7,1627,78,2677,2684,1.0,0.0026080476900149033,0.9973919523099851,979,0.6061847988077497,0.029061102831594635,0.36475409836065575
855,DeKalb,4688,11,3499,116,4677,4688,1.0,0.00234641638225256,0.9976535836177475,1073,0.7463737201365188,0.024744027303754267,0.22888225255972697
856,DeKalb,2363,5,1043,1067,2358,2363,1.0,0.0021159542953872196,0.9978840457046128,253,0.44138806601777403,0.45154464663563265,0.1070672873465933
857,DeKalb,2036,2,1079,734,2034,2036,1.0,0.0009823182711198428,0.9990176817288802,223,0.5299607072691552,0.3605108055009823,0.10952848722986247
858,DeKalb,2210,2,1387,105,2208,2210,1.0,0.0009049773755656109,0.9990950226244344,718,0.6276018099547511,0.04751131221719457,0.3248868778280543
859,DeKalb,2718,2,1765,819,2716,2718,1.0,0.0007358351729212656,0.9992641648270787,134,0.6493745401030169,0.30132450331125826,0.049300956585724795
860,DeKalb,4089,36,1626,514,4053,4089,1.0,0.00880410858400587,0.9911958914159942,1949,0.3976522377109318,0.12570310589386158,0.47664465639520665
861,DeKalb,2731,9,1275,432,2722,2731,1.0,0.0032954961552544857,0.9967045038447455,1024,0.4668619553277188,0.1581838154522153,0.3749542292200659
862,DeKalb,2974,3,2100,310,2971,2974,1.0,0.0010087424344317419,0.9989912575655683,564,0.7061197041022192,0.10423671822461332,0.18964357767316745
863,DeKalb,1887,5,828,74,1882,1887,1.0,0.002649708532061473,0.9973502914679385,985,0.43879173290937995,0.0392156862745098,0.5219925808161102
864,DeKalb,3463,1,1955,80,3462,3463,1.0,0.00028876696505919725,0.9997112330349408,1428,0.5645394166907306,0.02310135720473578,0.4123592261045336
865,DeKalb,1392,4,719,391,1388,1392,1.0,0.0028735632183908046,0.9971264367816092,282,0.5165229885057471,0.28089080459770116,0.2025862068965517
866,DeKalb,4126,12,2377,81,4114,4126,1.0,0.00290838584585555,0.9970916141541445,1668,0.5761027629665536,0.019631604459524964,0.40426563257392145
867,DeKalb,2474,1,1852,90,2473,2474,1.0,0.0004042037186742118,0.9995957962813258,532,0.7485852869846402,0.03637833468067906,0.21503637833468067
868,DeKalb,4618,19,2025,423,4599,4618,1.0,0.00411433521004764,0.9958856647899523,2170,0.43850151580770896,0.09159809441316587,0.4699003897791252
869,DeKalb,2512,10,1623,80,2502,2512,1.0,0.003980891719745223,0.9960191082802548,809,0.6460987261146497,0.03184713375796178,0.32205414012738853
870,DeKalb,1667,5,1213,53,1662,1667,1.0,0.002999400119976005,0.997000599880024,401,0.7276544691061788,0.03179364127174565,0.24055188962207558
871,DeKalb,4086,19,2667,163,4067,4086,1.0,0.00465002447381302,0.995349975526187,1256,0.6527165932452276,0.0398923152227117,0.3073910915320607
872,DeKalb,2859,2,1673,63,2857,2859,1.0,0.0006995452955578874,0.9993004547044421,1123,0.5851696397341728,0.022035676810073453,0.39279468345575375
873,DeKalb,3808,12,1959,102,3796,3808,1.0,0.0031512605042016808,0.9968487394957983,1747,0.5144432773109243,0.026785714285714284,0.4587710084033613
874,DeKalb,2155,0,1471,308,2155,2155,1.0,0.0,1.0,376,0.6825986078886311,0.14292343387471,0.17447795823665893
875,DeKalb,3298,10,1346,150,3288,3298,1.0,0.0030321406913280777,0.9969678593086719,1802,0.40812613705275924,0.04548211036992116,0.5463917525773195
876,DeKalb,3199,3,2304,161,3196,3199,1.0,0.0009377930603313535,0.9990622069396686,734,0.7202250703344796,0.05032822757111598,0.22944670209440451
877,DeKalb,2565,9,1333,963,2556,2565,1.0,0.0035087719298245615,0.9964912280701754,269,0.5196881091617934,0.37543859649122807,0.10487329434697856
878,DeKalb,2049,0,1060,210,2049,2049,1.0,0.0,1.0,779,0.5173255246461689,0.10248901903367497,0.38018545632015616
879,DeKalb,2746,14,1553,133,2732,2746,1.0,0.005098324836125273,0.9949016751638747,1060,0.5655498907501821,0.0484340859431901,0.3860160233066278
880,DeKalb,4757,14,2424,96,4743,4757,1.0,0.00294303132226193,0.9970569686777381,2237,0.5095648517973512,0.02018078620979609,0.47025436199285264
881,DeKalb,3776,6,1700,70,3770,3776,1.0,0.0015889830508474577,0.9984110169491526,2006,0.4502118644067797,0.018538135593220338,0.53125
882,DeKalb,2029,3,1404,75,2026,2029,1.0,0.0014785608674223755,0.9985214391325776,550,0.6919664859536717,0.03696402168555939,0.2710694923607688
883,DeKalb,3244,17,1928,143,3227,3244,1.0,0.0052404438964241675,0.9947595561035758,1173,0.594327990135635,0.04408138101109741,0.3615906288532676
884,DeKalb,4179,92,1067,168,4087,4179,1.0,0.022014836085187842,0.9779851639148122,2944,0.25532424024886335,0.04020100502512563,0.704474754726011
885,DeKalb,2339,4,1256,783,2335,2339,1.0,0.0017101325352714834,0.9982898674647285,300,0.5369816160752459,0.3347584437793929,0.12825994014536127
886,DeKalb,3155,13,1459,375,3142,3155,1.0,0.004120443740095087,0.9958795562599049,1321,0.4624405705229794,0.11885895404120443,0.4187004754358162
887,DeKalb,2491,2,1124,1108,2489,2491,1.0,0.0008028904054596548,0.9991971095945403,259,0.45122440786832596,0.44480128462464874,0.10397430750702528
888,DeKalb,3044,1,1084,802,3043,3044,1.0,0.000328515111695138,0.9996714848883048,1158,0.35611038107752957,0.26346911957950064,0.3804204993429698
889,DeKalb,3590,9,1245,191,3581,3590,1.0,0.0025069637883008357,0.9974930362116992,2154,0.3467966573816156,0.0532033426183844,0.6
890,DeKalb,2476,15,1242,158,2461,2476,1.0,0.006058158319870759,0.9939418416801292,1076,0.5016155088852988,0.06381260096930533,0.4345718901453958
891,DeKalb,3684,98,851,345,3586,3684,1.0,0.026601520086862108,0.9733984799131379,2488,0.23099891422366992,0.09364820846905537,0.6753528773072747
892,DeKalb,1479,3,909,323,1476,1479,1.0,0.002028397565922921,0.9979716024340771,247,0.6146044624746451,0.21839080459770116,0.16700473292765383
893,DeKalb,2313,4,1341,525,2309,2313,1.0,0.0017293558149589277,0.9982706441850411,447,0.5797665369649806,0.22697795071335927,0.1932555123216602
894,DeKalb,4666,13,2849,88,4653,4666,1.0,0.002786112301757394,0.9972138876982426,1729,0.6105872267466781,0.018859837119588514,0.3705529361337334
895,DeKalb,4042,136,913,377,3906,4042,1.0,0.03364670954972786,0.9663532904502722,2752,0.22587827808015834,0.09327065809005443,0.6808510638297872
896,DeKalb,4183,11,3384,271,4172,4183,1.0,0.002629691608893139,0.9973703083911069,528,0.8089887640449438,0.06478603872818552,0.12622519722687067
897,DeKalb,1535,5,928,62,1530,1535,1.0,0.003257328990228013,0.996742671009772,545,0.6045602605863192,0.040390879478827364,0.3550488599348534
898,DeKalb,2987,6,1791,52,2981,2987,1.0,0.002008704385671242,0.9979912956143288,1144,0.5995982591228658,0.017408771342484097,0.3829929695346502
899,DeKalb,2276,10,1114,51,2266,2276,1.0,0.004393673110720563,0.9956063268892794,1111,0.48945518453427067,0.02240773286467487,0.4881370826010545
900,DeKalb,2253,4,1218,121,2249,2253,1.0,0.001775410563692854,0.9982245894363071,914,0.5406125166444741,0.05370616955170883,0.4056813138038171
901,DeKalb,4273,8,1803,653,4265,4273,1.0,0.001872220922068804,0.9981277790779312,1817,0.42195179031125674,0.15282003276386613,0.42522817692487713
902,DeKalb,641,6,425,49,635,641,1.0,0.0093603744149766,0.9906396255850234,167,0.6630265210608425,0.07644305772230889,0.26053042121684866
903,DeKalb,2412,3,1042,62,2409,2412,1.0,0.0012437810945273632,0.9987562189054726,1308,0.4320066334991708,0.02570480928689884,0.5422885572139303
904,DeKalb,7029,162,2068,394,6867,7029,1.0,0.023047375160051217,0.9769526248399488,4567,0.2942097026604069,0.05605349267321098,0.6497368046663822
905,DeKalb,2917,9,2640,276,2908,2917,1.1142529614061902,0.0030853616729516627,0.9969146383270483,1,0.905039424065821,0.09461775797051765,0.00034281796366129587
906,DeKalb,2340,1,1469,73,2339,2340,1.0,0.00042735042735042735,0.9995726495726496,798,0.6277777777777778,0.031196581196581197,0.34102564102564104
907,DeKalb,3609,7,2302,118,3602,3609,1.0,0.0019395954558049321,0.9980604045441951,1189,0.6378498198947077,0.03269603768356886,0.3294541424217235
908,DeKalb,2744,0,1942,83,2744,2744,1.0,0.0,1.0,719,0.7077259475218659,0.030247813411078718,0.2620262390670554
909,DeKalb,2394,4,1535,86,2390,2394,1.0,0.001670843776106934,0.9983291562238931,773,0.641186299081036,0.03592314118629908,0.322890559732665
910,DeKalb,2647,7,1620,93,2640,2647,1.0,0.0026445032111824707,0.9973554967888175,934,0.612013600302229,0.03513411409142425,0.3528522856063468
911,DeKalb,3715,5,2296,89,3710,3715,1.0,0.0013458950201884253,0.9986541049798116,1330,0.6180349932705249,0.02395693135935397,0.35800807537012114
912,DeKalb,1808,4,1028,424,1804,1808,1.0,0.0022123893805309734,0.9977876106194691,356,0.5685840707964602,0.2345132743362832,0.19690265486725664
913,DeKalb,2744,8,1819,92,2736,2744,1.0,0.0029154518950437317,0.9970845481049563,833,0.6629008746355685,0.033527696793002916,0.30357142857142855
914,DeKalb,4135,10,2636,231,4125,4135,1.0,0.0024183796856106408,0.9975816203143894,1268,0.6374848851269649,0.055864570737605805,0.30665054413542925
915,DeKalb,4092,17,1754,166,4075,4092,1.0,0.004154447702834799,0.9958455522971652,2172,0.4286412512218964,0.04056695992179863,0.530791788856305
916,DeKalb,3846,17,2715,144,3829,3846,1.0,0.004420176807072283,0.9955798231929277,987,0.7059282371294852,0.0374414976599064,0.25663026521060844
917,DeKalb,5019,26,1780,138,4993,5019,1.0,0.005180314803745766,0.9948196851962542,3101,0.35465232117951784,0.02749551703526599,0.6178521617852162
918,DeKalb,2080,6,1182,112,2074,2080,1.0,0.0028846153846153848,0.9971153846153846,786,0.5682692307692307,0.05384615384615385,0.3778846153846154
919,DeKalb,2660,5,1801,710,2655,2660,1.0,0.0018796992481203006,0.9981203007518797,149,0.6770676691729324,0.2669172932330827,0.05601503759398496
920,DeKalb,3328,2,2436,95,3326,3328,1.0,0.0006009615384615385,0.9993990384615384,797,0.7319711538461539,0.028545673076923076,0.23948317307692307
921,DeKalb,3372,3,1783,313,3369,3372,1.0,0.0008896797153024911,0.9991103202846975,1276,0.5287663107947805,0.09282325029655991,0.37841043890865955
922,DeKalb,4383,7,2853,156,4376,4383,1.0,0.0015970796258270592,0.9984029203741729,1374,0.6509240246406571,0.03559206023271732,0.3134839151266256
923,DeKalb,1749,8,1029,299,1741,1749,1.0,0.004574042309891366,0.9954259576901087,421,0.5883361921097771,0.17095483133218983,0.24070897655803317
924,DeKalb,3103,18,1647,171,3085,3103,1.0,0.005800837898807605,0.9941991621011924,1285,0.5307766677408959,0.05510796003867225,0.4141153722204318
925,DeKalb,5954,5,2173,1522,5949,5954,1.0,0.0008397715821296608,0.9991602284178703,2259,0.36496472959355053,0.25562646960026875,0.3794088008061807
926,DeKalb,2838,64,990,650,2774,2838,1.0,0.02255109231853418,0.9774489076814659,1198,0.3488372093023256,0.22903453136011276,0.42212825933756165
927,DeKalb,2000,6,1058,672,1994,2000,1.0,0.003,0.997,270,0.529,0.336,0.135
928,DeKalb,1655,4,1269,63,1651,1655,1.0,0.002416918429003021,0.997583081570997,323,0.7667673716012084,0.038066465256797584,0.19516616314199395
929,DeKalb,2422,9,1395,69,2413,2422,1.0,0.0037159372419488025,0.9962840627580511,958,0.5759702725020645,0.028488852188274155,0.3955408753096614
930,DeKalb,1784,3,1300,62,1781,1784,1.0,0.0016816143497757848,0.9983183856502242,422,0.7286995515695067,0.034753363228699555,0.2365470852017937
931,DeKalb,3243,6,2156,95,3237,3243,1.0,0.0018501387604070306,0.9981498612395929,992,0.6648165279062597,0.02929386370644465,0.30588960838729573
932,DeKalb,3527,7,2064,106,3520,3527,1.0,0.001984689537850865,0.9980153104621491,1357,0.5851998865891692,0.03005387014459881,0.3847462432662319
933,DeKalb,3477,12,2219,159,3465,3477,1.0,0.003451251078515962,0.996548748921484,1099,0.63819384526891,0.0457290767903365,0.3160770779407535
934,DeKalb,3528,22,2431,154,3506,3528,1.0,0.006235827664399093,0.9937641723356009,943,0.6890589569160998,0.04365079365079365,0.2672902494331066
935,DeKalb,4272,41,1445,133,4231,4272,1.0,0.009597378277153557,0.9904026217228464,2694,0.33824906367041196,0.031132958801498127,0.6306179775280899
936,DeKalb,1904,16,801,183,1888,1904,1.0,0.008403361344537815,0.9915966386554622,920,0.4206932773109244,0.09611344537815127,0.4831932773109244
937,DeKalb,3135,18,1502,184,3117,3135,1.0,0.005741626794258373,0.9942583732057416,1449,0.4791068580542265,0.05869218500797448,0.46220095693779906
938,DeKalb,2332,11,1185,384,2321,2332,1.0,0.0047169811320754715,0.9952830188679245,763,0.508147512864494,0.1646655231560892,0.3271869639794168
939,DeKalb,3506,10,1208,131,3496,3506,1.0,0.002852253280091272,0.9971477467199087,2167,0.34455219623502564,0.03736451796919567,0.6180832857957786
940,DeKalb,4634,12,2285,102,4622,4634,1.0,0.002589555459646094,0.9974104445403539,2247,0.49309451877427707,0.0220112214069918,0.48489425981873113
941,DeKalb,2803,5,904,71,2798,2803,1.0,0.0017838030681412772,0.9982161969318587,1828,0.3225115947199429,0.025330003567606136,0.652158401712451
942,DeKalb,2386,5,1777,96,2381,2386,1.0,0.0020955574182732607,0.9979044425817267,513,0.7447611064543168,0.040234702430846606,0.21500419111483654
943,DeKalb,1580,9,674,609,1571,1580,1.0,0.00569620253164557,0.9943037974683544,297,0.42658227848101266,0.38544303797468354,0.1879746835443038
944,DeKalb,1472,0,984,43,1472,1472,1.0,0.0,1.0,445,0.6684782608695652,0.029211956521739132,0.3023097826086957
945,DeKalb,3614,22,1521,609,3592,3614,1.0,0.006087437742114001,0.993912562257886,1484,0.420863309352518,0.16851134477033758,0.41062534587714444
946,DeKalb,3249,8,1750,987,3241,3249,1.0,0.0024622960911049553,0.9975377039088951,512,0.538627269929209,0.30378578024007385,0.15758694983071714
947,DeKalb,1216,12,643,152,1204,1216,1.0,0.009868421052631578,0.9901315789473685,421,0.5287828947368421,0.125,0.3462171052631579
948,DeKalb,2795,1,1825,82,2794,2795,1.0,0.00035778175313059033,0.9996422182468694,888,0.6529516994633273,0.02933810375670841,0.3177101967799642
949,DeKalb,2255,48,665,248,2207,2255,1.0,0.021286031042128603,0.9787139689578714,1342,0.29490022172949004,0.10997782705099779,0.5951219512195122
950,DeKalb,2685,1,2029,73,2684,2685,1.0,0.00037243947858472997,0.9996275605214152,583,0.7556797020484172,0.027188081936685288,0.21713221601489757
951,DeKalb,3132,15,1461,62,3117,3132,1.0,0.004789272030651341,0.9952107279693486,1609,0.4664750957854406,0.01979565772669221,0.5137292464878672
952,DeKalb,1891,8,1518,162,1883,1891,1.0,0.004230565838180857,0.9957694341618192,211,0.8027498677948176,0.08566895822316235,0.1115811739820201
953,DeKalb,1430,2,652,532,1428,1430,1.0,0.0013986013986013986,0.9986013986013986,246,0.45594405594405596,0.37202797202797205,0.17202797202797201
954,DeKalb,3620,12,2113,140,3608,3620,1.0,0.0033149171270718232,0.9966850828729282,1367,0.5837016574585635,0.03867403314917127,0.3776243093922652
955,DeKalb,3312,0,1805,124,3312,3312,1.0,0.0,1.0,1383,0.544987922705314,0.03743961352657005,0.41757246376811596
956,DeKalb,3979,17,1779,542,3962,3979,1.0,0.0042724302588590096,0.995727569741141,1658,0.4470972606182458,0.1362151294295049,0.4166876099522493
957,DeKalb,3303,10,2394,162,3293,3303,1.0,0.003027550711474417,0.9969724492885256,747,0.7247956403269755,0.04904632152588556,0.22615803814713897
958,DeKalb,1780,3,1289,57,1777,1780,1.0,0.0016853932584269663,0.998314606741573,434,0.7241573033707865,0.03202247191011236,0.24382022471910111
959,Dodge,473,0,58,248,473,473,1.0,0.0,1.0,167,0.1226215644820296,0.5243128964059197,0.35306553911205074
960,Dodge,130,0,3,70,130,130,1.0,0.0,1.0,57,0.023076923076923078,0.5384615384615384,0.43846153846153846
961,Dodge,1153,7,235,540,1146,1153,1.0,0.006071118820468344,0.9939288811795317,378,0.20381613183000868,0.4683434518647008,0.32784041630529054
962,Dodge,573,3,29,289,570,573,1.0,0.005235602094240838,0.9947643979057592,255,0.0506108202443281,0.5043630017452007,0.44502617801047123
963,Dodge,275,0,46,102,275,275,1.0,0.0,1.0,127,0.16727272727272727,0.3709090909090909,0.4618181818181818
964,Dodge,555,0,45,275,555,555,1.0,0.0,1.0,235,0.08108108108108109,0.4954954954954955,0.42342342342342343
965,Dodge,6581,6,1194,1962,6575,6581,1.0,0.000911715544750038,0.99908828445525,3425,0.18143139340525755,0.2981309831332624,0.52043762346148
966,Dodge,316,0,39,190,316,316,1.0,0.0,1.0,87,0.12341772151898735,0.6012658227848101,0.27531645569620256
967,Dodge,364,1,41,189,363,364,1.0,0.0027472527472527475,0.9972527472527473,134,0.11263736263736264,0.5192307692307693,0.36813186813186816
968,Dodge,400,0,55,220,400,400,1.0,0.0,1.0,125,0.1375,0.55,0.3125
969,Dodge,1743,1,75,290,1742,1743,1.0,0.0005737234652897303,0.9994262765347103,1378,0.043029259896729774,0.1663798049340218,0.7905909351692484
970,Dodge,533,1,38,299,532,533,1.0,0.001876172607879925,0.99812382739212,196,0.07129455909943715,0.5609756097560976,0.3677298311444653
971,Dodge,760,0,116,398,760,760,1.0,0.0,1.0,246,0.15263157894736842,0.5236842105263158,0.3236842105263158
972,Dodge,1341,2,163,480,1339,1341,1.0,0.0014914243102162564,0.9985085756897838,698,0.1215510812826249,0.3579418344519016,0.5205070842654735
973,Dodge,144,2,10,133,142,144,1.0287769784172662,0.013888888888888888,0.9861111111111112,1,0.06944444444444445,0.9236111111111112,0.006944444444444444
974,Dodge,373,1,24,158,372,373,1.0,0.002680965147453083,0.9973190348525469,191,0.064343163538874,0.42359249329758714,0.5120643431635389
975,Dooly,809,0,215,230,809,809,1.0,0.0,1.0,364,0.2657601977750309,0.2843016069221261,0.449938195302843
976,Dooly,553,0,179,174,553,553,1.0,0.0,1.0,200,0.32368896925858953,0.31464737793851716,0.3616636528028933
977,Dooly,624,0,100,282,624,624,1.0,0.0,1.0,242,0.16025641025641027,0.4519230769230769,0.38782051282051283
978,Dooly,3589,6,532,547,3583,3589,1.0,0.0016717748676511562,0.9983282251323489,2510,0.14823070493173585,0.15241014210086376,0.6993591529674004
979,Dooly,3612,14,885,926,3598,3612,1.0,0.003875968992248062,0.9961240310077519,1801,0.24501661129568106,0.2563676633444075,0.4986157253599114
980,Dougherty,2419,2,871,63,2417,2419,1.0,0.0008267879288962381,0.9991732120711038,1485,0.3600661430343117,0.026043819760231502,0.6138900372054568
981,Dougherty,730,0,494,16,730,730,1.0,0.0,1.0,220,0.6767123287671233,0.021917808219178082,0.3013698630136986
982,Dougherty,2422,4,989,117,2418,2422,1.0,0.0016515276630883566,0.9983484723369116,1316,0.4083402146985962,0.048307184145334435,0.5433526011560693
983,Dougherty,1608,2,623,21,1606,1608,1.0,0.0012437810945273632,0.9987562189054726,964,0.38743781094527363,0.013059701492537313,0.599502487562189
984,Dougherty,1854,1,583,914,1853,1854,1.0,0.0005393743257820927,0.9994606256742179,357,0.3144552319309601,0.4929881337648328,0.1925566343042071
985,Dougherty,2659,7,759,655,2652,2659,1.0,0.0026325686348251222,0.9973674313651749,1245,0.28544565626175256,0.24633320797292216,0.4682211357653253
986,Dougherty,4899,16,2043,502,4883,4899,1.0,0.0032659726474790775,0.9967340273525209,2354,0.41702388242498467,0.10246989181465606,0.4805062257603593
987,Dougherty,1689,0,472,606,1689,1689,1.0,0.0,1.0,611,0.27945529899348726,0.35879218472468916,0.3617525162818236
988,Dougherty,3887,2,1531,1394,3885,3887,1.0,0.0005145356315924878,0.9994854643684075,962,0.3938770259840494,0.358631335219964,0.24749163879598662
989,Dougherty,1139,1,485,185,1138,1139,1.0,0.000877963125548727,0.9991220368744512,469,0.42581211589113255,0.16242317822651448,0.4117647058823529
990,Dougherty,2468,0,1101,32,2468,2468,1.0,0.0,1.0,1335,0.4461102106969206,0.012965964343598054,0.5409238249594813
991,Dougherty,974,1,637,44,973,974,1.0,0.001026694045174538,0.9989733059548255,293,0.6540041067761807,0.045174537987679675,0.3008213552361396
992,Dougherty,1431,1,656,32,1430,1431,1.0,0.0006988120195667365,0.9993011879804332,743,0.4584206848357792,0.02236198462613557,0.5192173305380853
993,Dougherty,1909,1,392,12,1908,1909,1.0,0.0005238344683080147,0.9994761655316919,1505,0.20534311157674176,0.006286013619696176,0.788370874803562
994,Dougherty,2621,2,775,816,2619,2621,1.0,0.0007630675314765357,0.9992369324685234,1030,0.2956886684471576,0.31133155284242653,0.3929797787104159
995,Dougherty,3826,4,1762,49,3822,3826,1.0,0.0010454783063251437,0.9989545216936748,2015,0.4605331939362258,0.01280710925248301,0.5266596968112912
996,Dougherty,3218,2,776,804,3216,3218,1.0,0.0006215040397762585,0.9993784959602238,1638,0.24114356743318832,0.24984462399005594,0.5090118085767558
997,Dougherty,3487,19,1223,183,3468,3487,1.0,0.0054488098652136505,0.9945511901347863,2081,0.350731287639805,0.05248064238600516,0.5967880699741899
998,Dougherty,2082,8,512,125,2074,2082,1.0,0.0038424591738712775,0.9961575408261287,1445,0.24591738712776176,0.060038424591738714,0.6940441882804995
999,Dougherty,2360,8,878,457,2352,2360,1.0,0.003389830508474576,0.9966101694915255,1025,0.37203389830508476,0.19364406779661017,0.4343220338983051
1000,Dougherty,3072,21,909,856,3051,3072,1.0,0.0068359375,0.9931640625,1307,0.2958984375,0.2786458333333333,0.4254557291666667
1001,Dougherty,695,3,290,119,692,695,1.0,0.004316546762589928,0.99568345323741,286,0.4172661870503597,0.1712230215827338,0.4115107913669065
1002,Dougherty,1517,7,450,549,1510,1517,1.0,0.004614370468029005,0.995385629531971,518,0.2966381015161503,0.36189848384970336,0.34146341463414637
1003,Dougherty,3953,12,1208,722,3941,3953,1.0,0.0030356691120667846,0.9969643308879332,2023,0.305590690614723,0.18264609157601822,0.5117632178092588
1004,Dougherty,1484,6,663,42,1478,1484,1.0,0.004043126684636119,0.9959568733153639,779,0.4467654986522911,0.02830188679245283,0.5249326145552561
1005,Dougherty,798,0,257,16,798,798,1.0,0.0,1.0,525,0.32205513784461154,0.020050125313283207,0.6578947368421053
1006,Dougherty,3796,5,1433,1020,3791,3796,1.0,0.0013171759747102212,0.9986828240252897,1343,0.3775026343519494,0.26870389884088514,0.35379346680716545
1007,Dougherty,3280,9,1805,103,3271,3280,1.0,0.00274390243902439,0.9972560975609757,1372,0.5503048780487805,0.031402439024390244,0.41829268292682925
1008,Douglas,3249,26,1336,579,3223,3249,1.0,0.008002462296091105,0.9919975377039089,1334,0.41120344721452756,0.17820867959372114,0.41058787319175133
1009,Douglas,3832,25,1197,1131,3807,3832,1.0,0.006524008350730689,0.9934759916492694,1504,0.3123695198329854,0.2951461377870564,0.3924843423799583
1010,Douglas,4098,14,2496,384,4084,4098,1.0,0.003416300634455832,0.9965836993655441,1218,0.6090775988286969,0.09370424597364568,0.2972181551976574
1011,Douglas,2953,21,802,1008,2932,2953,1.0,0.007111412123264477,0.9928885878767355,1143,0.27158821537419575,0.3413477819166949,0.3870640027091094
1012,Douglas,3980,19,2098,767,3961,3980,1.0,0.004773869346733669,0.9952261306532664,1115,0.5271356783919598,0.192713567839196,0.28015075376884424
1013,Douglas,4215,20,2065,677,4195,4215,1.0,0.004744958481613286,0.9952550415183867,1473,0.48991696322657174,0.16061684460260972,0.3494661921708185
1014,Douglas,6052,24,3250,1370,6028,6052,1.0,0.0039656311962987445,0.9960343688037012,1432,0.5370125578321217,0.22637144745538665,0.23661599471249173
1015,Douglas,5058,26,1889,253,5032,5058,1.0,0.005140371688414393,0.9948596283115856,2916,0.3734677738236457,0.05001977066034006,0.5765124555160143
1016,Douglas,3472,31,1107,749,3441,3472,1.0,0.008928571428571428,0.9910714285714286,1616,0.3188364055299539,0.2157258064516129,0.46543778801843316
1017,Douglas,4765,20,1051,2838,4745,4765,1.0,0.004197271773347324,0.9958027282266527,876,0.22056663168940188,0.5955928646379853,0.18384050367261282
1018,Douglas,4308,29,1116,1342,4279,4308,1.0,0.006731662024141133,0.9932683379758589,1850,0.2590529247910863,0.3115134633240483,0.42943361188486534
1019,Douglas,4984,26,754,2282,4958,4984,1.0,0.00521669341894061,0.9947833065810594,1948,0.1512841091492777,0.45786516853932585,0.39085072231139645
1020,Douglas,4276,12,2347,770,4264,4276,1.0,0.002806361085126286,0.9971936389148737,1159,0.5488774555659495,0.18007483629560336,0.27104770813844714
1021,Douglas,2691,13,679,581,2678,2691,1.0,0.004830917874396135,0.9951690821256038,1431,0.2523225566703828,0.21590486807878112,0.5317725752508361
1022,Douglas,2419,13,1143,729,2406,2419,1.0,0.005374121537825548,0.9946258784621744,547,0.4725093013642001,0.3013642000826788,0.2261264985531211
1023,Douglas,5738,22,2960,497,5716,5738,1.0,0.0038340885325897525,0.9961659114674103,2281,0.515859184384803,0.08661554548623214,0.39752527012896477
1024,Douglas,7068,18,3331,674,7050,7068,1.0,0.0025466893039049238,0.9974533106960951,3063,0.4712790039615167,0.0953593661573288,0.4333616298811545
1025,Douglas,4125,13,2009,1056,4112,4125,1.0,0.0031515151515151517,0.9968484848484849,1060,0.48703030303030304,0.256,0.25696969696969696
1026,Douglas,6459,14,2571,1969,6445,6459,1.0,0.0021675181916705373,0.9978324818083295,1919,0.3980492336274965,0.3048459513856634,0.29710481498684005
1027,Douglas,6812,43,2249,1014,6769,6812,1.0,0.00631238990017616,0.9936876100998239,3549,0.3301526717557252,0.14885496183206107,0.5209923664122137
1028,Douglas,5607,18,1702,2182,5589,5607,1.0,0.0032102728731942215,0.9967897271268058,1723,0.3035491350098092,0.38915641162832176,0.3072944533618691
1029,Douglas,2433,11,749,751,2422,2433,1.0,0.004521167283189478,0.9954788327168105,933,0.3078503904644472,0.30867242087957253,0.3834771886559803
1030,Douglas,3231,7,1699,279,3224,3231,1.0,0.002166511915815537,0.9978334880841845,1253,0.5258433921386567,0.08635097493036212,0.38780563293098114
1031,Douglas,4511,36,1466,1040,4475,4511,1.0,0.007980492130348038,0.992019507869652,2005,0.32498337397472843,0.23054755043227665,0.4444690755929949
1032,Douglas,2071,16,743,529,2055,2071,1.0,0.00772573635924674,0.9922742636407532,799,0.35876388218252053,0.25543215837759536,0.3858039594398841
1033,Early,970,9,369,294,961,970,1.0,0.009278350515463918,0.9907216494845361,307,0.3804123711340206,0.3030927835051546,0.31649484536082473
1034,Early,4050,14,1452,833,4036,4050,1.0,0.0034567901234567903,0.9965432098765432,1765,0.3585185185185185,0.205679012345679,0.43580246913580245
1035,Early,1317,6,191,641,1311,1317,1.0,0.004555808656036446,0.9954441913439636,485,0.14502657555049356,0.486712224753227,0.3682611996962794
1036,Early,1275,3,316,535,1272,1275,1.0,0.002352941176470588,0.9976470588235294,424,0.24784313725490195,0.4196078431372549,0.3325490196078431
1037,Early,703,4,109,419,699,703,1.0,0.005689900426742532,0.9943100995732574,175,0.155049786628734,0.5960170697012802,0.24893314366998578
1038,Echols,2709,53,167,1256,2656,2709,1.0,0.019564414913252122,0.9804355850867479,1286,0.06164636397194537,0.46363971945367294,0.47471391657438167
1039,Effingham,1971,3,317,1168,1968,1971,1.0,0.0015220700152207,0.9984779299847792,486,0.16083206494165397,0.5925925925925926,0.2465753424657534
1040,Effingham,3297,11,350,1753,3286,3297,1.0,0.0033363663936912345,0.9966636336063087,1194,0.10615711252653928,0.5316954807400667,0.362147406733394
1041,Effingham,1636,15,210,782,1621,1636,1.0,0.009168704156479218,0.9908312958435208,644,0.12836185819070906,0.4779951100244499,0.39364303178484106
1042,Effingham,2210,4,202,1230,2206,2210,1.0,0.0018099547511312218,0.9981900452488688,778,0.09140271493212669,0.5565610859728507,0.35203619909502265
1043,Effingham,2974,12,510,1723,2962,2974,1.0,0.004034969737726967,0.995965030262273,741,0.1714862138533961,0.5793544048419637,0.24915938130464022
1044,Effingham,3318,5,549,1522,3313,3318,1.0,0.0015069318866787222,0.9984930681133213,1247,0.1654611211573237,0.458710066305003,0.3758288125376733
1045,Effingham,4709,12,931,2418,4697,4709,1.0,0.002548311743469951,0.9974516882565301,1360,0.19770651943087705,0.5134848163091952,0.2888086642599278
1046,Effingham,1506,9,184,840,1497,1506,1.0,0.00597609561752988,0.9940239043824701,482,0.12217795484727756,0.5577689243027888,0.3200531208499336
1047,Effingham,1611,1,414,722,1610,1611,1.0,0.0006207324643078833,0.9993792675356921,475,0.2569832402234637,0.44816883923029177,0.2948479205462446
1048,Effingham,2551,8,334,1109,2543,2551,1.0,0.0031360250882007056,0.9968639749117993,1108,0.13092904743237946,0.4347314778518228,0.4343394747157977
1049,Effingham,3220,16,608,1606,3204,3220,1.0,0.004968944099378882,0.9950310559006211,1006,0.18881987577639753,0.49875776397515525,0.3124223602484472
1050,Effingham,3996,14,596,1933,3982,3996,1.0,0.0035035035035035035,0.9964964964964965,1467,0.14914914914914915,0.48373373373373374,0.36711711711711714
1051,Effingham,2181,16,419,847,2165,2181,1.0,0.007336084364970197,0.9926639156350298,915,0.19211370930765703,0.3883539660706098,0.4195323246217332
1052,Effingham,3065,26,313,1602,3039,3065,1.0,0.008482871125611746,0.9915171288743883,1150,0.10212071778140294,0.5226753670473083,0.37520391517128876
1053,Effingham,3015,12,445,1551,3003,3015,1.0,0.003980099502487562,0.9960199004975124,1019,0.14759535655058043,0.5144278606965174,0.33797678275290216
1054,Effingham,4351,20,970,1707,4331,4351,1.0,0.004596644449551827,0.9954033555504481,1674,0.22293725580326362,0.39232360376924846,0.3847391404274879
1055,Effingham,1684,10,368,845,1674,1684,1.0,0.0059382422802850355,0.994061757719715,471,0.21852731591448932,0.5017814726840855,0.27969121140142517
1056,Elbert,1287,3,154,604,1284,1287,1.0,0.002331002331002331,0.9976689976689976,529,0.11965811965811966,0.4693084693084693,0.411033411033411
1057,Elbert,5142,21,1263,1326,5121,5142,1.0,0.004084014002333722,0.9959159859976663,2553,0.2456242707117853,0.25787631271878647,0.49649941656942825
1058,Elbert,1028,3,144,469,1025,1028,1.0,0.0029182879377431907,0.9970817120622568,415,0.14007782101167315,0.45622568093385213,0.4036964980544747
1059,Elbert,715,3,55,371,712,715,1.0,0.004195804195804196,0.9958041958041958,289,0.07692307692307693,0.5188811188811189,0.4041958041958042
1060,Elbert,2033,0,248,962,2033,2033,1.0,0.0,1.0,823,0.1219872110181997,0.4731923266109198,0.4048204623708805
1061,Elbert,708,2,122,347,706,708,1.0,0.002824858757062147,0.9971751412429378,239,0.17231638418079095,0.4901129943502825,0.3375706214689266
1062,Elbert,568,2,83,271,566,568,1.0,0.0035211267605633804,0.9964788732394366,214,0.14612676056338028,0.477112676056338,0.3767605633802817
1063,Elbert,442,2,55,247,440,442,1.0,0.004524886877828055,0.995475113122172,140,0.1244343891402715,0.5588235294117647,0.3167420814479638
1064,Elbert,1853,7,441,756,1846,1853,1.0,0.0037776578521316784,0.9962223421478683,656,0.23799244468429573,0.4079870480302213,0.354020507285483
1065,Elbert,533,0,77,243,533,533,1.0,0.0,1.0,213,0.14446529080675422,0.45590994371482174,0.399624765478424
1066,Elbert,1184,0,237,630,1184,1184,1.0,0.0,1.0,317,0.20016891891891891,0.5320945945945946,0.2677364864864865
1067,Emanuel,852,5,74,489,847,852,1.0,0.005868544600938967,0.994131455399061,289,0.08685446009389672,0.573943661971831,0.3392018779342723
1068,Emanuel,853,2,29,549,851,853,1.0,0.0023446658851113715,0.9976553341148886,275,0.03399765533411489,0.6436107854630715,0.3223915592028136
1069,Emanuel,730,1,101,399,729,730,1.0,0.0013698630136986301,0.9986301369863013,230,0.13835616438356163,0.5465753424657535,0.3150684931506849
1070,Emanuel,252,0,117,65,252,252,1.0,0.0,1.0,70,0.4642857142857143,0.25793650793650796,0.2777777777777778
1071,Emanuel,618,2,77,294,616,618,1.0,0.003236245954692557,0.9967637540453075,247,0.12459546925566344,0.47572815533980584,0.39967637540453077
1072,Emanuel,564,1,52,222,563,564,1.0,0.0017730496453900709,0.99822695035461,290,0.09219858156028368,0.39361702127659576,0.5141843971631206
1073,Emanuel,735,3,34,456,732,735,1.0,0.004081632653061225,0.9959183673469387,245,0.04625850340136054,0.6204081632653061,0.3333333333333333
1074,Emanuel,804,4,128,270,800,804,1.0,0.004975124378109453,0.9950248756218906,406,0.15920398009950248,0.3358208955223881,0.5049751243781094
1075,Emanuel,582,1,86,287,581,582,1.0,0.001718213058419244,0.9982817869415808,209,0.14776632302405499,0.49312714776632305,0.359106529209622
1076,Emanuel,9084,30,1786,2790,9054,9084,1.0,0.0033025099075297227,0.9966974900924703,4508,0.19660942316160282,0.30713342140026423,0.496257155438133
1077,Emanuel,2246,4,400,730,2242,2246,1.0,0.0017809439002671415,0.9982190560997328,1116,0.17809439002671415,0.3250222617987533,0.4968833481745325
1078,Evans,8127,14,1324,2888,8113,8127,1.0,0.0017226528854435831,0.9982773471145564,3915,0.16291374430909314,0.3553586809400763,0.48172757475083056
1079,Fannin,1302,4,150,711,1298,1302,1.0,0.0030721966205837174,0.9969278033794163,441,0.1152073732718894,0.5460829493087558,0.3387096774193548
1080,Fannin,1296,4,169,726,1292,1296,1.0,0.0030864197530864196,0.9969135802469136,401,0.13040123456790123,0.5601851851851852,0.30941358024691357
1081,Fannin,3571,15,299,1824,3556,3571,1.0,0.004200504060487258,0.9957994959395128,1448,0.08373004760571269,0.5107812937552506,0.40548865863903666
1082,Fannin,1393,2,181,791,1391,1393,1.0,0.0014357501794687725,0.9985642498205313,421,0.1299353912419239,0.5678391959798995,0.3022254127781766
1083,Fannin,1278,10,169,784,1268,1278,1.0,0.00782472613458529,0.9921752738654147,325,0.1322378716744914,0.6134585289514867,0.2543035993740219
1084,Fannin,1839,6,212,1168,1833,1839,1.0,0.0032626427406199023,0.9967373572593801,459,0.11528004350190321,0.6351277868406743,0.2495921696574225
1085,Fannin,1219,4,124,711,1215,1219,1.0,0.003281378178835111,0.9967186218211649,384,0.10172272354388844,0.583264971287941,0.31501230516817064
1086,Fannin,2184,13,267,1265,2171,2184,1.0,0.005952380952380952,0.9940476190476191,652,0.12225274725274725,0.5792124542124543,0.29853479853479853
1087,Fannin,817,5,138,524,812,817,1.0,0.006119951040391677,0.9938800489596084,155,0.1689106487148103,0.6413708690330477,0.189718482252142
1088,Fannin,381,2,59,211,379,381,1.0,0.005249343832020997,0.994750656167979,111,0.15485564304461943,0.5538057742782152,0.29133858267716534
1089,Fannin,2418,9,332,1450,2409,2418,1.0,0.0037220843672456576,0.9962779156327544,636,0.13730355665839536,0.5996691480562448,0.2630272952853598
1090,Fannin,3476,6,471,2004,3470,3476,1.0,0.0017261219792865361,0.9982738780207134,1001,0.1355005753739931,0.5765247410817032,0.2879746835443038
1091,Fayette,1848,0,488,886,1848,1848,1.0,0.0,1.0,474,0.26406926406926406,0.47943722943722944,0.2564935064935065
1092,Fayette,1866,14,596,870,1852,1866,1.0,0.007502679528403001,0.992497320471597,400,0.31939978563772775,0.4662379421221865,0.21436227224008575
1093,Fayette,1682,11,643,567,1671,1682,1.0,0.006539833531510107,0.9934601664684899,472,0.3822829964328181,0.3370986920332937,0.2806183115338882
1094,Fayette,2524,12,1490,598,2512,2524,1.0,0.004754358161648178,0.9952456418383518,436,0.5903328050713154,0.23692551505546752,0.17274167987321712
1095,Fayette,1730,1,387,1114,1729,1730,1.0,0.0005780346820809249,0.999421965317919,229,0.22369942196531792,0.6439306358381502,0.13236994219653178
1096,Fayette,2464,13,343,1793,2451,2464,1.0,0.005275974025974026,0.994724025974026,328,0.13920454545454544,0.7276785714285714,0.1331168831168831
1097,Fayette,1870,6,489,1021,1864,1870,1.0,0.0032085561497326204,0.9967914438502674,360,0.26149732620320854,0.5459893048128343,0.1925133689839572
1098,Fayette,3026,8,970,1519,3018,3026,1.0,0.0026437541308658294,0.9973562458691342,537,0.3205551883674818,0.5019828155981494,0.1774619960343688
1099,Fayette,3114,12,2211,323,3102,3114,1.0,0.0038535645472061657,0.9961464354527938,580,0.710019267822736,0.10372511239563263,0.18625561978163135
1100,Fayette,2131,16,915,568,2115,2131,1.0,0.007508212106992022,0.992491787893008,648,0.4293758798686063,0.2665415297982168,0.3040825903331769
1101,Fayette,2805,5,984,732,2800,2805,1.0,0.0017825311942959,0.9982174688057041,1089,0.3508021390374332,0.2609625668449198,0.38823529411764707
1102,Fayette,3514,5,1105,1677,3509,3514,1.0,0.0014228799089356858,0.9985771200910644,732,0.31445645987478654,0.47723392145702903,0.2083096186681844
1103,Fayette,2388,16,621,879,2372,2388,1.0,0.006700167504187605,0.9932998324958124,888,0.2600502512562814,0.36809045226130654,0.37185929648241206
1104,Fayette,1677,7,825,478,1670,1677,1.0,0.0041741204531902205,0.9958258795468098,374,0.4919499105545617,0.28503279666070364,0.22301729278473464
1105,Fayette,1532,3,478,803,1529,1532,1.0,0.0019582245430809398,0.9980417754569191,251,0.31201044386422977,0.5241514360313316,0.16383812010443866
1106,Fayette,2450,9,1070,628,2441,2450,1.0,0.003673469387755102,0.9963265306122449,752,0.43673469387755104,0.2563265306122449,0.3069387755102041
1107,Fayette,3261,7,1299,664,3254,3261,1.0,0.0021465808034345293,0.9978534191965654,1298,0.3983440662373505,0.20361852192578964,0.39803741183685987
1108,Fayette,5511,11,1731,1991,5500,5511,1.0,0.001996007984031936,0.998003992015968,1789,0.3140990745781165,0.36127744510978044,0.3246234803121031
1109,Fayette,961,1,625,155,960,961,1.0,0.001040582726326743,0.9989594172736732,181,0.6503642039542143,0.16129032258064516,0.18834547346514047
1110,Fayette,3363,5,1007,1620,3358,3363,1.0,0.0014867677668748143,0.9985132322331252,736,0.2994350282485876,0.4817127564674398,0.21885221528397264
1111,Fayette,2814,22,1415,920,2792,2814,1.0,0.007818052594171997,0.992181947405828,479,0.5028429282160626,0.3269367448471926,0.17022032693674485
1112,Fayette,3051,3,1290,1189,3048,3051,1.0,0.0009832841691248771,0.9990167158308751,572,0.42281219272369713,0.3897082923631596,0.18747951491314324
1113,Fayette,1305,4,412,640,1301,1305,1.0,0.0030651340996168583,0.9969348659003832,253,0.3157088122605364,0.4904214559386973,0.19386973180076628
1114,Fayette,2247,6,1038,643,2241,2247,1.0,0.0026702269692923898,0.9973297730307076,566,0.46194926568758343,0.2861593235425011,0.25189141076991545
1115,Fayette,2892,5,824,1528,2887,2892,1.0,0.0017289073305670815,0.9982710926694329,540,0.28492392807745504,0.5283540802213001,0.18672199170124482
1116,Fayette,3634,3,1068,2320,3631,3634,1.0,0.000825536598789213,0.9991744634012107,246,0.2938910291689598,0.6384149697303247,0.06769400110071547
1117,Fayette,4937,25,2252,1338,4912,4937,1.0,0.005063803929511849,0.9949361960704881,1347,0.4561474579704274,0.27101478630747416,0.27283775572209845
1118,Fayette,1887,19,471,775,1868,1887,1.0,0.010068892421833599,0.9899311075781664,641,0.24960254372019078,0.41070482246952833,0.33969263381028086
1119,Fayette,1194,1,417,634,1193,1194,1.0,0.0008375209380234506,0.9991624790619765,143,0.3492462311557789,0.5309882747068677,0.11976549413735343
1120,Fayette,3215,7,1453,1083,3208,3215,1.0,0.002177293934681182,0.9978227060653189,679,0.45194401244167964,0.3368584758942457,0.21119751166407466
1121,Fayette,3287,2,653,1885,3285,3287,1.0,0.000608457560085184,0.9993915424399148,749,0.1986613933678126,0.573471250380286,0.22786735625190144
1122,Fayette,3296,11,997,1899,3285,3296,1.0,0.003337378640776699,0.9966626213592233,400,0.3024878640776699,0.5761529126213593,0.12135922330097088
1123,Fayette,3123,10,1188,1166,3113,3123,1.0,0.003202049311559398,0.9967979506884406,769,0.3804034582132565,0.3733589497278258,0.2462375920589177
1124,Fayette,1918,1,554,967,1917,1918,1.0,0.0005213764337851929,0.9994786235662148,397,0.28884254431699685,0.5041710114702815,0.20698644421272158
1125,Fayette,932,3,280,496,929,932,1.0,0.003218884120171674,0.9967811158798283,156,0.30042918454935624,0.5321888412017167,0.16738197424892703
1126,Fayette,2349,8,476,1583,2341,2349,1.0,0.0034057045551298426,0.9965942954448701,290,0.20263942103022564,0.6739037888463176,0.12345679012345678
1127,Floyd,4061,18,679,1764,4043,4061,1.0,0.004432405811376508,0.9955675941886235,1618,0.16720019699581384,0.4343757695148978,0.39842403348928834
1128,Floyd,1639,4,155,791,1635,1639,1.0,0.0024405125076266015,0.9975594874923734,693,0.09456985967053082,0.48261134838316044,0.4228187919463087
1129,Floyd,2693,6,223,1543,2687,2693,1.0,0.0022279985146676567,0.9977720014853323,927,0.08280727812848125,0.5729669513553658,0.344225770516153
1130,Floyd,1814,3,242,883,1811,1814,1.0,0.0016538037486218302,0.9983461962513782,689,0.13340683572216097,0.48676957001102533,0.37982359426681367
1131,Floyd,1342,5,140,721,1337,1342,1.0,0.0037257824143070045,0.996274217585693,481,0.10432190760059612,0.53725782414307,0.35842026825633383
1132,Floyd,3909,13,565,1801,3896,3909,1.0,0.00332565873624968,0.9966743412637503,1543,0.14453824507546686,0.46073164492197494,0.3947301100025582
1133,Floyd,5135,49,1282,1303,5086,5135,1.0,0.009542356377799415,0.9904576436222006,2550,0.24965920155793572,0.2537487828627069,0.49659201557935734
1134,Floyd,5477,10,795,2964,5467,5477,1.0,0.0018258170531312763,0.9981741829468688,1718,0.14515245572393645,0.5411721745481103,0.31367536972795323
1135,Floyd,451,1,55,280,450,451,1.0,0.0022172949002217295,0.9977827050997783,116,0.12195121951219512,0.6208425720620843,0.2572062084257206
1136,Floyd,1801,1,150,1154,1800,1801,1.0,0.000555247084952804,0.9994447529150472,497,0.0832870627429206,0.6407551360355358,0.27595780122154356
1137,Floyd,1230,5,83,631,1225,1230,1.0,0.0040650406504065045,0.9959349593495935,516,0.06747967479674796,0.5130081300813009,0.4195121951219512
1138,Floyd,6793,57,450,1029,6736,6793,1.0,0.008390990725747092,0.9916090092742529,5314,0.06624466362431915,0.15147946415427646,0.7822758722214044
1139,Floyd,4660,24,562,1823,4636,4660,1.0,0.005150214592274678,0.9948497854077253,2275,0.12060085836909872,0.3912017167381974,0.48819742489270385
1140,Floyd,1848,1,120,971,1847,1848,1.0,0.0005411255411255411,0.9994588744588745,757,0.06493506493506493,0.5254329004329005,0.4096320346320346
1141,Floyd,3895,81,1476,1704,3814,3895,1.0,0.02079589216944801,0.979204107830552,715,0.37894736842105264,0.4374839537869063,0.18356867779204109
1142,Floyd,5198,47,1118,1426,5151,5198,1.0,0.009041939207387457,0.9909580607926125,2654,0.21508272412466334,0.2743362831858407,0.510580992689496
1143,Floyd,2297,8,216,977,2289,2297,1.0,0.0034828036569438396,0.9965171963430561,1104,0.09403569873748367,0.42533739660426645,0.48062690465824986
1144,Floyd,4095,34,1037,1088,4061,4095,1.0,0.008302808302808303,0.9916971916971917,1970,0.2532356532356532,0.2656898656898657,0.4810744810744811
1145,Floyd,1465,11,146,405,1454,1465,1.0,0.007508532423208191,0.9924914675767919,914,0.09965870307167235,0.2764505119453925,0.6238907849829352
1146,Floyd,1995,16,638,204,1979,1995,1.0,0.008020050125313283,0.9919799498746867,1153,0.3197994987468672,0.10225563909774436,0.5779448621553884
1147,Floyd,655,1,87,541,654,655,1.0,0.0015267175572519084,0.9984732824427481,27,0.13282442748091602,0.8259541984732824,0.04122137404580153
1148,Floyd,4233,29,883,1035,4204,4233,1.0,0.006850933144342074,0.993149066855658,2315,0.208599102291519,0.2445074415308292,0.5468934561776518
1149,Floyd,1969,18,107,436,1951,1969,1.0,0.009141696292534281,0.9908583037074657,1426,0.05434230573895378,0.22143219908583037,0.7242254951752158
1150,Floyd,4048,10,397,2138,4038,4048,1.0,0.0024703557312252965,0.9975296442687747,1513,0.09807312252964427,0.5281620553359684,0.37376482213438733
1151,Floyd,3592,18,402,1511,3574,3592,1.0,0.005011135857461025,0.994988864142539,1679,0.11191536748329621,0.42065701559020047,0.46742761692650336
1152,Forsyth,18111,27,3871,5095,18084,18111,1.0,0.0014908066920655955,0.9985091933079344,9145,0.2137375075920711,0.2813207442990448,0.5049417481088841
1153,Forsyth,9707,50,1820,1404,9657,9707,1.0,0.005150922015040692,0.9948490779849594,6483,0.18749356134748119,0.14463789018234263,0.6678685484701762
1154,Forsyth,10345,51,1850,6123,10294,10345,1.0,0.004929917834702755,0.9950700821652972,2372,0.17883035282745288,0.5918801353310779,0.2292895118414693
1155,Forsyth,6993,38,889,4154,6955,6993,1.0,0.005434005434005434,0.9945659945659946,1950,0.12712712712712712,0.594022594022594,0.27885027885027885
1156,Forsyth,7223,31,1577,4346,7192,7223,1.0,0.004291845493562232,0.9957081545064378,1300,0.21833033365637547,0.60168904887166,0.17998061747196456
1157,Forsyth,7653,38,1082,3981,7615,7653,1.0,0.004965373056317784,0.9950346269436822,2590,0.14138246439304847,0.520188161505292,0.33842937410165946
1158,Forsyth,5268,38,1332,2989,5230,5268,1.0,0.00721336370539104,0.992786636294609,947,0.2528473804100228,0.5673880030372058,0.17976461655277146
1159,Forsyth,7876,12,1949,4633,7864,7876,1.0,0.0015236160487557136,0.9984763839512443,1294,0.24746063991874048,0.5882427628237684,0.1642965972574911
1160,Forsyth,21094,46,6149,12780,21048,21094,1.0,0.0021807148952308715,0.9978192851047691,2165,0.2915046932777093,0.6058594861097942,0.10263582061249645
1161,Forsyth,9437,36,1499,4801,9401,9437,1.0,0.003814771643530783,0.9961852283564692,3137,0.15884285260146233,0.5087421850164248,0.33241496238211293
1162,Forsyth,14308,101,1270,3520,14207,14308,1.0,0.0070589879787531454,0.9929410120212468,9518,0.0887615320100643,0.2460162147050601,0.6652222532848756
1163,Forsyth,9687,7,4336,5350,9680,9687,1.2256105276477287,0.0007226179415711778,0.9992773820584289,1,0.4476101992360896,0.5522865696294003,0.00010323113451016826
1164,Forsyth,14596,23,4676,7740,14573,14596,1.0,0.0015757741847081392,0.9984242258152919,2180,0.32036174294327213,0.530282269114826,0.14935598794190189
1165,Forsyth,11336,26,3233,4599,11310,11336,1.0,0.0022935779816513763,0.9977064220183486,3504,0.28519760056457305,0.4056986591390261,0.30910374029640086
1166,Forsyth,10977,36,1741,5939,10941,10977,1.0,0.003279584585952446,0.9967204154140475,3297,0.15860435455953356,0.5410403571103216,0.30035528833014485
1167,Forsyth,18366,74,4929,7668,18292,18366,1.0,0.004029184362408799,0.9959708156375912,5769,0.2683763475988239,0.41751061744527934,0.31411303495589676
1168,Franklin,1421,1,110,805,1420,1421,1.0,0.0007037297677691766,0.9992962702322308,506,0.07741027445460943,0.5665024630541872,0.35608726249120337
1169,Franklin,2754,5,193,1570,2749,2754,1.0,0.0018155410312273058,0.9981844589687727,991,0.070079883805374,0.570079883805374,0.359840232389252
1170,Franklin,2904,7,382,1199,2897,2904,1.0,0.0024104683195592287,0.9975895316804407,1323,0.1315426997245179,0.4128787878787879,0.4555785123966942
1171,Franklin,3344,0,325,1750,3344,3344,1.0,0.0,1.0,1269,0.097188995215311,0.5233253588516746,0.37948564593301437
1172,Franklin,3093,9,282,1130,3084,3093,1.0,0.002909796314258002,0.997090203685742,1681,0.09117361784675072,0.36534109279017135,0.5434852893630779
1173,Franklin,2721,9,173,1563,2712,2721,1.0,0.0033076074972436605,0.9966923925027563,985,0.06357956633590592,0.5744211686879823,0.36199926497611173
1174,Franklin,2061,3,128,1052,2058,2061,1.0,0.001455604075691412,0.9985443959243085,881,0.06210577389616691,0.5104318292091218,0.4274623968947113
1175,Fulton,3783,4,2579,247,3779,3783,1.0,0.00105736188210415,0.9989426381178959,957,0.6817340734866508,0.06529209621993128,0.2529738302934179
1176,Fulton,4043,14,2984,301,4029,4043,1.0,0.0034627751669552313,0.9965372248330447,758,0.7380657927281722,0.07444966608953747,0.18748454118229038
1177,Fulton,1431,4,717,49,1427,1431,1.0,0.002795248078266946,0.9972047519217331,665,0.5010482180293501,0.03424178895877009,0.4647099930118798
1178,Fulton,1043,0,435,34,1043,1043,1.0,0.0,1.0,574,0.4170661553211889,0.032598274209012464,0.5503355704697986
1179,Fulton,2974,9,2435,287,2965,2974,1.0,0.003026227303295225,0.9969737726967047,252,0.8187626092804304,0.09650302622730329,0.0847343644922663
1180,Fulton,963,3,481,34,960,963,1.0,0.003115264797507788,0.9968847352024922,448,0.4994807892004154,0.035306334371754934,0.4652128764278297
1181,Fulton,1918,12,1159,87,1906,1918,1.0,0.006256517205422315,0.9937434827945777,672,0.6042752867570386,0.04535974973931178,0.35036496350364965
1182,Fulton,1037,9,405,17,1028,1037,1.0,0.008678881388621022,0.991321118611379,615,0.390549662487946,0.01639344262295082,0.5930568948891032
1183,Fulton,2697,5,1287,72,2692,2697,1.0,0.0018539117538005192,0.9981460882461994,1338,0.4771968854282536,0.026696329254727477,0.4961067853170189
1184,Fulton,1241,4,603,28,1237,1241,1.0,0.0032232070910556,0.9967767929089444,610,0.48589846897663175,0.022562449637389202,0.49153908138597907
1185,Fulton,1022,15,468,37,1007,1022,1.0,0.014677103718199608,0.9853228962818004,517,0.45792563600782776,0.036203522504892366,0.5058708414872799
1186,Fulton,1870,8,928,56,1862,1870,1.0,0.0042780748663101605,0.9957219251336898,886,0.49625668449197863,0.029946524064171122,0.4737967914438503
1187,Fulton,4144,29,808,67,4115,4144,1.0,0.006998069498069498,0.9930019305019305,3269,0.19498069498069498,0.016167953667953667,0.7888513513513513
1188,Fulton,6738,10,3329,754,6728,6738,1.0,0.0014841199168892847,0.9985158800831108,2655,0.4940635203324429,0.11190264173345206,0.39403383793410507
1189,Fulton,2499,7,1242,168,2492,2499,1.0,0.0028011204481792717,0.9971988795518207,1089,0.4969987995198079,0.06722689075630252,0.43577430972388953
1190,Fulton,2454,9,1175,138,2445,2454,1.0,0.003667481662591687,0.9963325183374083,1141,0.47881010594947027,0.05623471882640587,0.4649551752241239
1191,Fulton,5753,11,3200,478,5742,5753,1.0,0.0019120458891013384,0.9980879541108987,2075,0.5562315313749349,0.0830870849991309,0.36068138362593427
1192,Fulton,1906,4,1463,143,1902,1906,1.0,0.002098635886673662,0.9979013641133263,300,0.7675760755508919,0.07502623294858342,0.15739769150052466
1193,Fulton,3435,7,2092,280,3428,3435,1.0,0.0020378457059679767,0.997962154294032,1063,0.6090247452692867,0.08151382823871907,0.30946142649199415
1194,Fulton,936,3,432,65,933,936,1.0,0.003205128205128205,0.9967948717948718,439,0.46153846153846156,0.06944444444444445,0.469017094017094
1195,Fulton,4068,7,2523,349,4061,4068,1.0,0.001720747295968535,0.9982792527040315,1196,0.6202064896755162,0.08579154375614553,0.29400196656833827
1196,Fulton,2523,9,1412,163,2514,2523,1.0,0.0035671819262782403,0.9964328180737217,948,0.5596512088783194,0.06460562822037257,0.375743162901308
1197,Fulton,1539,5,924,135,1534,1539,1.0,0.003248862897985705,0.9967511371020142,480,0.6003898635477583,0.08771929824561403,0.31189083820662766
1198,Fulton,9044,15,4164,783,9029,9044,1.0,0.0016585581601061478,0.9983414418398938,4097,0.46041574524546663,0.08657673595754091,0.45300751879699247
1199,Fulton,3350,2,1314,222,3348,3350,1.0,0.0005970149253731343,0.9994029850746269,1814,0.39223880597014926,0.0662686567164179,0.5414925373134328
1200,Fulton,869,1,450,43,868,869,1.0,0.0011507479861910242,0.998849252013809,376,0.5178365937859609,0.04948216340621404,0.4326812428078251
1201,Fulton,1371,9,544,104,1362,1371,1.0,0.006564551422319475,0.9934354485776805,723,0.3967906637490883,0.07585703865791393,0.5273522975929978
1202,Fulton,1667,7,777,41,1660,1667,1.0,0.004199160167966407,0.9958008398320336,849,0.46610677864427114,0.02459508098380324,0.5092981403719257
1203,Fulton,661,0,213,16,661,661,1.0,0.0,1.0,432,0.32223903177004537,0.024205748865355523,0.653555219364599
1204,Fulton,1506,4,728,27,1502,1506,1.0,0.0026560424966799467,0.99734395750332,751,0.48339973439575035,0.017928286852589643,0.49867197875166
1205,Fulton,852,0,433,29,852,852,1.0,0.0,1.0,390,0.5082159624413145,0.03403755868544601,0.45774647887323944
1206,Fulton,2316,1,1024,71,2315,2316,1.0,0.0004317789291882556,0.9995682210708118,1221,0.4421416234887737,0.03065630397236615,0.5272020725388601
1207,Fulton,2675,8,1253,242,2667,2675,1.0,0.0029906542056074765,0.9970093457943925,1180,0.46841121495327104,0.09046728971962617,0.4411214953271028
1208,Fulton,497,0,272,14,497,497,1.0,0.0,1.0,211,0.5472837022132797,0.028169014084507043,0.4245472837022133
1209,Fulton,918,7,388,33,911,918,1.0,0.007625272331154684,0.9923747276688453,497,0.4226579520697168,0.03594771241830065,0.5413943355119826
1210,Fulton,8400,34,559,89,8366,8400,1.0,0.004047619047619047,0.9959523809523809,7752,0.06654761904761905,0.010595238095238095,0.9228571428571428
1211,Fulton,566,5,206,16,561,566,1.0,0.0088339222614841,0.991166077738516,344,0.36395759717314485,0.028268551236749116,0.607773851590106
1212,Fulton,3252,5,455,88,3247,3252,1.0,0.0015375153751537515,0.9984624846248462,2709,0.13991389913899138,0.02706027060270603,0.8330258302583026
1213,Fulton,2709,11,870,48,2698,2709,1.0,0.004060538944259874,0.9959394610557402,1791,0.3211517165005537,0.017718715393133997,0.6611295681063123
1214,Fulton,7021,22,2118,313,6999,7021,1.0,0.0031334567725395243,0.9968665432274605,4590,0.30166642928357784,0.0445805440820396,0.6537530266343826
1215,Fulton,7,0,7,0,7,7,1.1666666666666667,0.0,1.0,0,1.0,0.0,0.0
1216,Fulton,720,0,408,20,720,720,1.0,0.0,1.0,292,0.5666666666666667,0.027777777777777776,0.40555555555555556
1217,Fulton,1671,4,781,44,1667,1671,1.0,0.0023937761819269898,0.997606223818073,846,0.4673847995212448,0.026331538001196888,0.5062836624775583
1218,Fulton,1401,4,580,20,1397,1401,1.0,0.0028551034975017845,0.9971448965024983,801,0.41399000713775874,0.014275517487508922,0.5717344753747323
1219,Fulton,2865,2,758,33,2863,2865,1.0,0.0006980802792321117,0.9993019197207679,2074,0.26457242582897034,0.011518324607329843,0.7239092495636998
1220,Fulton,133,0,51,1,133,133,1.0,0.0,1.0,81,0.38345864661654133,0.007518796992481203,0.6090225563909775
1221,Fulton,1318,4,812,33,1314,1318,1.0,0.0030349013657056147,0.9969650986342944,473,0.6160849772382397,0.02503793626707132,0.3588770864946889
1222,Fulton,4279,2,1145,114,4277,4279,1.0,0.00046739892498247256,0.9995326010750175,3020,0.2675858845524655,0.026641738724000934,0.7057723767235335
1223,Fulton,719,0,388,19,719,719,1.0,0.0,1.0,312,0.5396383866481224,0.02642559109874826,0.4339360222531293
1224,Fulton,4042,5,769,71,4037,4042,1.0,0.0012370113805047005,0.9987629886194953,3202,0.19025235032162297,0.01756556160316675,0.7921820880752103
1225,Fulton,2071,1,183,9,2070,2071,1.0,0.0004828585224529213,0.9995171414775471,1879,0.08836310960888459,0.0043457267020762915,0.9072911636890391
1226,Fulton,2279,1,1273,67,2278,2279,1.0,0.00043878894251864854,0.9995612110574813,939,0.5585783238262396,0.029398859148749453,0.412022817025011
1227,Fulton,1593,1,929,60,1592,1593,1.0,0.0006277463904582549,0.9993722536095417,604,0.5831763967357187,0.03766478342749529,0.37915881983678595
1228,Fulton,766,0,328,15,766,766,1.0,0.0,1.0,423,0.4281984334203655,0.0195822454308094,0.5522193211488251
1229,Fulton,1926,11,1198,48,1915,1926,1.0,0.005711318795430945,0.994288681204569,680,0.6220145379023884,0.024922118380062305,0.3530633437175493
1230,Fulton,951,1,643,40,950,951,1.0,0.0010515247108307045,0.9989484752891693,268,0.676130389064143,0.04206098843322818,0.28180862250262884
1231,Fulton,2956,4,1288,69,2952,2956,1.0,0.0013531799729364006,0.9986468200270636,1599,0.435723951285521,0.02334235453315291,0.5409336941813261
1232,Fulton,861,0,225,2,861,861,1.0,0.0,1.0,634,0.2613240418118467,0.0023228803716608595,0.7363530778164924
1233,Fulton,1858,6,1035,61,1852,1858,1.0,0.0032292787944025836,0.9967707212055974,762,0.5570505920344456,0.03283100107642627,0.4101184068891281
1234,Fulton,733,0,380,30,733,733,1.0,0.0,1.0,323,0.5184174624829468,0.040927694406548434,0.4406548431105048
1235,Fulton,3044,7,1973,208,3037,3044,1.0,0.0022996057818659658,0.9977003942181341,863,0.6481603153745072,0.0683311432325887,0.2835085413929041
1236,Fulton,3292,2,2185,217,3290,3292,1.0,0.0006075334143377885,0.9993924665856622,890,0.663730255164034,0.06591737545565006,0.2703523693803159
1237,Fulton,2159,0,1055,68,2159,2159,1.0,0.0,1.0,1036,0.4886521537748958,0.031496062992125984,0.4798517832329782
1238,Fulton,43,1,38,5,42,43,1.0,0.023255813953488372,0.9767441860465116,0,0.8837209302325582,0.11627906976744186,0.0
1239,Fulton,267,0,85,6,267,267,1.0,0.0,1.0,176,0.31835205992509363,0.02247191011235955,0.6591760299625468
1240,Fulton,143,0,130,13,143,143,3.4878048780487805,0.0,1.0,0,0.9090909090909091,0.09090909090909091,0.0
1241,Fulton,631,1,422,48,630,631,1.0,0.001584786053882726,0.9984152139461173,161,0.6687797147385103,0.07606973058637084,0.2551505546751189
1242,Fulton,7970,31,1097,119,7939,7970,1.0,0.0038895859473023838,0.9961104140526976,6754,0.13764115432873275,0.01493099121706399,0.8474278544542032
1243,Fulton,1873,3,1231,224,1870,1873,1.0,0.001601708489054992,0.9983982915109451,418,0.6572343833422317,0.1195942338494394,0.22317138280832888
1244,Fulton,10253,37,5955,1304,10216,10253,1.0,0.0036086998927143273,0.9963913001072857,2994,0.580805617867941,0.12718228811079685,0.29201209402126205
1245,Fulton,2385,4,1337,269,2381,2385,1.0,0.0016771488469601676,0.9983228511530399,779,0.5605870020964361,0.11278825995807128,0.3266247379454927
1246,Fulton,3114,17,1726,306,3097,3114,1.0,0.005459216441875401,0.9945407835581246,1082,0.5542710340398201,0.09826589595375723,0.3474630700064226
1247,Fulton,531,1,355,65,530,531,1.0,0.0018832391713747645,0.9981167608286252,111,0.6685499058380414,0.1224105461393597,0.20903954802259886
1248,Fulton,6154,31,2142,329,6123,6154,1.0,0.005037374065648359,0.9949626259343517,3683,0.34806629834254144,0.053461163470913224,0.5984725381865453
1249,Fulton,2626,1,1894,329,2625,2626,1.0,0.0003808073115003808,0.9996191926884996,403,0.7212490479817213,0.12528560548362527,0.15346534653465346
1250,Fulton,912,1,628,162,911,912,1.0,0.0010964912280701754,0.9989035087719298,122,0.6885964912280702,0.17763157894736842,0.1337719298245614
1251,Fulton,605,0,410,159,605,605,1.0,0.0,1.0,36,0.6776859504132231,0.2628099173553719,0.05950413223140496
1252,Fulton,1656,4,808,351,1652,1656,1.0,0.0024154589371980675,0.9975845410628019,497,0.48792270531400966,0.21195652173913043,0.3001207729468599
1253,Fulton,644,2,324,22,642,644,1.0,0.003105590062111801,0.9968944099378882,298,0.5031055900621118,0.034161490683229816,0.46273291925465837
1254,Fulton,1687,0,1092,261,1687,1687,1.0,0.0,1.0,334,0.6473029045643154,0.15471250740960285,0.1979845880260818
1255,Fulton,8969,14,3341,2030,8955,8969,1.0,0.0015609320994536737,0.9984390679005464,3598,0.3725052960196231,0.2263351544207827,0.40115954955959415
1256,Fulton,2628,0,1154,1280,2628,2628,1.0,0.0,1.0,194,0.439117199391172,0.487062404870624,0.07382039573820395
1257,Fulton,5466,9,1945,1266,5457,5466,1.0,0.001646542261251372,0.9983534577387486,2255,0.3558360775704354,0.23161361141602635,0.41255031101353823
1258,Fulton,5796,23,2020,1211,5773,5796,1.0,0.003968253968253968,0.996031746031746,2565,0.34851621808143546,0.20893719806763286,0.44254658385093165
1259,Fulton,2359,11,1192,510,2348,2359,1.0,0.0046629927935565915,0.9953370072064434,657,0.5052988554472234,0.2161933022467147,0.2785078423060619
1260,Fulton,4129,10,1790,1054,4119,4129,1.0,0.002421893921046258,0.9975781060789537,1285,0.4335190118672802,0.2552676192782756,0.3112133688544442
1261,Fulton,2048,2,1025,621,2046,2048,1.0,0.0009765625,0.9990234375,402,0.50048828125,0.30322265625,0.1962890625
1262,Fulton,3481,7,1537,707,3474,3481,1.0,0.002010916403332376,0.9979890835966676,1237,0.4415397874174088,0.20310255673656996,0.35535765584602125
1263,Fulton,2963,9,1039,452,2954,2963,1.0,0.0030374620317246033,0.9969625379682754,1472,0.3506581167735403,0.15254809314883563,0.49679379007762403
1264,Fulton,2644,3,1081,228,2641,2644,1.0,0.0011346444780635401,0.9988653555219364,1335,0.4088502269288956,0.08623298033282904,0.5049167927382754
1265,Fulton,3092,7,1306,1070,3085,3092,1.0,0.002263906856403622,0.9977360931435963,716,0.42238033635187583,0.3460543337645537,0.2315653298835705
1266,Fulton,3438,2,1444,1298,3436,3438,1.0,0.0005817335660267597,0.9994182664339732,696,0.4200116346713205,0.3775450843513671,0.2024432809773124
1267,Fulton,1378,0,506,691,1378,1378,1.0,0.0,1.0,181,0.3671988388969521,0.5014513788098693,0.1313497822931785
1268,Fulton,960,3,363,517,957,960,1.0,0.003125,0.996875,80,0.378125,0.5385416666666667,0.08333333333333333
1269,Fulton,2356,3,1085,1079,2353,2356,1.0,0.0012733446519524619,0.9987266553480475,192,0.4605263157894737,0.4579796264855688,0.08149405772495756
1270,Fulton,1962,5,891,956,1957,1962,1.0,0.0025484199796126403,0.9974515800203874,115,0.4541284403669725,0.4872579001019368,0.058613659531090725
1271,Fulton,3561,17,1265,737,3544,3561,1.0,0.004773939904521202,0.9952260600954788,1559,0.35523729289525413,0.20696433586071328,0.4377983712440326
1272,Fulton,2644,0,1099,971,2644,2644,1.0,0.0,1.0,574,0.41565809379727686,0.3672465960665658,0.21709531013615735
1273,Fulton,3593,2,1630,955,3591,3593,1.0,0.0005566379070414695,0.9994433620929585,1008,0.45365989423879766,0.2657946006123017,0.28054550514890064
1274,Fulton,818,3,570,247,815,818,1.3262987012987013,0.003667481662591687,0.9963325183374083,1,0.6968215158924206,0.3019559902200489,0.0012224938875305623
1275,Fulton,5679,7,2310,914,5672,5679,1.0,0.0012326113752421201,0.9987673886247579,2455,0.40676175382989965,0.16094382813875682,0.43229441803134355
1276,Fulton,2429,4,839,942,2425,2429,1.0,0.0016467682173734047,0.9983532317826266,648,0.3454096335940716,0.3878139151914368,0.26677645121449156
1277,Fulton,658,0,338,318,658,658,1.0,0.0,1.0,2,0.513677811550152,0.48328267477203646,0.00303951367781155
1278,Fulton,1875,3,756,452,1872,1875,1.0,0.0016,0.9984,667,0.4032,0.24106666666666668,0.35573333333333335
1279,Fulton,2333,10,946,186,2323,2333,1.0,0.0042863266180882984,0.9957136733819117,1201,0.405486498071153,0.07972567509644235,0.5147878268324046
1280,Fulton,4290,29,2098,595,4261,4290,1.0,0.00675990675990676,0.9932400932400932,1597,0.48904428904428904,0.1386946386946387,0.37226107226107225
1281,Fulton,399,2,175,7,397,399,1.0,0.005012531328320802,0.9949874686716792,217,0.43859649122807015,0.017543859649122806,0.543859649122807
1282,Fulton,2808,6,1601,67,2802,2808,1.0,0.002136752136752137,0.9978632478632479,1140,0.5701566951566952,0.02386039886039886,0.405982905982906
1283,Fulton,1763,8,949,48,1755,1763,1.0,0.0045377197958026095,0.9954622802041974,766,0.5382870107770845,0.027226318774815655,0.43448667044809985
1284,Fulton,2776,8,1514,123,2768,2776,1.0,0.002881844380403458,0.9971181556195965,1139,0.5453890489913544,0.04430835734870317,0.41030259365994237
1285,Fulton,4238,13,1917,1029,4225,4238,1.0,0.003067484662576687,0.9969325153374233,1292,0.4523360075507315,0.24280320906087777,0.30486078338839073
1286,Fulton,4547,8,2228,538,4539,4547,1.0,0.0017594018033868484,0.9982405981966131,1781,0.4899934022432373,0.11831977127776556,0.39168682647899716
1287,Fulton,1537,16,624,75,1521,1537,1.0,0.01040988939492518,0.9895901106050748,838,0.405985686402082,0.048796356538711776,0.5452179570592063
1288,Fulton,1096,1,563,35,1095,1096,1.0,0.0009124087591240876,0.9990875912408759,498,0.5136861313868614,0.03193430656934307,0.4543795620437956
1289,Fulton,4938,17,2051,119,4921,4938,1.0,0.003442689347914135,0.9965573106520859,2768,0.4153503442689348,0.024098825435398947,0.5605508302956662
1290,Fulton,2530,14,1591,279,2516,2530,1.0,0.005533596837944664,0.9944664031620554,660,0.6288537549407115,0.11027667984189723,0.2608695652173913
1291,Fulton,2764,6,1724,72,2758,2764,1.0,0.002170767004341534,0.9978292329956585,968,0.6237337192474675,0.02604920405209841,0.35021707670043417
1292,Fulton,3211,9,2592,96,3202,3211,1.0,0.002802865151043289,0.9971971348489567,523,0.8072251635004671,0.02989722827779508,0.16287760822173777
1293,Fulton,2365,8,1153,52,2357,2365,1.0,0.0033826638477801266,0.9966173361522199,1160,0.4875264270613108,0.021987315010570826,0.4904862579281184
1294,Fulton,4192,20,2117,121,4172,4192,1.0,0.004770992366412214,0.9952290076335878,1954,0.5050095419847328,0.028864503816793893,0.4661259541984733
1295,Fulton,910,4,569,31,906,910,1.0,0.004395604395604396,0.9956043956043956,310,0.6252747252747253,0.03406593406593406,0.34065934065934067
1296,Fulton,1009,1,638,31,1008,1009,1.0,0.0009910802775024777,0.9990089197224975,340,0.6323092170465807,0.030723488602576808,0.33696729435084244
1297,Fulton,1141,0,844,38,1141,1141,1.0,0.0,1.0,259,0.7397020157756354,0.033304119193689745,0.22699386503067484
1298,Fulton,421,0,269,8,421,421,1.0,0.0,1.0,144,0.6389548693586699,0.019002375296912115,0.342042755344418
1299,Fulton,2237,9,1083,50,2228,2237,1.0,0.004023245417970496,0.9959767545820295,1104,0.4841305319624497,0.022351363433169423,0.4935181046043809
1300,Fulton,305,0,264,10,305,305,1.0,0.0,1.0,31,0.8655737704918033,0.03278688524590164,0.10163934426229508
1301,Fulton,994,0,479,24,994,994,1.0,0.0,1.0,491,0.4818913480885312,0.02414486921529175,0.4939637826961771
1302,Fulton,1285,1,972,47,1284,1285,1.0,0.0007782101167315176,0.9992217898832685,266,0.756420233463035,0.036575875486381325,0.20700389105058364
1303,Fulton,2162,0,1531,70,2162,2162,1.0,0.0,1.0,561,0.7081406105457909,0.032377428307123035,0.25948196114708605
1304,Fulton,1287,0,720,31,1287,1287,1.0,0.0,1.0,536,0.5594405594405595,0.024087024087024088,0.41647241647241645
1305,Fulton,999,1,385,22,998,999,1.0,0.001001001001001001,0.998998998998999,592,0.38538538538538536,0.022022022022022022,0.5925925925925926
1306,Fulton,5452,14,2949,101,5438,5452,1.0,0.0025678650036683784,0.9974321349963317,2402,0.5409024211298606,0.018525311812179018,0.4405722670579604
1307,Fulton,2592,4,2095,53,2588,2592,1.0,0.0015432098765432098,0.9984567901234568,444,0.8082561728395061,0.02044753086419753,0.1712962962962963
1308,Fulton,1287,2,688,37,1285,1287,1.0,0.001554001554001554,0.9984459984459985,562,0.5345765345765345,0.028749028749028748,0.4366744366744367
1309,Fulton,922,0,581,24,922,922,1.0,0.0,1.0,317,0.6301518438177874,0.026030368763557483,0.3438177874186551
1310,Fulton,3425,7,1988,64,3418,3425,1.0,0.0020437956204379564,0.997956204379562,1373,0.5804379562043795,0.018686131386861315,0.40087591240875914
1311,Fulton,2220,2,957,51,2218,2220,1.0,0.0009009009009009009,0.9990990990990991,1212,0.43108108108108106,0.022972972972972974,0.5459459459459459
1312,Fulton,575,1,372,26,574,575,1.0,0.0017391304347826088,0.9982608695652174,177,0.6469565217391304,0.04521739130434783,0.30782608695652175
1313,Fulton,1882,4,1068,36,1878,1882,1.0,0.0021253985122210413,0.997874601487779,778,0.5674814027630181,0.019128586609989374,0.41339001062699254
1314,Fulton,1723,3,1158,53,1720,1723,1.0,0.0017411491584445734,0.9982588508415554,512,0.6720835751596054,0.030760301799187463,0.2971561230412072
1315,Fulton,3452,8,1770,70,3444,3452,1.0,0.002317497103128621,0.9976825028968713,1612,0.5127462340672074,0.020278099652375436,0.46697566628041715
1316,Fulton,2133,14,1440,70,2119,2133,1.0,0.006563525550867323,0.9934364744491326,623,0.6751054852320675,0.032817627754336616,0.29207688701359585
1317,Fulton,2012,6,1088,39,2006,2012,1.0,0.002982107355864811,0.9970178926441352,885,0.5407554671968191,0.019383697813121274,0.4398608349900596
1318,Fulton,2396,4,809,37,2392,2396,1.0,0.001669449081803005,0.998330550918197,1550,0.33764607679465775,0.015442404006677797,0.6469115191986644
1319,Fulton,4707,17,3034,199,4690,4707,1.0,0.0036116422349691947,0.9963883577650308,1474,0.6445719141703845,0.04227745910346293,0.3131506267261525
1320,Fulton,1282,4,586,30,1278,1282,1.0,0.0031201248049922,0.9968798751950078,666,0.45709828393135726,0.0234009360374415,0.5195007800312013
1321,Fulton,1912,12,671,64,1900,1912,1.0,0.006276150627615063,0.9937238493723849,1177,0.35094142259414224,0.03347280334728033,0.6155857740585774
1322,Fulton,902,3,496,29,899,902,1.0,0.0033259423503325942,0.9966740576496674,377,0.549889135254989,0.03215077605321508,0.417960088691796
1323,Fulton,820,3,431,25,817,820,1.0,0.003658536585365854,0.9963414634146341,364,0.525609756097561,0.03048780487804878,0.44390243902439025
1324,Fulton,1044,7,346,32,1037,1044,1.0,0.006704980842911878,0.9932950191570882,666,0.3314176245210728,0.03065134099616858,0.6379310344827587
1325,Fulton,2575,5,1389,43,2570,2575,1.0,0.001941747572815534,0.9980582524271845,1143,0.5394174757281553,0.016699029126213592,0.4438834951456311
1326,Fulton,928,0,491,22,928,928,1.0,0.0,1.0,415,0.5290948275862069,0.023706896551724137,0.44719827586206895
1327,Fulton,3122,26,1327,78,3096,3122,1.0,0.008327994875080076,0.9916720051249199,1717,0.4250480461242793,0.024983984625240232,0.5499679692504804
1328,Fulton,2966,9,1512,105,2957,2966,1.0,0.0030343897505057315,0.9969656102494943,1349,0.5097774780849629,0.035401213755900204,0.4548213081591369
1329,Fulton,614,3,268,18,611,614,1.0,0.004885993485342019,0.995114006514658,328,0.4364820846905538,0.029315960912052116,0.5342019543973942
1330,Fulton,2499,9,1312,69,2490,2499,1.0,0.003601440576230492,0.9963985594237695,1118,0.5250100040016007,0.027611044417767107,0.44737895158063223
1331,Fulton,862,6,402,18,856,862,1.0,0.0069605568445475635,0.9930394431554525,442,0.46635730858468677,0.02088167053364269,0.5127610208816705
1332,Fulton,1936,5,996,40,1931,1936,1.0,0.0025826446280991736,0.9974173553719008,900,0.5144628099173554,0.02066115702479339,0.46487603305785125
1333,Fulton,5584,6,2195,1864,5578,5584,1.0,0.0010744985673352436,0.9989255014326648,1525,0.39308739255014324,0.333810888252149,0.27310171919770776
1334,Fulton,1650,1,486,400,1649,1650,1.0,0.0006060606060606061,0.9993939393939394,764,0.29454545454545455,0.24242424242424243,0.463030303030303
1335,Fulton,2399,3,978,879,2396,2399,1.0,0.0012505210504376823,0.9987494789495623,542,0.40766986244268444,0.36640266777824093,0.2259274697790746
1336,Fulton,1229,0,392,278,1229,1229,1.0,0.0,1.0,559,0.3189585028478438,0.22620016273393004,0.4548413344182262
1337,Fulton,3352,15,1291,1266,3337,3352,1.0,0.004474940334128878,0.9955250596658711,795,0.38514319809069214,0.3776849642004773,0.23717183770883055
1338,Fulton,2661,4,1000,778,2657,2661,1.0,0.001503194287861706,0.9984968057121383,883,0.37579857196542654,0.29237128898910186,0.33183013904547165
1339,Fulton,746,0,280,203,746,746,1.0,0.0,1.0,263,0.3753351206434316,0.27211796246648795,0.35254691689008044
1340,Fulton,1091,21,325,101,1070,1091,1.0,0.01924839596700275,0.9807516040329972,665,0.29789184234647115,0.0925756186984418,0.6095325389550871
1341,Fulton,1593,2,658,764,1591,1593,1.0,0.0012554927809165098,0.9987445072190835,171,0.4130571249215317,0.4795982423101067,0.10734463276836158
1342,Fulton,518,0,193,205,518,518,1.0,0.0,1.0,120,0.37258687258687256,0.39575289575289574,0.23166023166023167
1343,Fulton,4605,9,1927,1857,4596,4605,1.0,0.001954397394136808,0.9980456026058632,821,0.41845819761129205,0.40325732899022804,0.17828447339847991
1344,Fulton,1788,1,694,888,1787,1788,1.0,0.0005592841163310962,0.9994407158836689,206,0.38814317673378074,0.4966442953020134,0.11521252796420582
1345,Fulton,4594,12,1464,1370,4582,4594,1.0,0.00261210274270788,0.9973878972572922,1760,0.31867653461036133,0.2982150631258163,0.38310840226382237
1346,Fulton,1889,7,768,755,1882,1889,1.0,0.0037056643726839597,0.9962943356273161,366,0.4065643197458973,0.39968237162519854,0.1937533086289042
1347,Fulton,5233,7,1933,1508,5226,5233,1.0,0.0013376648194152493,0.9986623351805848,1792,0.36938658513281103,0.28817122109688514,0.3424421937703038
1348,Fulton,1005,2,453,238,1003,1005,1.0,0.001990049751243781,0.9980099502487563,314,0.4507462686567164,0.23681592039800994,0.3124378109452736
1349,Fulton,946,0,343,476,946,946,1.0,0.0,1.0,127,0.36257928118393234,0.5031712473572939,0.13424947145877378
1350,Fulton,1507,12,320,185,1495,1507,1.0,0.007962840079628402,0.9920371599203716,1002,0.21234240212342403,0.12276045122760451,0.6648971466489715
1351,Fulton,1953,1,406,201,1952,1953,1.0,0.0005120327700972862,0.9994879672299027,1346,0.2078853046594982,0.10291858678955453,0.6891961085509473
1352,Fulton,2684,8,792,955,2676,2684,1.0,0.0029806259314456036,0.9970193740685543,937,0.29508196721311475,0.35581222056631895,0.3491058122205663
1353,Fulton,3184,7,1419,1161,3177,3184,1.0,0.0021984924623115578,0.9978015075376885,604,0.44566582914572866,0.3646356783919598,0.18969849246231155
1354,Fulton,340,0,150,61,340,340,1.0,0.0,1.0,129,0.4411764705882353,0.17941176470588235,0.37941176470588234
1355,Fulton,413,1,96,151,412,413,1.0,0.002421307506053269,0.9975786924939467,166,0.2324455205811138,0.36561743341404357,0.4019370460048426
1356,Fulton,410,1,98,208,409,410,1.0,0.0024390243902439024,0.9975609756097561,104,0.23902439024390243,0.5073170731707317,0.25365853658536586
1357,Fulton,803,1,345,321,802,803,1.0,0.0012453300124533001,0.9987546699875467,137,0.42963885429638854,0.39975093399750933,0.1706102117061021
1358,Fulton,475,0,90,240,475,475,1.0,0.0,1.0,145,0.18947368421052632,0.5052631578947369,0.30526315789473685
1359,Fulton,1285,11,610,143,1274,1285,1.0,0.008560311284046693,0.9914396887159533,532,0.47470817120622566,0.111284046692607,0.4140077821011673
1360,Fulton,1377,8,786,143,1369,1377,1.0,0.005809731299927378,0.9941902687000727,448,0.5708061002178649,0.10384894698620188,0.3253449527959332
1361,Fulton,416,0,188,64,416,416,1.0,0.0,1.0,164,0.4519230769230769,0.15384615384615385,0.3942307692307692
1362,Fulton,1338,0,586,80,1338,1338,1.0,0.0,1.0,672,0.43796711509715996,0.059790732436472344,0.5022421524663677
1364,Fulton,44,0,16,3,44,44,1.0,0.0,1.0,25,0.36363636363636365,0.06818181818181818,0.5681818181818182
1365,Fulton,1481,3,921,43,1478,1481,1.0,0.002025658338960162,0.9979743416610398,517,0.6218771100607697,0.02903443619176232,0.34908845374746794
1366,Fulton,144,0,72,5,144,144,1.0,0.0,1.0,67,0.5,0.034722222222222224,0.4652777777777778
1367,Fulton,658,0,214,14,658,658,1.0,0.0,1.0,430,0.3252279635258359,0.02127659574468085,0.6534954407294833
1368,Fulton,18,0,3,1,18,18,1.0,0.0,1.0,14,0.16666666666666666,0.05555555555555555,0.7777777777777778
1369,Fulton,227,0,71,1,227,227,1.0,0.0,1.0,155,0.31277533039647576,0.004405286343612335,0.6828193832599119
1370,Fulton,237,34,225,11,203,237,33.714285714285715,0.14345991561181434,0.8565400843881856,1,0.9493670886075949,0.046413502109704644,0.004219409282700422
1371,Fulton,42,0,41,1,42,42,1.2352941176470589,0.0,1.0,0,0.9761904761904762,0.023809523809523808,0.0
1372,Fulton,363,0,61,3,363,363,1.0,0.0,1.0,299,0.16804407713498623,0.008264462809917356,0.8236914600550964
1373,Fulton,459,0,106,7,459,459,1.0,0.0,1.0,346,0.23093681917211328,0.015250544662309368,0.7538126361655774
1374,Fulton,171,0,36,0,171,171,1.0,0.0,1.0,135,0.21052631578947367,0.0,0.7894736842105263
1375,Fulton,283,0,0,0,283,283,1.0,0.0,1.0,283,0.0,0.0,1.0
1376,Fulton,604,0,177,6,604,604,1.0,0.0,1.0,421,0.29304635761589404,0.009933774834437087,0.6970198675496688
1377,Fulton,3187,18,1462,168,3169,3187,1.0,0.005647944775651083,0.9943520552243489,1557,0.45873862566677126,0.052714151239410104,0.48854722309381865
1378,Fulton,3358,25,1591,146,3333,3358,1.0,0.007444907683144729,0.9925550923168552,1621,0.47379392495533057,0.043478260869565216,0.48272781417510424
1379,Fulton,2645,29,1042,70,2616,2645,1.0,0.010964083175803403,0.9890359168241966,1533,0.3939508506616257,0.026465028355387523,0.5795841209829867
1380,Fulton,1737,18,982,154,1719,1737,1.0,0.010362694300518135,0.9896373056994818,601,0.565342544617156,0.08865860679332183,0.3459988485895222
1381,Fulton,545,0,261,48,545,545,1.0,0.0,1.0,236,0.47889908256880737,0.08807339449541285,0.43302752293577984
1382,Fulton,492,1,233,12,491,492,1.0,0.0020325203252032522,0.9979674796747967,247,0.4735772357723577,0.024390243902439025,0.5020325203252033
1383,Fulton,1495,3,697,52,1492,1495,1.0,0.002006688963210702,0.9979933110367893,746,0.4662207357859532,0.034782608695652174,0.49899665551839467
1384,Fulton,5136,28,2674,178,5108,5136,1.0,0.005451713395638629,0.9945482866043613,2284,0.5206386292834891,0.03465732087227414,0.4447040498442368
1385,Fulton,1419,2,1020,61,1417,1419,1.0,0.0014094432699083862,0.9985905567300916,338,0.718816067653277,0.04298801973220578,0.23819591261451725
1386,Fulton,6955,17,2991,120,6938,6955,1.0,0.0024442846872753414,0.9975557153127247,3844,0.43005032350826744,0.017253774263120056,0.5526959022286125
1387,Fulton,2626,6,1490,57,2620,2626,1.0,0.002284843869002285,0.9977151561309977,1079,0.5674028941355674,0.021706016755521706,0.41089108910891087
1388,Fulton,4306,7,2223,300,4299,4306,1.0,0.001625638643752903,0.9983743613562471,1783,0.516256386437529,0.06967022758941012,0.41407338597306087
1389,Fulton,7259,17,3246,361,7242,7259,1.0,0.00234192037470726,0.9976580796252927,3652,0.44716903154704507,0.04973136795701887,0.503099600495936
1390,Fulton,813,0,445,32,813,813,1.0,0.0,1.0,336,0.5473554735547356,0.03936039360393604,0.4132841328413284
1391,Fulton,5057,62,1622,556,4995,5057,1.0,0.012260233339924856,0.9877397666600751,2879,0.32074352382835675,0.10994660866126162,0.5693098675103816
1392,Fulton,6380,13,2902,1573,6367,6380,1.0,0.0020376175548589342,0.997962382445141,1905,0.454858934169279,0.24655172413793103,0.29858934169278994
1393,Fulton,3786,0,1306,897,3786,3786,1.0,0.0,1.0,1583,0.3449550977284733,0.23692551505546752,0.4181193872160592
1394,Fulton,596,0,283,198,596,596,1.0,0.0,1.0,115,0.4748322147651007,0.33221476510067116,0.1929530201342282
1395,Fulton,1890,3,777,445,1887,1890,1.0,0.0015873015873015873,0.9984126984126984,668,0.4111111111111111,0.23544973544973544,0.35343915343915344
1396,Fulton,4196,0,2118,1431,4196,4196,1.0,0.0,1.0,647,0.5047664442326025,0.34103908484270734,0.15419447092469019
1397,Fulton,417,2,149,80,415,417,1.0,0.004796163069544364,0.9952038369304557,188,0.35731414868105515,0.19184652278177458,0.45083932853717024
1398,Fulton,2939,4,1054,700,2935,2939,1.0,0.0013610071452875127,0.9986389928547125,1185,0.3586253827832596,0.23817625042531473,0.4031983667914257
1399,Fulton,3379,5,1094,967,3374,3379,1.0,0.001479727730097662,0.9985202722699024,1318,0.3237644273453685,0.2861793430008878,0.3900562296537437
1400,Fulton,5264,4,2145,1403,5260,5264,1.0,0.0007598784194528875,0.9992401215805471,1716,0.40748480243161095,0.2665273556231003,0.32598784194528874
1401,Fulton,3157,6,1267,1013,3151,3157,1.0,0.0019005384859043396,0.9980994615140957,877,0.401330376940133,0.32087424770351597,0.27779537535635096
1402,Fulton,3616,7,1426,947,3609,3616,1.0,0.0019358407079646017,0.9980641592920354,1243,0.39435840707964603,0.26189159292035397,0.34375
1403,Fulton,3127,8,1246,725,3119,3127,1.0,0.0025583626479053407,0.9974416373520947,1156,0.3984649824112568,0.23185161496642148,0.3696834026223217
1404,Fulton,4178,2,1314,1364,4176,4178,1.0,0.0004786979415988511,0.9995213020584012,1500,0.31450454763044516,0.32647199617041645,0.35902345619913834
1405,Fulton,2759,1,907,1328,2758,2759,1.0,0.0003624501631025734,0.9996375498368975,524,0.3287422979340341,0.48133381660021746,0.18992388546574845
1406,Fulton,2181,2,768,1067,2179,2181,1.0,0.0009170105456212746,0.9990829894543787,346,0.35213204951856947,0.48922512608895,0.1586428243924805
1407,Fulton,275,1,76,156,274,275,1.0,0.0036363636363636364,0.9963636363636363,43,0.27636363636363637,0.5672727272727273,0.15636363636363637
1408,Fulton,2648,8,1042,1040,2640,2648,1.0,0.0030211480362537764,0.9969788519637462,566,0.3935045317220544,0.39274924471299094,0.21374622356495468
1409,Fulton,1074,5,430,266,1069,1074,1.0,0.004655493482309125,0.9953445065176909,378,0.40037243947858475,0.24767225325884543,0.35195530726256985
1410,Fulton,2708,0,1108,976,2708,2708,1.0,0.0,1.0,624,0.4091580502215657,0.3604135893648449,0.23042836041358936
1411,Fulton,2645,1,1146,1151,2644,2645,1.0,0.0003780718336483932,0.9996219281663516,348,0.4332703213610586,0.43516068052930057,0.13156899810964084
1412,Fulton,4216,24,1794,1362,4192,4216,1.0,0.0056925996204933585,0.9943074003795066,1060,0.42552182163187857,0.3230550284629981,0.2514231499051233
1413,Fulton,2612,0,1078,1236,2612,2612,1.0,0.0,1.0,298,0.4127105666156202,0.47320061255742724,0.11408882082695253
1414,Fulton,717,0,206,346,717,717,1.0,0.0,1.0,165,0.28730822873082285,0.4825662482566248,0.2301255230125523
1415,Fulton,2404,8,679,1397,2396,2404,1.0,0.0033277870216306157,0.9966722129783694,328,0.28244592346089853,0.5811148086522463,0.13643926788685523
1416,Fulton,1680,3,568,960,1677,1680,1.0,0.0017857142857142857,0.9982142857142857,152,0.3380952380952381,0.5714285714285714,0.09047619047619047
1417,Fulton,3626,7,1178,2048,3619,3626,1.0,0.0019305019305019305,0.9980694980694981,400,0.3248758963044677,0.5648097076668506,0.11031439602868175
1418,Fulton,3151,8,1075,1576,3143,3151,1.0,0.0025388765471278957,0.9974611234528721,500,0.341161536020311,0.5001586797841955,0.1586797841954935
1419,Fulton,5071,10,1869,1794,5061,5071,1.0,0.0019719976336028395,0.9980280023663972,1408,0.3685663577203707,0.35377637546834945,0.27765726681127983
1420,Fulton,4668,28,939,446,4640,4668,1.0,0.005998286203941731,0.9940017137960583,3283,0.2011568123393316,0.09554413024850043,0.7032990574121679
1421,Fulton,3682,11,1431,774,3671,3682,1.0,0.0029875067897881585,0.9970124932102118,1477,0.388647474198805,0.2102118413905486,0.4011406844106464
1422,Fulton,1591,1,476,841,1590,1591,1.0,0.0006285355122564425,0.9993714644877436,274,0.29918290383406665,0.5285983658076682,0.17221873035826524
1423,Fulton,761,5,235,411,756,761,1.0,0.006570302233902759,0.9934296977660972,115,0.3088042049934297,0.5400788436268068,0.15111695137976347
1424,Fulton,470,2,189,180,468,470,1.0,0.00425531914893617,0.9957446808510638,101,0.4021276595744681,0.3829787234042553,0.2148936170212766
1425,Fulton,3415,15,1393,411,3400,3415,1.0,0.004392386530014641,0.9956076134699854,1611,0.40790629575402637,0.12035139092240117,0.47174231332357247
1426,Fulton,4707,12,1928,2276,4695,4707,1.0,0.0025493945188017845,0.9974506054811982,503,0.4096027193541534,0.48353516039940514,0.10686212024644147
1427,Fulton,4001,0,1737,1523,4001,4001,1.0,0.0,1.0,741,0.43414146463384157,0.3806548362909273,0.18520369907523118
1428,Fulton,5934,24,2038,1347,5910,5934,1.0,0.004044489383215369,0.9959555106167847,2549,0.34344455679137176,0.2269969666329626,0.42955847657566565
1429,Fulton,1709,0,883,650,1709,1709,1.0,0.0,1.0,176,0.5166764189584553,0.38033937975424226,0.10298420128730251
1430,Fulton,4283,79,1220,615,4204,4283,1.0,0.01844501517627831,0.9815549848237217,2448,0.2848470698108802,0.1435909409292552,0.5715619892598646
1431,Fulton,3067,8,1335,934,3059,3067,1.0,0.0026084121291164004,0.9973915878708836,798,0.43527877404629933,0.3045321160743397,0.26018910987936095
1432,Fulton,2710,47,754,145,2663,2710,1.0,0.01734317343173432,0.9826568265682657,1811,0.2782287822878229,0.05350553505535055,0.6682656826568266
1433,Fulton,1335,17,203,74,1318,1335,1.0,0.012734082397003745,0.9872659176029962,1058,0.15205992509363295,0.05543071161048689,0.7925093632958802
1434,Fulton,2492,6,823,1008,2486,2492,1.0,0.002407704654895666,0.9975922953451043,661,0.33025682182985555,0.4044943820224719,0.26524879614767255
1435,Fulton,5744,7,2132,3031,5737,5744,1.0,0.0012186629526462396,0.9987813370473537,581,0.3711699164345404,0.5276810584958217,0.10114902506963788
1436,Fulton,3635,3,1347,1599,3632,3635,1.0,0.0008253094910591472,0.9991746905089408,689,0.3705639614855571,0.43988995873452547,0.18954607977991747
1437,Fulton,2961,13,1154,900,2948,2961,1.0,0.004390408645727794,0.9956095913542722,907,0.38973319824383656,0.303951367781155,0.30631543397500843
1438,Fulton,6246,2,2447,2667,6244,6246,1.0,0.0003202049311559398,0.9996797950688441,1132,0.39177073326929235,0.42699327569644574,0.18123599103426194
1439,Fulton,3910,5,1583,1329,3905,3910,1.0,0.0012787723785166241,0.9987212276214834,998,0.4048593350383632,0.33989769820971866,0.25524296675191815
1440,Fulton,1957,7,804,856,1950,1957,1.0,0.0035769034236075624,0.9964230965763924,297,0.4108329075114972,0.43740419008686765,0.15176290240163515
1441,Fulton,3369,16,1351,765,3353,3369,1.0,0.004749183734045711,0.9952508162659542,1253,0.40100920154348474,0.22707034728406056,0.37192045117245476
1442,Fulton,1948,1,801,950,1947,1948,1.0,0.000513347022587269,0.9994866529774127,197,0.41119096509240244,0.48767967145790553,0.10112936344969199
1443,Fulton,2627,2,1119,1045,2625,2627,1.0,0.0007613247049866769,0.9992386752950133,463,0.42596117244004567,0.39779215835553866,0.17624666920441567
1444,Fulton,3367,4,1186,1420,3363,3367,1.0,0.001188001188001188,0.9988119988119988,761,0.35224235224235223,0.42174042174042176,0.22601722601722601
1445,Fulton,5776,17,2040,1100,5759,5776,1.0,0.002943213296398892,0.9970567867036011,2636,0.35318559556786705,0.1904432132963989,0.45637119113573404
1446,Fulton,427,0,50,3,427,427,1.0,0.0,1.0,374,0.117096018735363,0.00702576112412178,0.8758782201405152
1447,Fulton,2027,7,1557,49,2020,2027,1.0,0.003453379378391712,0.9965466206216083,421,0.7681302417365565,0.024173655648741982,0.20769610261470153
1448,Fulton,2192,4,1599,60,2188,2192,1.0,0.0018248175182481751,0.9981751824817519,533,0.729470802919708,0.02737226277372263,0.24315693430656934
1450,Fulton,1064,0,1031,33,1064,1064,1.2049830124575311,0.0,1.0,0,0.9689849624060151,0.03101503759398496,0.0
1451,Fulton,1129,10,527,208,1119,1129,1.0,0.008857395925597875,0.9911426040744021,394,0.466784765279008,0.18423383525243578,0.3489813994685562
1452,Fulton,704,0,458,16,704,704,1.0,0.0,1.0,230,0.6505681818181818,0.022727272727272728,0.32670454545454547
1453,Fulton,3391,2,2443,93,3389,3391,1.0,0.0005897965202005308,0.9994102034797995,855,0.7204364494249484,0.027425538189324684,0.2521380123857269
1454,Fulton,2911,6,1829,80,2905,2911,1.0,0.0020611473720371005,0.9979388526279629,1002,0.6283064239093095,0.027481964960494674,0.3442116111301958
1455,Fulton,663,0,399,74,663,663,1.0,0.0,1.0,190,0.6018099547511312,0.11161387631975868,0.2865761689291101
1456,Fulton,6661,24,4088,413,6637,6661,1.0,0.003603062603212731,0.9963969373967873,2160,0.6137216634139018,0.06200270229695241,0.3242756342891458
1457,Fulton,12,0,11,1,12,12,1.0909090909090908,0.0,1.0,0,0.9166666666666666,0.08333333333333333,0.0
1458,Fulton,3637,4,2442,124,3633,3637,1.0,0.0010998075336816058,0.9989001924663184,1071,0.6714324993126203,0.03409403354412978,0.29447346714324996
1459,Fulton,94,0,71,0,94,94,1.0,0.0,1.0,23,0.7553191489361702,0.0,0.24468085106382978
1460,Fulton,607,0,345,11,607,607,1.0,0.0,1.0,251,0.5683690280065898,0.018121911037891267,0.4135090609555189
1461,Fulton,760,4,413,17,756,760,1.0,0.005263157894736842,0.9947368421052631,330,0.5434210526315789,0.02236842105263158,0.4342105263157895
1462,Fulton,717,0,420,14,717,717,1.0,0.0,1.0,283,0.5857740585774058,0.019525801952580194,0.3947001394700139
1463,Fulton,13,0,3,0,13,13,1.0,0.0,1.0,10,0.23076923076923078,0.0,0.7692307692307693
1465,Fulton,1857,3,943,46,1854,1857,1.0,0.0016155088852988692,0.9983844911147012,868,0.5078082929456113,0.024771136241249325,0.4674205708131395
1466,Fulton,1840,4,1202,46,1836,1840,1.0,0.002173913043478261,0.9978260869565218,592,0.6532608695652173,0.025,0.3217391304347826
1467,Fulton,1655,0,998,54,1655,1655,1.0,0.0,1.0,603,0.6030211480362537,0.03262839879154079,0.36435045317220544
1468,Fulton,1633,13,768,49,1620,1633,1.0,0.007960808328230252,0.9920391916717698,816,0.47030006123698714,0.030006123698714023,0.49969381506429883
1469,Fulton,1479,0,960,44,1479,1479,1.0,0.0,1.0,475,0.6490872210953347,0.029749830966869506,0.3211629479377958
1470,Fulton,1512,0,959,51,1512,1512,1.0,0.0,1.0,502,0.6342592592592593,0.03373015873015873,0.33201058201058203
1471,Fulton,3086,10,1904,115,3076,3086,1.0,0.0032404406999351912,0.9967595593000648,1067,0.6169799092676604,0.037265068049254696,0.3457550226830849
1472,Fulton,1058,5,474,32,1053,1058,1.0,0.004725897920604915,0.995274102079395,552,0.44801512287334594,0.030245746691871456,0.5217391304347826
1473,Fulton,327,3,46,14,324,327,1.0,0.009174311926605505,0.9908256880733946,267,0.14067278287461774,0.04281345565749235,0.8165137614678899
1474,Fulton,6720,9,4595,216,6711,6720,1.0,0.0013392857142857143,0.9986607142857142,1909,0.6837797619047619,0.03214285714285714,0.28407738095238094
1475,Fulton,4780,14,3600,108,4766,4780,1.0,0.0029288702928870294,0.997071129707113,1072,0.7531380753138075,0.022594142259414227,0.22426778242677825
1476,Fulton,17,0,16,1,17,17,1.7,0.0,1.0,0,0.9411764705882353,0.058823529411764705,0.0
1477,Fulton,72,0,43,1,72,72,1.0,0.0,1.0,28,0.5972222222222222,0.013888888888888888,0.3888888888888889
1478,Fulton,33,0,4,1,33,33,1.0,0.0,1.0,28,0.12121212121212122,0.030303030303030304,0.8484848484848485
1479,Fulton,1241,1,732,45,1240,1241,1.0,0.0008058017727639,0.9991941982272361,464,0.5898468976631749,0.0362610797743755,0.37389202256244963
1480,Fulton,985,4,380,13,981,985,1.0,0.0040609137055837565,0.9959390862944163,592,0.38578680203045684,0.013197969543147208,0.601015228426396
1481,Fulton,888,0,654,24,888,888,1.0,0.0,1.0,210,0.7364864864864865,0.02702702702702703,0.23648648648648649
1482,Fulton,1876,5,1507,72,1871,1876,1.0,0.0026652452025586353,0.9973347547974414,297,0.8033049040511727,0.03837953091684435,0.15831556503198294
1483,Fulton,208,0,134,7,208,208,1.0,0.0,1.0,67,0.6442307692307693,0.03365384615384615,0.32211538461538464
1484,Fulton,1839,1,786,37,1838,1839,1.0,0.000543773790103317,0.9994562262098967,1016,0.4274061990212072,0.02011963023382273,0.5524741707449701
1485,Fulton,2449,2,1964,55,2447,2449,1.0,0.0008166598611678236,0.9991833401388321,430,0.8019599836668028,0.022458146182115148,0.17558187015108206
1486,Fulton,1937,3,1212,62,1934,1937,1.0,0.0015487867836861124,0.9984512132163139,663,0.6257098606091894,0.03200826019617966,0.3422818791946309
1487,Fulton,4478,5,2537,176,4473,4478,1.0,0.0011165698972755694,0.9988834301027244,1765,0.5665475658776239,0.03930326038410004,0.394149173738276
1488,Fulton,3642,9,2085,90,3633,3642,1.0,0.002471169686985173,0.9975288303130149,1467,0.5724876441515651,0.02471169686985173,0.4028006589785832
1489,Fulton,492,0,334,22,492,492,1.0,0.0,1.0,136,0.6788617886178862,0.044715447154471545,0.2764227642276423
1490,Fulton,2573,2,1467,68,2571,2573,1.0,0.000777302759424796,0.9992226972405752,1038,0.5701515740380878,0.026428293820443063,0.4034201321414691
1491,Fulton,2183,2,1342,62,2181,2183,1.0,0.0009161704076958314,0.9990838295923041,779,0.6147503435639029,0.028401282638570773,0.3568483737975263
1492,Fulton,2799,8,1776,74,2791,2799,1.0,0.0028581636298678098,0.9971418363701322,949,0.6345123258306538,0.02643801357627724,0.33904966059306896
1493,Fulton,165,0,114,7,165,165,1.0,0.0,1.0,44,0.6909090909090909,0.04242424242424243,0.26666666666666666
1494,Fulton,1609,4,575,22,1605,1609,1.0,0.002486016159105034,0.997513983840895,1012,0.3573648228713487,0.013673088875077687,0.6289620882535737
1495,Fulton,4441,3,1807,2038,4438,4441,1.0,0.0006755235307363207,0.9993244764692637,596,0.4068903400135105,0.45890565188020715,0.13420400810628236
1496,Fulton,1286,1,564,331,1285,1286,1.0,0.0007776049766718507,0.9992223950233281,391,0.4385692068429238,0.2573872472783826,0.30404354587869364
1497,Fulton,1615,2,684,231,1613,1615,1.0,0.001238390092879257,0.9987616099071207,700,0.4235294117647059,0.14303405572755418,0.43343653250773995
1498,Fulton,1787,3,741,473,1784,1787,1.0,0.0016787912702853946,0.9983212087297146,573,0.41466144376049247,0.2646894236149972,0.32064913262451034
1499,Fulton,4324,19,1799,895,4305,4324,1.0,0.0043940795559666975,0.9956059204440333,1630,0.416049953746531,0.20698427382053655,0.37696577243293244
1500,Fulton,1734,0,864,692,1734,1734,1.0,0.0,1.0,178,0.4982698961937716,0.3990772779700115,0.10265282583621683
1501,Fulton,1680,1,776,625,1679,1680,1.0,0.0005952380952380953,0.9994047619047619,279,0.46190476190476193,0.37202380952380953,0.16607142857142856
1502,Fulton,1288,1,527,471,1287,1288,1.0,0.0007763975155279503,0.9992236024844721,290,0.4091614906832298,0.3656832298136646,0.2251552795031056
1503,Fulton,1091,2,370,195,1089,1091,1.0,0.0018331805682859762,0.998166819431714,526,0.3391384051329056,0.17873510540788268,0.4821264894592117
1504,Fulton,989,4,299,230,985,989,1.0,0.004044489383215369,0.9959555106167847,460,0.3023255813953488,0.23255813953488372,0.46511627906976744
1505,Fulton,2569,11,911,381,2558,2569,1.0,0.004281821720513819,0.9957181782794862,1277,0.3546126897625535,0.1483067341377968,0.4970805760996497
1506,Fulton,695,9,308,252,686,695,1.0,0.012949640287769784,0.9870503597122302,135,0.44316546762589926,0.36258992805755397,0.19424460431654678
1507,Fulton,949,3,345,152,946,949,1.0,0.003161222339304531,0.9968387776606955,452,0.3635405690200211,0.1601685985247629,0.47629083245521603
1508,Fulton,2644,6,717,310,2638,2644,1.0,0.0022692889561270802,0.9977307110438729,1617,0.27118003025718607,0.1172465960665658,0.6115733736762481
1509,Fulton,2951,8,1300,1273,2943,2951,1.0,0.0027109454422229754,0.997289054557777,378,0.44052863436123346,0.43137919349373094,0.12809217214503557
1510,Fulton,3272,9,1545,1399,3263,3272,1.0,0.0027506112469437654,0.9972493887530562,328,0.4721882640586797,0.4275672371638142,0.10024449877750612
1511,Fulton,5249,23,1785,936,5226,5249,1.0,0.004381787007048962,0.9956182129929511,2528,0.3400647742427129,0.178319679939036,0.4816155458182511
1512,Fulton,3026,48,655,235,2978,3026,1.0,0.015862524785194978,0.984137475214805,2136,0.21645736946463978,0.07766027759418374,0.7058823529411765
1513,Fulton,812,14,161,33,798,812,1.0,0.017241379310344827,0.9827586206896551,618,0.19827586206896552,0.04064039408866995,0.7610837438423645
1514,Fulton,411,0,172,145,411,411,1.0,0.0,1.0,94,0.41849148418491483,0.35279805352798055,0.22871046228710462
1515,Fulton,3098,5,1302,942,3093,3098,1.0,0.0016139444803098773,0.9983860555196902,854,0.42027114267269206,0.3040671400903809,0.27566171723692706
1516,Fulton,2628,9,855,653,2619,2628,1.0,0.003424657534246575,0.9965753424657534,1120,0.3253424657534247,0.2484779299847793,0.426179604261796
1517,Fulton,1387,7,541,368,1380,1387,1.0,0.005046863734679163,0.9949531362653208,478,0.39005046863734677,0.2653208363374189,0.3446286950252343
1518,Fulton,1402,2,500,665,1400,1402,1.0,0.0014265335235378032,0.9985734664764622,237,0.3566333808844508,0.4743223965763195,0.16904422253922968
1519,Fulton,3432,22,1273,238,3410,3432,1.0,0.00641025641025641,0.9935897435897436,1921,0.3709207459207459,0.06934731934731934,0.5597319347319347
1520,Fulton,2149,10,756,344,2139,2149,1.0,0.004653327128897162,0.9953466728711028,1049,0.3517915309446254,0.16007445323406236,0.4881340158213122
1521,Fulton,1837,0,905,833,1837,1837,1.0,0.0,1.0,99,0.492651061513337,0.45345672291780076,0.05389221556886228
1522,Fulton,3872,13,1471,1253,3859,3872,1.0,0.0033574380165289257,0.9966425619834711,1148,0.37990702479338845,0.32360537190082644,0.2964876033057851
1523,Fulton,592,1,297,247,591,592,1.0,0.0016891891891891893,0.9983108108108109,48,0.5016891891891891,0.4172297297297297,0.08108108108108109
1524,Fulton,222,0,100,99,222,222,1.0,0.0,1.0,23,0.45045045045045046,0.44594594594594594,0.1036036036036036
1525,Fulton,3850,11,1530,494,3839,3850,1.0,0.002857142857142857,0.9971428571428571,1826,0.3974025974025974,0.12831168831168832,0.4742857142857143
1526,Fulton,2438,4,1222,443,2434,2438,1.0,0.0016406890894175555,0.9983593109105825,773,0.5012305168170632,0.18170631665299425,0.3170631665299426
1527,Fulton,3137,10,1059,449,3127,3137,1.0,0.0031877590054191903,0.9968122409945808,1629,0.3375836786738923,0.14313037934332165,0.5192859419827861
1528,Fulton,3355,7,1082,691,3348,3355,1.0,0.0020864381520119225,0.9979135618479881,1582,0.3225037257824143,0.20596125186289121,0.47153502235469447
1529,Fulton,5064,21,1791,382,5043,5064,1.0,0.004146919431279621,0.9958530805687204,2891,0.3536729857819905,0.07543443917851501,0.5708925750394944
1530,Fulton,4994,9,1316,729,4985,4994,1.0,0.001802162595114137,0.9981978374048859,2949,0.263516219463356,0.14597517020424508,0.5905086103323989
1531,Fulton,1902,1,777,504,1901,1902,1.0,0.0005257623554153522,0.9994742376445847,621,0.4085173501577287,0.26498422712933756,0.3264984227129338
1532,Fulton,4481,16,1859,120,4465,4481,1.0,0.0035706315554563713,0.9964293684445437,2502,0.41486275384958715,0.026779736665922784,0.55835750948449
1533,Fulton,512,0,216,13,512,512,1.0,0.0,1.0,283,0.421875,0.025390625,0.552734375
1534,Fulton,16,1,0,0,15,16,1.0,0.0625,0.9375,16,0.0,0.0,1.0
1535,Fulton,561,2,374,19,559,561,1.0,0.0035650623885918,0.9964349376114082,168,0.6666666666666666,0.0338680926916221,0.2994652406417112
1536,Fulton,10182,36,5141,300,10146,10182,1.0,0.0035356511490866236,0.9964643488509134,4741,0.5049106265959536,0.02946375957572186,0.4656256138283245
1537,Fulton,44,0,15,5,44,44,1.0,0.0,1.0,24,0.3409090909090909,0.11363636363636363,0.5454545454545454
1538,Fulton,3390,5,1223,265,3385,3390,1.0,0.0014749262536873156,0.9985250737463127,1902,0.3607669616519174,0.07817109144542773,0.5610619469026549
1539,Fulton,503,2,230,37,501,503,1.0,0.003976143141153081,0.9960238568588469,236,0.4572564612326044,0.073558648111332,0.4691848906560636
1540,Gilmer,1808,7,205,917,1801,1808,1.0,0.0038716814159292035,0.9961283185840708,686,0.11338495575221239,0.5071902654867256,0.37942477876106195
1541,Gilmer,1371,2,221,937,1369,1371,1.0,0.0014587892049598833,0.9985412107950401,213,0.1611962071480671,0.6834427425237053,0.15536105032822758
1542,Gilmer,1637,1,170,1055,1636,1637,1.0,0.0006108735491753207,0.9993891264508247,412,0.10384850335980451,0.6444715943799634,0.2516799022602321
1543,Gilmer,1022,3,171,556,1019,1022,1.0,0.0029354207436399216,0.99706457925636,295,0.16731898238747553,0.5440313111545988,0.28864970645792565
1544,Gilmer,1833,5,227,1013,1828,1833,1.0,0.002727768685215494,0.9972722313147845,593,0.12384069830878341,0.552645935624659,0.32351336606655756
1545,Gilmer,2186,55,215,1050,2131,2186,1.0,0.02516010978956999,0.97483989021043,921,0.09835315645013723,0.48032936870997256,0.42131747483989024
1546,Gilmer,2074,17,270,1102,2057,2074,1.0,0.00819672131147541,0.9918032786885246,702,0.13018322082931533,0.5313404050144648,0.33847637415621984
1547,Gilmer,3783,26,504,1763,3757,3783,1.0,0.006872852233676976,0.993127147766323,1516,0.13322759714512292,0.4660322495374042,0.4007401533174729
1548,Gilmer,3470,17,392,1748,3453,3470,1.0,0.004899135446685879,0.9951008645533141,1330,0.11296829971181556,0.5037463976945245,0.38328530259365995
1549,Gilmer,1272,12,136,715,1260,1272,1.0,0.009433962264150943,0.9905660377358491,421,0.1069182389937107,0.5621069182389937,0.3309748427672956
1550,Gilmer,2264,15,164,1036,2249,2264,1.0,0.0066254416961130744,0.9933745583038869,1064,0.07243816254416961,0.4575971731448763,0.46996466431095407
1551,Gilmer,1328,5,119,726,1323,1328,1.0,0.0037650602409638554,0.9962349397590361,483,0.08960843373493976,0.5466867469879518,0.36370481927710846
1552,Gilmer,1383,0,138,811,1383,1383,1.0,0.0,1.0,434,0.09978308026030369,0.586406362979031,0.3138105567606652
1553,Glascock,129,0,11,109,129,129,1.0,0.0,1.0,9,0.08527131782945736,0.8449612403100775,0.06976744186046512
1554,Glascock,818,0,58,442,818,818,1.0,0.0,1.0,318,0.07090464547677261,0.5403422982885085,0.38875305623471884
1555,Glascock,815,0,38,554,815,815,1.0,0.0,1.0,223,0.046625766871165646,0.6797546012269938,0.27361963190184047
1556,Glascock,474,0,48,298,474,474,1.0,0.0,1.0,128,0.10126582278481013,0.6286919831223629,0.270042194092827
1557,Glynn,4007,13,694,1289,3994,4007,1.0,0.0032443224357374596,0.9967556775642625,2024,0.17319690541552282,0.32168704766658346,0.5051160469178937
1558,Glynn,2682,12,334,1462,2670,2682,1.0,0.0044742729306487695,0.9955257270693513,886,0.12453392990305742,0.5451155853840418,0.3303504847129008
1559,Glynn,4031,21,1543,189,4010,4031,1.0,0.005209625403125776,0.9947903745968742,2299,0.38278342842967006,0.04688662862813198,0.570329942942198
1560,Glynn,3159,15,725,1530,3144,3159,1.0,0.004748338081671415,0.9952516619183286,904,0.22950300728078507,0.4843304843304843,0.2861665083887306
1561,Glynn,3091,21,579,1412,3070,3091,1.0,0.006793917825946296,0.9932060821740537,1100,0.1873180200582336,0.45681009382077,0.35587188612099646
1562,Glynn,3745,3,967,2089,3742,3745,1.0,0.0008010680907877169,0.9991989319092123,689,0.2582109479305741,0.5578104138851803,0.18397863818424567
1563,Glynn,3668,13,857,553,3655,3668,1.0,0.003544165757906216,0.9964558342420938,2258,0.23364231188658668,0.15076335877862596,0.6155943293347873
1564,Glynn,4256,11,1090,2312,4245,4256,1.0,0.0025845864661654134,0.9974154135338346,854,0.25610902255639095,0.543233082706767,0.20065789473684212
1565,Glynn,3686,9,1160,639,3677,3686,1.0,0.0024416711882799783,0.99755832881172,1887,0.31470428648941945,0.17335865436787845,0.5119370591427022
1566,Glynn,817,4,277,343,813,817,1.0,0.004895960832313341,0.9951040391676866,197,0.3390452876376989,0.41982864137086906,0.24112607099143207
1567,Glynn,3330,23,665,1725,3307,3330,1.0,0.006906906906906907,0.9930930930930931,940,0.1996996996996997,0.5180180180180181,0.2822822822822823
1568,Glynn,3452,12,1193,787,3440,3452,1.0,0.0034762456546929316,0.996523754345307,1472,0.3455967555040556,0.2279837775202781,0.4264194669756663
1569,Glynn,2498,1,697,1665,2497,2498,1.0,0.00040032025620496394,0.999599679743795,136,0.2790232185748599,0.666533226581265,0.0544435548438751
1570,Glynn,2737,9,615,1427,2728,2737,1.0,0.003288271830471319,0.9967117281695287,695,0.2246985750822068,0.5213737668980636,0.2539276580197296
1571,Glynn,2243,8,382,908,2235,2243,1.0,0.0035666518056174765,0.9964333481943826,953,0.17030762371823452,0.4048149799375836,0.4248773963441819
1572,Glynn,2157,9,465,194,2148,2157,1.0,0.004172461752433936,0.9958275382475661,1498,0.21557719054242003,0.0899397311080204,0.6944830783495596
1573,Glynn,4167,10,1122,2399,4157,4167,1.0,0.0023998080153587713,0.9976001919846412,646,0.26925845932325415,0.5757139428845692,0.15502759779217662
1574,Glynn,4308,18,835,1725,4290,4308,1.0,0.004178272980501393,0.9958217270194986,1748,0.19382544103992572,0.40041782729805014,0.40575673166202414
1575,Glynn,4961,42,736,2280,4919,4961,1.0,0.008466035073573876,0.9915339649264261,1945,0.14835718605119935,0.4595847611368676,0.39205805281193307
1576,Glynn,3473,14,943,688,3459,3473,1.0,0.004031097034264325,0.9959689029657357,1842,0.271523178807947,0.19809962568384681,0.5303771955082062
1577,Gordon,12115,90,1702,4233,12025,12115,1.0,0.007428807263722658,0.9925711927362774,6180,0.1404869995872885,0.3494015683037557,0.5101114321089558
1578,Gordon,2213,7,148,1215,2206,2213,1.0,0.0031631269769543608,0.9968368730230457,850,0.06687754179846363,0.5490284681427926,0.3840939900587438
1579,Gordon,8199,74,769,3227,8125,8199,1.0,0.00902549091352604,0.990974509086474,4203,0.0937919258446152,0.39358458348579095,0.5126234906695939
1580,Gordon,2114,1,203,1097,2113,2114,1.0,0.0004730368968779565,0.9995269631031221,814,0.09602649006622517,0.5189214758751183,0.38505203405865657
1581,Gordon,1649,11,116,790,1638,1649,1.0,0.0066707095209217705,0.9933292904790783,743,0.0703456640388114,0.4790782292298363,0.45057610673135234
1582,Gordon,696,0,93,403,696,696,1.0,0.0,1.0,200,0.1336206896551724,0.5790229885057471,0.28735632183908044
1583,Gordon,1276,2,84,644,1274,1276,1.0,0.001567398119122257,0.9984326018808778,548,0.06583072100313479,0.5047021943573667,0.42946708463949845
1584,Gordon,2438,11,197,1118,2427,2438,1.0,0.004511894995898278,0.9954881050041017,1123,0.0808039376538146,0.4585726004922067,0.4606234618539787
1585,Gordon,3160,20,332,1703,3140,3160,1.0,0.006329113924050633,0.9936708860759493,1125,0.10506329113924051,0.5389240506329114,0.3560126582278481
1586,Gordon,1849,9,127,838,1840,1849,1.0,0.0048674959437533805,0.9951325040562466,884,0.06868577609518658,0.45321795565170364,0.4780962682531098
1587,Gordon,6044,30,497,3246,6014,6044,1.0,0.004963600264725348,0.9950363997352747,2301,0.08223031105228326,0.5370615486432826,0.3807081403044342
1588,Gordon,1747,4,116,891,1743,1747,1.0,0.0022896393817973667,0.9977103606182026,740,0.06639954207212365,0.5100171722953635,0.42358328563251285
1589,Grady,1185,4,104,513,1181,1185,1.0,0.0033755274261603376,0.9966244725738397,568,0.08776371308016878,0.43291139240506327,0.47932489451476795
1590,Grady,3013,20,1269,298,2993,3013,1.0,0.006637902422834384,0.9933620975771656,1446,0.42117490872884167,0.09890474610023232,0.47992034517092597
1591,Grady,4026,52,740,985,3974,4026,1.0,0.012916045702930949,0.9870839542970691,2301,0.18380526577247888,0.24465971187282662,0.5715350223546944
1592,Grady,574,1,119,242,573,574,1.0,0.0017421602787456446,0.9982578397212544,213,0.2073170731707317,0.42160278745644597,0.3710801393728223
1593,Grady,1095,3,201,418,1092,1095,1.0,0.0027397260273972603,0.9972602739726028,476,0.18356164383561643,0.3817351598173516,0.434703196347032
1594,Grady,406,1,46,196,405,406,1.0,0.0024630541871921183,0.9975369458128078,164,0.11330049261083744,0.4827586206896552,0.4039408866995074
1595,Grady,1789,10,230,764,1779,1789,1.0,0.005589714924538848,0.9944102850754611,795,0.1285634432643935,0.427054220234768,0.44438233650083847
1596,Grady,1228,9,212,464,1219,1228,1.0,0.007328990228013029,0.992671009771987,552,0.17263843648208468,0.3778501628664495,0.4495114006514658
1597,Grady,699,3,103,261,696,699,1.0,0.004291845493562232,0.9957081545064378,335,0.1473533619456366,0.37339055793991416,0.4792560801144492
1598,Grady,1023,14,62,473,1009,1023,1.0,0.013685239491691105,0.9863147605083089,488,0.06060606060606061,0.46236559139784944,0.47702834799608995
1599,Grady,609,5,54,374,604,609,1.0,0.008210180623973728,0.9917898193760263,181,0.08866995073891626,0.6141215106732348,0.29720853858784896
1600,Grady,1444,8,195,640,1436,1444,1.0,0.00554016620498615,0.9944598337950139,609,0.13504155124653738,0.44321329639889195,0.42174515235457066
1601,Grady,2871,38,284,1406,2833,2871,1.0,0.013235806339254615,0.9867641936607454,1181,0.09892023685127134,0.4897248345524208,0.4113549285963079
1602,Greene,4920,9,1501,1287,4911,4920,1.0,0.001829268292682927,0.9981707317073171,2132,0.3050813008130081,0.26158536585365855,0.43333333333333335
1603,Greene,6772,12,1421,4689,6760,6772,1.0,0.0017720023626698169,0.9982279976373302,662,0.20983461311281748,0.6924099232132309,0.09775546367395156
1604,Greene,1064,3,368,338,1061,1064,1.0,0.002819548872180451,0.9971804511278195,358,0.3458646616541353,0.3176691729323308,0.33646616541353386
1605,Greene,2221,12,673,614,2209,2221,1.0,0.005402971634398919,0.994597028365601,934,0.3030166591625394,0.2764520486267447,0.4205312922107159
1606,Greene,381,0,125,140,381,381,1.0,0.0,1.0,116,0.32808398950131235,0.3674540682414698,0.30446194225721784
1607,Gwinnett,2786,19,1041,1062,2767,2786,1.0,0.0068198133524766695,0.9931801866475233,683,0.373653984206748,0.3811916726489591,0.24515434314429288
1608,Gwinnett,6147,20,2998,1179,6127,6147,1.0,0.003253619651862697,0.9967463803481373,1970,0.4877175858142183,0.191800878477306,0.3204815357084757
1609,Gwinnett,6672,10,3086,1710,6662,6672,1.0,0.001498800959232614,0.9985011990407674,1876,0.46252997601918466,0.256294964028777,0.28117505995203834
1610,Gwinnett,4635,17,1922,1481,4618,4635,1.0,0.003667745415318231,0.9963322545846818,1232,0.4146709816612729,0.3195253505933118,0.2658036677454153
1611,Gwinnett,3859,22,1425,839,3837,3859,1.0,0.005700958797615963,0.994299041202384,1595,0.36926664939103393,0.21741383778180876,0.4133195128271573
1612,Gwinnett,4908,14,2353,1003,4894,4908,1.0,0.0028524857375713123,0.9971475142624286,1552,0.4794213528932355,0.20436022819885902,0.3162184189079055
1613,Gwinnett,6433,19,3216,1332,6414,6433,1.0,0.002953520907819058,0.9970464790921809,1885,0.49992227576558373,0.20705736048499923,0.2930203637494171
1614,Gwinnett,7075,24,3025,2229,7051,7075,1.0,0.003392226148409894,0.99660777385159,1821,0.4275618374558304,0.3150530035335689,0.2573851590106007
1615,Gwinnett,6328,51,2639,1408,6277,6328,1.0,0.008059418457648546,0.9919405815423514,2281,0.4170353982300885,0.2225031605562579,0.3604614412136536
1616,Gwinnett,4588,19,2274,960,4569,4588,1.0,0.004141238012205754,0.9958587619877942,1354,0.495640802092415,0.2092414995640802,0.2951176983435048
1617,Gwinnett,4147,4,1697,1166,4143,4147,1.0,0.0009645526886906198,0.9990354473113093,1284,0.40921147817699544,0.28116710875331563,0.30962141306968893
1618,Gwinnett,4094,85,1033,529,4009,4094,1.0,0.02076209086468002,0.9792379091353199,2532,0.25232046897899363,0.12921348314606743,0.618466047874939
1619,Gwinnett,8763,100,2589,1008,8663,8763,1.0,0.011411617026132604,0.9885883829738674,5166,0.2954467648065731,0.11502909962341663,0.5895241355700103
1620,Gwinnett,3104,28,1293,895,3076,3104,1.0,0.00902061855670103,0.990979381443299,916,0.4165592783505155,0.28833762886597936,0.29510309278350516
1621,Gwinnett,2131,8,767,789,2123,2131,1.0,0.003754106053496011,0.996245893946504,575,0.3599249178789301,0.3702487095260441,0.2698263725950258
1622,Gwinnett,3219,57,873,564,3162,3219,1.0,0.017707362534948742,0.9822926374650512,1782,0.2712022367194781,0.17520969245107176,0.5535880708294502
1623,Gwinnett,2512,8,1008,876,2504,2512,1.0,0.0031847133757961785,0.9968152866242038,628,0.4012738853503185,0.3487261146496815,0.25
1624,Gwinnett,3288,33,768,447,3255,3288,1.0,0.010036496350364963,0.989963503649635,2073,0.23357664233576642,0.13594890510948904,0.6304744525547445
1625,Gwinnett,2810,3,1150,990,2807,2810,1.0,0.0010676156583629894,0.998932384341637,670,0.4092526690391459,0.35231316725978645,0.23843416370106763
1626,Gwinnett,5028,35,1514,551,4993,5028,1.0,0.00696101829753381,0.9930389817024662,2963,0.3011137629276054,0.10958631662688942,0.5892999204455052
1627,Gwinnett,2058,13,734,671,2045,2058,1.0,0.006316812439261419,0.9936831875607386,653,0.3566569484936832,0.326044703595724,0.3172983479105928
1628,Gwinnett,3175,24,1275,1169,3151,3175,1.0,0.007559055118110236,0.9924409448818897,731,0.4015748031496063,0.3681889763779528,0.23023622047244094
1629,Gwinnett,2880,18,963,984,2862,2880,1.0,0.00625,0.99375,933,0.334375,0.3416666666666667,0.32395833333333335
1630,Gwinnett,2581,49,561,321,2532,2581,1.0,0.01898488957768307,0.9810151104223169,1699,0.2173576133281674,0.12437039907012785,0.6582719876017048
1631,Gwinnett,2050,15,652,626,2035,2050,1.0,0.007317073170731708,0.9926829268292683,772,0.3180487804878049,0.3053658536585366,0.37658536585365854
1632,Gwinnett,2701,33,762,949,2668,2701,1.0,0.012217697149203998,0.987782302850796,990,0.28211773417252867,0.35135135135135137,0.36653091447611996
1633,Gwinnett,1645,16,531,639,1629,1645,1.0,0.009726443768996961,0.990273556231003,475,0.32279635258358663,0.3884498480243161,0.2887537993920973
1634,Gwinnett,3288,26,1398,671,3262,3288,1.0,0.007907542579075427,0.9920924574209246,1219,0.4251824817518248,0.20407542579075424,0.3707420924574209
1635,Gwinnett,4122,23,1637,1167,4099,4122,1.0,0.005579815623483746,0.9944201843765162,1318,0.39713731198447355,0.2831149927219796,0.3197476952935468
1636,Gwinnett,3016,28,1287,1041,2988,3016,1.0,0.009283819628647215,0.9907161803713528,688,0.4267241379310345,0.34515915119363394,0.22811671087533156
1637,Gwinnett,1909,8,652,750,1901,1909,1.0,0.0041906757464641176,0.9958093242535359,507,0.34154007333682557,0.392875851231011,0.26558407543216345
1638,Gwinnett,2925,8,1133,1209,2917,2925,1.0,0.002735042735042735,0.9972649572649572,583,0.38735042735042735,0.41333333333333333,0.19931623931623932
1639,Gwinnett,4518,30,1779,710,4488,4518,1.0,0.006640106241699867,0.9933598937583001,2029,0.3937583001328021,0.1571491810535635,0.4490925188136344
1640,Gwinnett,3921,14,1606,1123,3907,3921,1.0,0.003570517725070135,0.9964294822749299,1192,0.4095893904616169,0.28640652894669727,0.3040040805916858
1641,Gwinnett,3837,14,1592,953,3823,3837,1.0,0.0036486838676048996,0.9963513161323951,1292,0.4149074798019286,0.24837112327339067,0.3367213969246807
1642,Gwinnett,2845,7,1138,970,2838,2845,1.0,0.002460456942003515,0.9975395430579965,737,0.4,0.3409490333919156,0.25905096660808435
1643,Gwinnett,4362,30,1840,1126,4332,4362,1.0,0.0068775790921595595,0.9931224209078404,1396,0.4218248509857863,0.2581384685923888,0.32003668042182487
1644,Gwinnett,3620,25,1647,1533,3595,3620,1.0,0.006906077348066298,0.9930939226519337,440,0.4549723756906077,0.4234806629834254,0.12154696132596685
1645,Gwinnett,2579,15,831,1128,2564,2579,1.0,0.0058162078324932144,0.9941837921675067,620,0.32221791392012405,0.43737882900348973,0.24040325707638618
1646,Gwinnett,1562,11,589,521,1551,1562,1.0,0.007042253521126761,0.9929577464788732,452,0.37708066581306016,0.33354673495518566,0.2893725992317542
1647,Gwinnett,5268,34,1976,1391,5234,5268,1.0,0.006454062262718299,0.9935459377372817,1901,0.37509491268033407,0.2640470766894457,0.3608580106302202
1648,Gwinnett,5958,16,2301,1479,5942,5958,1.0,0.002685464921114468,0.9973145350788856,2178,0.3862034239677744,0.24823766364551864,0.36555891238670696
1649,Gwinnett,4566,17,1312,1145,4549,4566,1.0,0.0037231712658782304,0.9962768287341218,2109,0.287341217696014,0.250766535260622,0.461892247043364
1650,Gwinnett,2850,17,887,680,2833,2850,1.0,0.0059649122807017545,0.9940350877192983,1283,0.3112280701754386,0.23859649122807017,0.45017543859649123
1651,Gwinnett,8048,67,2076,1204,7981,8048,1.0,0.008325049701789265,0.9916749502982107,4768,0.25795228628230615,0.1496023856858847,0.5924453280318092
1652,Gwinnett,6435,28,2372,965,6407,6435,1.0,0.004351204351204351,0.9956487956487956,3098,0.3686091686091686,0.14996114996114995,0.48142968142968146
1653,Gwinnett,9559,50,2872,868,9509,9559,1.0,0.005230672664504655,0.9947693273354954,5819,0.3004498378491474,0.09080447745580082,0.6087456846950517
1654,Gwinnett,3620,11,1146,1137,3609,3620,1.0,0.0030386740331491712,0.9969613259668508,1337,0.3165745856353591,0.31408839779005526,0.3693370165745856
1655,Gwinnett,3503,6,1167,894,3497,3503,1.0,0.0017128175849272054,0.9982871824150727,1442,0.3331430202683414,0.25520982015415355,0.411647159577505
1656,Gwinnett,5531,8,1986,1825,5523,5531,1.0,0.001446393057313325,0.9985536069426867,1720,0.35906707647803293,0.32995841619960226,0.31097450732236487
1657,Gwinnett,5055,72,1116,318,4983,5055,1.0,0.014243323442136498,0.9857566765578635,3621,0.22077151335311573,0.0629080118694362,0.7163204747774481
1658,Gwinnett,4894,21,1435,2326,4873,4894,1.0,0.004290968532897425,0.9957090314671025,1133,0.2932161830813241,0.4752758479771148,0.2315079689415611
1659,Gwinnett,5575,15,1560,2641,5560,5575,1.0,0.0026905829596412557,0.9973094170403587,1374,0.27982062780269057,0.4737219730941704,0.24645739910313902
1660,Gwinnett,2875,8,891,1570,2867,2875,1.0,0.002782608695652174,0.9972173913043478,414,0.3099130434782609,0.5460869565217391,0.144
1661,Gwinnett,7373,8,2054,3387,7365,7373,1.0,0.0010850400108504,0.9989149599891496,1932,0.2785840227858402,0.45937881459378815,0.26203716262037163
1662,Gwinnett,3580,14,1396,1321,3566,3580,1.0,0.003910614525139665,0.9960893854748604,863,0.38994413407821227,0.36899441340782124,0.2410614525139665
1663,Gwinnett,3381,24,1549,742,3357,3381,1.0,0.00709849157054126,0.9929015084294588,1090,0.45814847678201714,0.2194616977225673,0.32238982549541556
1664,Gwinnett,2360,16,855,560,2344,2360,1.0,0.006779661016949152,0.9932203389830508,945,0.3622881355932203,0.23728813559322035,0.4004237288135593
1665,Gwinnett,3799,34,1807,537,3765,3799,1.0,0.008949723611476704,0.9910502763885233,1455,0.4756514872334825,0.14135298762832324,0.38299552513819424
1666,Gwinnett,1952,7,746,604,1945,1952,1.0,0.003586065573770492,0.9964139344262295,602,0.382172131147541,0.3094262295081967,0.3084016393442623
1667,Gwinnett,4451,46,1622,1101,4405,4451,1.0,0.010334756234554033,0.989665243765446,1728,0.364412491574927,0.24736014378791282,0.3882273646371602
1668,Gwinnett,4144,4,1443,1478,4140,4144,1.0,0.0009652509652509653,0.999034749034749,1223,0.3482142857142857,0.35666023166023164,0.2951254826254826
1669,Gwinnett,7228,74,2609,1217,7154,7228,1.0,0.010237963475373547,0.9897620365246265,3402,0.36095738793580523,0.16837299391256225,0.47066961815163255
1670,Gwinnett,4865,24,1658,1355,4841,4865,1.0,0.004933196300102775,0.9950668036998972,1852,0.3408016443987667,0.27852004110996914,0.38067831449126416
1671,Gwinnett,6046,21,2190,1682,6025,6046,1.0,0.003473370823685081,0.996526629176315,2174,0.3622229573271585,0.2782004631161098,0.3595765795567317
1672,Gwinnett,3605,23,1325,877,3582,3605,1.0,0.0063800277392510405,0.9936199722607489,1403,0.36754507628294036,0.2432732316227462,0.38918169209431347
1673,Gwinnett,3270,33,1231,502,3237,3270,1.0,0.010091743119266056,0.9899082568807339,1537,0.3764525993883792,0.15351681957186544,0.47003058103975537
1674,Gwinnett,3185,14,1143,850,3171,3185,1.0,0.004395604395604396,0.9956043956043956,1192,0.35886970172684457,0.2668759811616955,0.37425431711145996
1675,Gwinnett,2516,5,1033,877,2511,2516,1.0,0.001987281399046105,0.9980127186009539,606,0.4105723370429253,0.3485691573926868,0.24085850556438793
1676,Gwinnett,7775,41,2782,2405,7734,7775,1.0,0.005273311897106109,0.9947266881028939,2588,0.3578135048231511,0.3093247588424437,0.33286173633440513
1677,Gwinnett,5378,28,1533,1919,5350,5378,1.0,0.005206396429899591,0.9947936035701004,1926,0.2850502045370026,0.35682409817776123,0.35812569728523613
1678,Gwinnett,2965,9,1069,1160,2956,2965,1.0,0.0030354131534569982,0.996964586846543,736,0.36053962900505904,0.3912310286677909,0.24822934232715008
1679,Gwinnett,6253,28,2110,1326,6225,6253,1.0,0.004477850631696785,0.9955221493683032,2817,0.33743802974572207,0.21205821205821207,0.45050375819606586
1680,Gwinnett,4774,17,1622,1883,4757,4774,1.0,0.0035609551738583997,0.9964390448261417,1269,0.339757017176372,0.3944281524926686,0.2658148303309594
1681,Gwinnett,5088,29,1442,1566,5059,5088,1.0,0.005699685534591195,0.9943003144654088,2080,0.28341194968553457,0.30778301886792453,0.4088050314465409
1682,Gwinnett,3450,11,1058,1192,3439,3450,1.0,0.003188405797101449,0.9968115942028986,1200,0.30666666666666664,0.34550724637681157,0.34782608695652173
1683,Gwinnett,4509,36,1313,941,4473,4509,1.0,0.007984031936127744,0.9920159680638723,2255,0.29119538700377023,0.20869372366378355,0.5001108893324462
1684,Gwinnett,5865,39,2428,1056,5826,5865,1.0,0.006649616368286445,0.9933503836317136,2381,0.41398124467178177,0.18005115089514068,0.40596760443307756
1685,Gwinnett,5015,38,982,1174,4977,5015,1.0,0.007577268195413759,0.9924227318045863,2859,0.19581256231306082,0.2340977068793619,0.5700897308075773
1686,Gwinnett,7394,75,2101,621,7319,7394,1.0,0.010143359480659994,0.98985664051934,4672,0.2841493102515553,0.08398701649986476,0.63186367324858
1687,Gwinnett,2774,54,860,793,2720,2774,1.0,0.01946647440519106,0.9805335255948089,1121,0.31002162941600575,0.28586878154289835,0.4041095890410959
1688,Gwinnett,4459,23,2077,681,4436,4459,1.0,0.0051581071989235255,0.9948418928010765,1701,0.46579950661583314,0.15272482619421396,0.3814756671899529
1689,Gwinnett,3619,63,1457,563,3556,3619,1.0,0.017408123791102514,0.9825918762088974,1599,0.4025974025974026,0.15556783641890023,0.4418347609836972
1690,Gwinnett,4554,25,1692,1429,4529,4554,1.0,0.005489679402722881,0.9945103205972771,1433,0.3715415019762846,0.3137900746596399,0.3146684233640755
1691,Gwinnett,4795,32,1368,774,4763,4795,1.0,0.006673618352450469,0.9933263816475495,2653,0.28529718456725756,0.16141814389989573,0.5532846715328467
1692,Gwinnett,2662,31,1054,467,2631,2662,1.0,0.011645379413974455,0.9883546205860255,1141,0.3959429000751315,0.17543200601051842,0.4286250939143501
1693,Gwinnett,3348,28,1327,1139,3320,3348,1.0,0.008363201911589008,0.991636798088411,882,0.3963560334528076,0.34020310633213857,0.26344086021505375
1694,Gwinnett,5449,27,2201,1258,5422,5449,1.0,0.004955037621581942,0.9950449623784181,1990,0.40392732611488347,0.2308680491833364,0.36520462470178017
1695,Gwinnett,8456,69,3651,1114,8387,8456,1.0,0.00815988647114475,0.9918401135288553,3691,0.4317644276253548,0.13174077578051088,0.4364947965941343
1696,Gwinnett,3344,35,994,609,3309,3344,1.0,0.010466507177033494,0.9895334928229665,1741,0.2972488038277512,0.1821172248803828,0.5206339712918661
1697,Gwinnett,5064,50,1521,516,5014,5064,1.0,0.009873617693522907,0.9901263823064771,3027,0.3003554502369668,0.1018957345971564,0.5977488151658767
1698,Gwinnett,4011,68,1301,654,3943,4011,1.0,0.016953378209922713,0.9830466217900773,2056,0.3243580154574919,0.1630516080777861,0.512590376464722
1699,Gwinnett,3264,50,1092,682,3214,3264,1.0,0.015318627450980392,0.9846813725490197,1490,0.33455882352941174,0.20894607843137256,0.4564950980392157
1700,Gwinnett,3730,64,1023,342,3666,3730,1.0,0.017158176943699734,0.9828418230563003,2365,0.2742627345844504,0.09168900804289544,0.6340482573726541
1701,Gwinnett,10153,57,2766,474,10096,10153,1.0,0.005614104205653501,0.9943858957943466,6913,0.2724317935585541,0.04668570865753964,0.6808824977839062
1702,Gwinnett,4372,49,1076,421,4323,4372,1.0,0.01120768526989936,0.9887923147301007,2875,0.24611161939615736,0.09629460201280879,0.6575937785910339
1703,Gwinnett,3413,95,1065,437,3318,3413,1.0,0.027834749487254614,0.9721652505127454,1911,0.3120421916202754,0.12803984764137122,0.5599179607383533
1704,Gwinnett,6776,56,2161,1171,6720,6776,1.0,0.008264462809917356,0.9917355371900827,3444,0.31891971664698937,0.17281582054309327,0.5082644628099173
1705,Gwinnett,6129,68,1719,766,6061,6129,1.0,0.011094795235764399,0.9889052047642356,3644,0.28046989720998533,0.1249796051558166,0.5945504976341981
1706,Gwinnett,6105,103,1948,514,6002,6105,1.0,0.016871416871416873,0.9831285831285831,3643,0.31908271908271907,0.08419328419328419,0.5967239967239967
1707,Gwinnett,7159,84,2690,892,7075,7159,1.0,0.011733482329934349,0.9882665176700657,3577,0.37575080318480236,0.12459840759882665,0.499650789216371
1708,Gwinnett,5132,93,1283,362,5039,5132,1.0,0.0181215900233827,0.9818784099766174,3487,0.25,0.0705378020265004,0.6794621979734996
1709,Gwinnett,2520,0,1041,1228,2520,2520,1.0,0.0,1.0,251,0.41309523809523807,0.4873015873015873,0.0996031746031746
1710,Gwinnett,7928,218,1447,532,7710,7928,1.0,0.02749747729566095,0.972502522704339,5949,0.18251765893037336,0.06710393541876893,0.7503784056508577
1711,Gwinnett,2234,0,889,741,2234,2234,1.0,0.0,1.0,604,0.39794091316025065,0.3316920322291853,0.270367054610564
1712,Gwinnett,4252,113,935,327,4139,4252,1.0,0.026575729068673566,0.9734242709313264,2990,0.21989651928504234,0.07690498588899342,0.7031984948259643
1713,Gwinnett,3777,55,1017,277,3722,3777,1.0,0.014561821551495897,0.9854381784485041,2483,0.2692613185067514,0.07333862854117024,0.6574000529520784
1714,Gwinnett,5104,131,1065,452,4973,5104,1.0,0.025666144200626958,0.974333855799373,3587,0.20865987460815047,0.08855799373040753,0.702782131661442
1715,Gwinnett,4959,16,1980,1485,4943,4959,1.0,0.003226456946965114,0.9967735430530349,1494,0.3992740471869328,0.29945553539019965,0.30127041742286753
1716,Gwinnett,4011,45,1154,434,3966,4011,1.0,0.011219147344801795,0.9887808526551982,2423,0.28770880079780603,0.1082024432809773,0.6040887559212167
1717,Gwinnett,5990,132,1200,265,5858,5990,1.0,0.022036727879799666,0.9779632721202003,4525,0.2003338898163606,0.04424040066777963,0.7554257095158597
1718,Gwinnett,6610,98,1694,489,6512,6610,1.0,0.014826021180030256,0.9851739788199697,4427,0.2562783661119516,0.07397881996974282,0.6697428139183056
1719,Gwinnett,2146,3,898,1089,2143,2146,1.0,0.0013979496738117428,0.9986020503261882,159,0.418452935694315,0.5074557315936626,0.07409133271202237
1720,Gwinnett,2483,8,950,1265,2475,2483,1.0,0.003221908981071285,0.9967780910189287,268,0.38260169150221507,0.5094643576318969,0.10793395086588804
1721,Gwinnett,6102,59,1922,383,6043,6102,1.0,0.009668960996394626,0.9903310390036054,3797,0.31497869550966895,0.06276630612913799,0.622254998361193
1722,Gwinnett,6922,121,1461,480,6801,6922,1.0,0.01748049696619474,0.9825195030338053,4981,0.2110661658480208,0.06934412019647501,0.7195897139555042
1723,Gwinnett,2524,9,972,649,2515,2524,1.0,0.0035657686212361333,0.9964342313787639,903,0.38510301109350237,0.2571315372424723,0.35776545166402535
1724,Gwinnett,3625,59,939,192,3566,3625,1.0,0.016275862068965516,0.9837241379310345,2494,0.2590344827586207,0.05296551724137931,0.688
1725,Gwinnett,4903,58,1418,751,4845,4903,1.0,0.011829492147664695,0.9881705078523353,2734,0.2892106873342851,0.15317152763614114,0.5576177850295737
1726,Gwinnett,4923,65,1257,802,4858,4923,1.0,0.013203331302051594,0.9867966686979484,2864,0.25533211456429006,0.1629087954499289,0.5817590899857811
1727,Gwinnett,2459,17,955,528,2442,2459,1.0,0.0069133794225294835,0.9930866205774705,976,0.3883692557950386,0.21472143147620984,0.3969093127287515
1728,Gwinnett,2720,33,665,420,2687,2720,1.0,0.01213235294117647,0.9878676470588236,1635,0.24448529411764705,0.15441176470588236,0.6011029411764706
1729,Gwinnett,6182,97,1711,1069,6085,6182,1.0,0.015690714978971208,0.9843092850210288,3402,0.27677127143319313,0.1729213846651569,0.5503073439016499
1730,Gwinnett,3898,24,1509,1130,3874,3898,1.0,0.0061570035915854285,0.9938429964084146,1259,0.38712160082093383,0.2898922524371473,0.32298614674191894
1731,Gwinnett,6502,130,1393,371,6372,6502,1.0,0.019993848046754845,0.9800061519532451,4738,0.21424177176253462,0.05705936634881575,0.7286988618886496
1732,Gwinnett,1721,2,722,873,1719,1721,1.0,0.0011621150493898896,0.9988378849506101,126,0.41952353282975013,0.5072632190586868,0.07321324811156305
1733,Gwinnett,5876,32,1562,2851,5844,5876,1.0,0.005445881552076242,0.9945541184479237,1463,0.26582709326072157,0.48519400953029274,0.2489788972089857
1734,Gwinnett,3307,2,957,1391,3305,3307,1.0,0.0006047777441790142,0.999395222255821,959,0.2893861505896583,0.4206229210765044,0.28999092833383733
1735,Gwinnett,4857,23,1014,1383,4834,4857,1.0,0.004735433395099856,0.9952645666049001,2460,0.20877084620135886,0.28474366893143915,0.506485484867202
1736,Gwinnett,4068,20,1147,1531,4048,4068,1.0,0.004916420845624385,0.9950835791543756,1390,0.28195673549655853,0.37635201573254673,0.3416912487708948
1737,Gwinnett,6661,5,2112,1754,6656,6661,1.0,0.0007506380423359856,0.999249361957664,2795,0.3170695090827203,0.26332382525146375,0.41960666566581595
1738,Gwinnett,4148,23,2202,539,4125,4148,1.0,0.005544840887174542,0.9944551591128254,1407,0.5308582449373191,0.12994214079074254,0.3391996142719383
1739,Gwinnett,4634,15,2082,642,4619,4634,1.0,0.0032369443245576176,0.9967630556754424,1910,0.44928787224859734,0.13854121709106604,0.4121709106603366
1740,Gwinnett,5361,24,3055,664,5337,5361,1.0,0.004476776720761052,0.9955232232792389,1642,0.569856370080209,0.12385748927438911,0.306286140645402
1741,Gwinnett,3718,12,2008,648,3706,3718,1.0,0.0032275416890801506,0.9967724583109199,1062,0.5400753093060785,0.17428725121032812,0.2856374394835933
1742,Gwinnett,5231,36,2311,620,5195,5231,1.0,0.006882049321353469,0.9931179506786465,2300,0.44178933282355193,0.11852418275664309,0.439686484419805
1743,Gwinnett,5905,20,3370,747,5885,5905,1.0,0.003386960203217612,0.9966130397967824,1788,0.5707027942421676,0.12650296359017782,0.30279424216765455
1744,Gwinnett,6080,28,3251,712,6052,6080,1.0,0.004605263157894736,0.9953947368421052,2117,0.5347039473684211,0.11710526315789474,0.3481907894736842
1745,Gwinnett,6184,26,2139,2277,6158,6184,1.0,0.004204398447606727,0.9957956015523933,1768,0.34589262613195343,0.36820827943078915,0.2858990944372574
1746,Gwinnett,5497,26,1758,1911,5471,5497,1.0,0.004729852646898308,0.9952701473531017,1828,0.3198108058941241,0.34764416954702565,0.33254502455885027
1747,Gwinnett,4941,25,1793,1836,4916,4941,1.0,0.005059704513256426,0.9949402954867436,1312,0.36288200769075085,0.37158469945355194,0.2655332928556972
1748,Gwinnett,6658,65,1389,1598,6593,6658,1.0,0.009762691498948633,0.9902373085010514,3671,0.2086212075698408,0.24001201562030638,0.5513667768098528
1749,Gwinnett,6821,71,1854,2087,6750,6821,1.0,0.010409030933880663,0.9895909690661193,2880,0.27180765283682745,0.30596686702829495,0.4222254801348776
1750,Gwinnett,5353,11,1595,2225,5342,5353,1.0,0.0020549224733794136,0.9979450775266205,1533,0.29796375864001495,0.41565477302447223,0.2863814683355128
1751,Gwinnett,6042,74,1439,1796,5968,6042,1.0,0.012247600132406488,0.9877523998675936,2807,0.23816617014233699,0.29725256537570344,0.46458126448195963
1752,Gwinnett,4128,19,1238,1373,4109,4128,1.0,0.004602713178294574,0.9953972868217055,1517,0.2999031007751938,0.3326065891472868,0.36749031007751937
1753,Gwinnett,4976,24,1379,1568,4952,4976,1.0,0.00482315112540193,0.9951768488745981,2029,0.2771302250803859,0.31511254019292606,0.4077572347266881
1754,Gwinnett,3079,18,891,1316,3061,3079,1.0,0.005846053913608314,0.9941539460863917,872,0.28937966872361154,0.42741149723936345,0.283208834037025
1755,Gwinnett,2157,10,680,549,2147,2157,1.0,0.004636068613815485,0.9953639313861845,928,0.31525266573945293,0.2545201668984701,0.43022716736207695
1756,Gwinnett,5308,14,1818,1725,5294,5308,1.0,0.0026375282592313487,0.9973624717407686,1765,0.3425018839487566,0.3249811605124341,0.33251695553880933
1757,Gwinnett,7152,27,2190,1859,7125,7152,1.0,0.0037751677852348995,0.9962248322147651,3103,0.3062080536912752,0.25992729306487694,0.4338646532438479
1758,Gwinnett,4832,4,1627,2150,4828,4832,1.0,0.0008278145695364238,0.9991721854304636,1055,0.3367135761589404,0.4449503311258278,0.2183360927152318
1759,Gwinnett,4562,16,1541,1832,4546,4562,1.0,0.0035072336694432268,0.9964927663305567,1189,0.33779044278825077,0.40157825515124945,0.2606313020604998
1760,Gwinnett,4354,15,1550,1375,4339,4354,1.0,0.003445107946715664,0.9965548920532843,1429,0.35599448782728527,0.3158015617822692,0.3282039503904456
1761,Gwinnett,4547,7,1676,1233,4540,4547,1.0,0.0015394765779634925,0.9984605234220365,1638,0.36859467780954475,0.271167802946998,0.3602375192434572
1762,Gwinnett,3744,4,1203,1876,3740,3744,1.0,0.0010683760683760685,0.9989316239316239,665,0.3213141025641026,0.5010683760683761,0.17761752136752137
1763,Habersham,1544,3,250,1006,1541,1544,1.0,0.0019430051813471502,0.9980569948186528,288,0.16191709844559585,0.6515544041450777,0.18652849740932642
1764,Habersham,1947,13,190,523,1934,1947,1.0,0.00667693888032871,0.9933230611196713,1234,0.09758602978941962,0.26861838726245507,0.6337955829481253
1765,Habersham,6514,22,522,3098,6492,6514,1.0,0.0033773411114522566,0.9966226588885477,2894,0.08013509364445809,0.47559103469450414,0.44427387166103777
1766,Habersham,9971,19,1177,5752,9952,9971,1.0,0.0019055260254738741,0.9980944739745261,3042,0.11804232273593421,0.5768729315013539,0.3050847457627119
1767,Habersham,7889,69,858,3267,7820,7889,1.0,0.008746355685131196,0.9912536443148688,3764,0.10875903156293573,0.4141209278742553,0.477120040562809
1768,Habersham,7020,24,455,2588,6996,7020,1.0,0.003418803418803419,0.9965811965811966,3977,0.06481481481481481,0.36866096866096865,0.5665242165242165
1769,Habersham,993,9,111,403,984,993,1.0,0.00906344410876133,0.9909365558912386,479,0.11178247734138973,0.40584088620342396,0.4823766364551863
1770,Hall,7050,73,1287,2913,6977,7050,1.0,0.010354609929078015,0.989645390070922,2850,0.1825531914893617,0.41319148936170214,0.40425531914893614
1771,Hall,6531,97,987,1219,6434,6531,1.0,0.014852243148063084,0.9851477568519369,4325,0.15112540192926044,0.18664829275761752,0.662226305313122
1772,Hall,3860,38,690,978,3822,3860,1.0,0.009844559585492229,0.9901554404145078,2192,0.17875647668393782,0.2533678756476684,0.5678756476683938
1773,Hall,4352,38,720,2300,4314,4352,1.0,0.008731617647058824,0.9912683823529411,1332,0.16544117647058823,0.5284926470588235,0.30606617647058826
1774,Hall,4768,16,801,2424,4752,4768,1.0,0.003355704697986577,0.9966442953020134,1543,0.16799496644295303,0.5083892617449665,0.3236157718120805
1775,Hall,4203,19,693,1732,4184,4203,1.0,0.004520580537711158,0.9954794194622888,1778,0.16488222698072805,0.4120866048060909,0.42303116821318104
1776,Hall,5923,39,1025,3154,5884,5923,1.0,0.006584501097416849,0.9934154989025832,1744,0.1730541955090326,0.5325004220834036,0.29444538240756374
1777,Hall,4181,26,572,2419,4155,4181,1.0,0.006218607988519493,0.9937813920114805,1190,0.13680937574742885,0.5785697201626405,0.2846209040899306
1778,Hall,5349,20,1005,2398,5329,5349,1.0,0.003739016638624042,0.9962609833613759,1946,0.1878855860908581,0.44830809497102264,0.36380631893811927
1779,Hall,7724,70,1178,2695,7654,7724,1.0,0.009062661833247023,0.990937338166753,3851,0.1525116519937856,0.34891248058001034,0.498575867426204
1780,Hall,9789,158,1688,1787,9631,9789,1.0,0.016140565941362754,0.9838594340586373,6314,0.17243845132291347,0.1825518439064256,0.645009704770661
1781,Hall,5352,21,600,1870,5331,5352,1.0,0.003923766816143498,0.9960762331838565,2882,0.11210762331838565,0.34940209267563527,0.5384902840059791
1782,Hall,4100,23,353,2067,4077,4100,1.0,0.005609756097560975,0.994390243902439,1680,0.08609756097560975,0.5041463414634146,0.4097560975609756
1783,Hall,3684,12,281,2428,3672,3684,1.0,0.003257328990228013,0.996742671009772,975,0.07627578718783931,0.6590662323561346,0.26465798045602607
1784,Hall,3033,13,259,1924,3020,3033,1.0,0.004286185295087373,0.9957138147049126,850,0.08539399934058688,0.6343554236729311,0.28025057698648204
1785,Hall,6446,19,799,3391,6427,6446,1.0,0.00294756438101148,0.9970524356189885,2256,0.12395283896990382,0.5260626745268383,0.3499844865032578
1786,Hall,4064,12,598,2273,4052,4064,1.0,0.002952755905511811,0.9970472440944882,1193,0.14714566929133857,0.5593011811023622,0.2935531496062992
1787,Hall,3582,6,549,2054,3576,3582,1.0,0.0016750418760469012,0.998324958123953,979,0.15326633165829145,0.5734226689000559,0.2733109994416527
1788,Hall,4772,37,690,2514,4735,4772,1.0,0.007753562447611065,0.992246437552389,1568,0.14459346186085498,0.5268231349538978,0.32858340318524726
1789,Hall,3799,10,761,2369,3789,3799,1.0,0.0026322716504343247,0.9973677283495657,669,0.2003158725980521,0.6235851539878916,0.17609897341405634
1790,Hall,5369,28,1018,1691,5341,5369,1.0,0.005215123859191656,0.9947848761408083,2660,0.1896070031663252,0.3149562302104675,0.4954367666232073
1791,Hall,4427,19,1400,269,4408,4427,1.0,0.004291845493562232,0.9957081545064378,2758,0.3162412468940592,0.06076349672464423,0.6229952563812966
1792,Hall,10177,216,1264,1217,9961,10177,1.0,0.021224329370148374,0.9787756706298516,7696,0.12420163112901642,0.11958337427532671,0.7562149945956569
1793,Hall,4582,84,753,952,4498,4582,1.0,0.018332605848974247,0.9816673941510258,2877,0.16433871671759057,0.20776953295504147,0.627891750327368
1794,Hall,2154,8,362,547,2146,2154,1.0,0.003714020427112349,0.9962859795728877,1245,0.1680594243268338,0.2539461467038069,0.5779944289693594
1795,Hall,1398,4,130,755,1394,1398,1.0,0.002861230329041488,0.9971387696709585,513,0.09298998569384835,0.5400572246065808,0.3669527896995708
1796,Hall,3910,14,407,2602,3896,3910,1.0,0.0035805626598465474,0.9964194373401535,901,0.1040920716112532,0.6654731457800511,0.23043478260869565
1797,Hall,8296,28,1834,5056,8268,8296,1.0,0.0033751205400192863,0.9966248794599807,1406,0.22107039537126327,0.609450337512054,0.16947926711668274
1798,Hall,3393,25,585,1825,3368,3393,1.0,0.0073681108163866785,0.9926318891836133,983,0.1724137931034483,0.5378720895962276,0.2897141173003242
1799,Hall,4592,14,900,2390,4578,4592,1.0,0.003048780487804878,0.9969512195121951,1302,0.19599303135888502,0.5204703832752613,0.28353658536585363
1800,Hall,2984,6,842,1957,2978,2984,1.0,0.0020107238605898124,0.9979892761394102,185,0.282171581769437,0.6558310991957105,0.06199731903485255
1801,Hancock,719,0,470,146,719,719,1.0,0.0,1.0,103,0.6536856745479833,0.20305980528511822,0.14325452016689846
1802,Hancock,1166,9,382,408,1157,1166,1.0,0.007718696397941681,0.9922813036020584,376,0.3276157804459691,0.34991423670668953,0.32246998284734135
1803,Hancock,335,2,197,37,333,335,1.0,0.005970149253731343,0.9940298507462687,101,0.5880597014925373,0.11044776119402985,0.30149253731343284
1804,Hancock,656,2,381,96,654,656,1.0,0.003048780487804878,0.9969512195121951,179,0.5807926829268293,0.14634146341463414,0.2728658536585366
1805,Hancock,954,3,315,48,951,954,1.0,0.0031446540880503146,0.9968553459119497,591,0.330188679245283,0.050314465408805034,0.6194968553459119
1806,Hancock,493,0,192,93,493,493,1.0,0.0,1.0,208,0.3894523326572008,0.18864097363083165,0.42190669371196754
1807,Hancock,144,0,84,26,144,144,1.0,0.0,1.0,34,0.5833333333333334,0.18055555555555555,0.2361111111111111
1808,Hancock,576,0,315,60,576,576,1.0,0.0,1.0,201,0.546875,0.10416666666666667,0.3489583333333333
1809,Hancock,422,3,88,130,419,422,1.0,0.0071090047393364926,0.9928909952606635,204,0.20853080568720378,0.3080568720379147,0.4834123222748815
1810,Hancock,2032,3,561,115,2029,2032,1.0,0.0014763779527559055,0.9985236220472441,1356,0.27608267716535434,0.056594488188976375,0.6673228346456693
1811,Haralson,1105,0,38,434,1105,1105,1.0,0.0,1.0,633,0.034389140271493215,0.3927601809954751,0.5728506787330316
1812,Haralson,6974,21,760,3798,6953,6974,1.0,0.0030111843991970175,0.996988815600803,2416,0.10897619730427302,0.5445942070547749,0.3464295956409521
1813,Haralson,2690,0,183,1452,2690,2690,1.0,0.0,1.0,1055,0.06802973977695168,0.5397769516728624,0.39219330855018586
1814,Haralson,1280,2,62,637,1278,1280,1.0,0.0015625,0.9984375,581,0.0484375,0.49765625,0.45390625
1815,Haralson,1771,5,90,1050,1766,1771,1.0,0.00282326369282891,0.9971767363071711,631,0.050818746470920384,0.5928853754940712,0.35629587803500845
1816,Haralson,428,2,12,209,426,428,1.0,0.004672897196261682,0.9953271028037384,207,0.028037383177570093,0.4883177570093458,0.48364485981308414
1817,Haralson,536,0,36,500,536,536,1.279236276849642,0.0,1.0,0,0.06716417910447761,0.9328358208955224,0.0
1818,Haralson,335,4,18,231,331,335,1.0,0.011940298507462687,0.9880597014925373,86,0.05373134328358209,0.6895522388059702,0.25671641791044775
1819,Haralson,2102,5,168,1104,2097,2102,1.0,0.002378686964795433,0.9976213130352045,830,0.07992388201712655,0.5252140818268316,0.3948620361560419
1820,Haralson,3600,9,300,1715,3591,3600,1.0,0.0025,0.9975,1585,0.08333333333333333,0.47638888888888886,0.44027777777777777
1821,Haralson,869,4,46,493,865,869,1.0,0.004602991944764097,0.9953970080552359,330,0.05293440736478711,0.567318757192175,0.379746835443038
1822,Haralson,1281,4,79,708,1277,1281,1.0,0.00312256049960968,0.9968774395003903,494,0.06167056986729118,0.5526932084309133,0.38563622170179546
1823,Harris,2859,8,580,1696,2851,2859,1.0,0.0027981811822315496,0.9972018188177685,583,0.20286813571178733,0.5932144106330884,0.20391745365512418
1824,Harris,4197,11,1018,2326,4186,4197,1.0,0.0026209197045508697,0.9973790802954491,853,0.24255420538479866,0.5542053847986658,0.20324040981653563
1825,Harris,1691,2,452,730,1689,1691,1.0,0.0011827321111768185,0.9988172678888232,509,0.267297457125961,0.43169722057953874,0.3010053222945003
1826,Harris,3027,10,718,1342,3017,3027,1.0,0.003303600925008259,0.9966963990749917,967,0.237198546415593,0.44334324413610837,0.31945820944829867
1827,Harris,2726,10,458,1556,2716,2726,1.0,0.003668378576669112,0.9963316214233309,712,0.16801173881144535,0.5707997065297139,0.2611885546588408
1828,Harris,2852,5,424,1842,2847,2852,1.0,0.0017531556802244039,0.9982468443197756,586,0.14866760168302945,0.6458625525946704,0.20546984572230015
1829,Harris,1271,8,149,704,1263,1271,1.0,0.006294256490952006,0.993705743509048,418,0.11723052714398112,0.5538945712037766,0.3288749016522423
1830,Harris,992,3,255,429,989,992,1.0,0.0030241935483870967,0.9969758064516129,308,0.25705645161290325,0.4324596774193548,0.31048387096774194
1831,Harris,1831,5,210,1082,1826,1831,1.0,0.002730748225013654,0.9972692517749864,539,0.11469142545057345,0.5909339158929546,0.2943746586564719
1832,Harris,905,7,179,422,898,905,1.0,0.0077348066298342545,0.9922651933701657,304,0.19779005524861878,0.4662983425414365,0.33591160220994476
1833,Harris,2927,13,731,1392,2914,2927,1.0,0.004441407584557568,0.9955585924154424,804,0.24974376494704476,0.4755722582849334,0.27468397676802186
1834,Harris,1521,11,283,798,1510,1521,1.0,0.007232084155161078,0.9927679158448389,440,0.18606180144641682,0.52465483234714,0.2892833662064431
1835,Hart,1724,12,269,802,1712,1724,1.0,0.0069605568445475635,0.9930394431554525,653,0.15603248259860789,0.4651972157772622,0.37877030162412995
1836,Hart,1715,5,180,816,1710,1715,1.0,0.0029154518950437317,0.9970845481049563,719,0.10495626822157435,0.47580174927113705,0.4192419825072886
1837,Hart,1365,4,345,499,1361,1365,1.0,0.0029304029304029304,0.9970695970695971,521,0.25274725274725274,0.36556776556776555,0.38168498168498166
1838,Hart,2354,7,272,1118,2347,2354,1.0,0.002973661852166525,0.9970263381478335,964,0.11554800339847068,0.4749362786745964,0.40951571792693287
1839,Hart,8167,12,1451,3258,8155,8167,1.0,0.0014693277825394882,0.9985306722174605,3458,0.17766621770539978,0.398922492959471,0.42341128933512917
1840,Hart,3228,9,453,1912,3219,3228,1.0,0.0027881040892193307,0.9972118959107806,863,0.14033457249070633,0.5923172242874845,0.2673482032218092
1841,Hart,1883,0,187,1059,1883,1883,1.0,0.0,1.0,637,0.09930961232076474,0.5624004248539565,0.3382899628252788
1842,Heard,1886,6,186,1122,1880,1886,1.0,0.003181336161187699,0.9968186638388123,578,0.09862142099681867,0.5949098621420997,0.3064687168610817
1843,Heard,840,2,37,384,838,840,1.0,0.002380952380952381,0.9976190476190476,419,0.04404761904761905,0.45714285714285713,0.4988095238095238
1844,Heard,1237,1,83,644,1236,1237,1.0,0.0008084074373484236,0.9991915925626516,510,0.06709781729991916,0.5206143896523848,0.412287793047696
1845,Heard,1464,3,82,852,1461,1464,1.0,0.0020491803278688526,0.9979508196721312,530,0.056010928961748634,0.5819672131147541,0.3620218579234973
1846,Heard,2559,7,331,1139,2552,2559,1.0,0.0027354435326299334,0.9972645564673701,1089,0.129347401328644,0.44509574052364204,0.42555685814771393
1847,Heard,712,2,105,375,710,712,1.0,0.0028089887640449437,0.9971910112359551,232,0.14747191011235955,0.526685393258427,0.3258426966292135
1848,Henry,3348,6,1733,773,3342,3348,1.0,0.0017921146953405018,0.9982078853046595,842,0.5176224611708483,0.23088410991636799,0.25149342891278376
1849,Henry,5444,25,1958,1324,5419,5444,1.0,0.004592211609110948,0.9954077883908891,2162,0.35966201322556945,0.2432035268185158,0.3971344599559148
1850,Henry,2850,6,1068,947,2844,2850,1.0,0.002105263157894737,0.9978947368421053,835,0.37473684210526315,0.33228070175438595,0.2929824561403509
1851,Henry,3289,9,863,1838,3280,3289,1.0,0.002736394040741867,0.9972636059592581,588,0.26238978412891456,0.5588324718759501,0.1787777439951353
1852,Henry,4258,6,2685,491,4252,4258,1.0,0.0014091122592766556,0.9985908877407234,1082,0.6305777360263034,0.11531235321747299,0.2541099107562236
1853,Henry,4483,8,2443,948,4475,4483,1.0,0.0017845192951148785,0.9982154807048851,1092,0.544947579745706,0.2114655364711131,0.2435868837831809
1854,Henry,4345,15,1263,1471,4330,4345,1.0,0.0034522439585730723,0.996547756041427,1611,0.2906789413118527,0.3385500575373993,0.37077100115074796
1855,Henry,5225,25,2636,1221,5200,5225,1.0,0.004784688995215311,0.9952153110047847,1368,0.5044976076555024,0.2336842105263158,0.26181818181818184
1856,Henry,3242,10,1111,1633,3232,3242,1.0,0.0030845157310302285,0.9969154842689698,498,0.3426896977174584,0.5037014188772363,0.15360888340530537
1857,Henry,4938,12,1589,2217,4926,4938,1.0,0.002430133657351154,0.9975698663426489,1132,0.32179019846091533,0.4489671931956258,0.2292426083434589
1858,Henry,4374,11,1483,1584,4363,4374,1.0,0.002514860539551898,0.9974851394604481,1307,0.33904892546867854,0.36213991769547327,0.2988111568358482
1859,Henry,3831,13,1755,918,3818,3831,1.0,0.0033933698773166276,0.9966066301226834,1158,0.4581049334377447,0.23962411902897415,0.30227094753328115
1860,Henry,7011,11,3274,1504,7000,7011,1.0,0.0015689630580516332,0.9984310369419483,2233,0.46698045927827697,0.21452003993724147,0.3184995007844815
1861,Henry,10208,29,4666,2064,10179,10208,1.0,0.002840909090909091,0.9971590909090909,3478,0.45709247648902823,0.20219435736677116,0.3407131661442006
1862,Henry,3038,9,1451,522,3029,3038,1.0,0.0029624753127057276,0.9970375246872942,1065,0.47761685319289005,0.1718235681369322,0.35055957867017773
1863,Henry,4520,13,1828,1166,4507,4520,1.0,0.0028761061946902654,0.9971238938053097,1526,0.4044247787610619,0.2579646017699115,0.33761061946902654
1864,Henry,3673,11,969,1898,3662,3673,1.0,0.0029948271167982575,0.9970051728832018,806,0.2638170432888647,0.5167438061530084,0.21943915055812688
1865,Henry,3653,9,784,1855,3644,3653,1.0,0.0024637284423761293,0.9975362715576239,1014,0.2146181220914317,0.5078018067341911,0.2775800711743772
1866,Henry,5466,21,3201,782,5445,5466,1.0,0.0038419319429198683,0.9961580680570802,1483,0.5856201975850713,0.14306622758873033,0.27131357482619833
1867,Henry,7573,24,2956,1887,7549,7573,1.0,0.003169153571900172,0.9968308464280998,2730,0.3903340816057045,0.249174699590651,0.36049121880364454
1868,Henry,4523,8,1819,1460,4515,4523,1.0,0.0017687375635640063,0.998231262436436,1244,0.40216670351536593,0.32279460535043114,0.275038691134203
1869,Henry,5669,23,2194,1416,5646,5669,1.0,0.0040571529370259304,0.9959428470629741,2059,0.387017110601517,0.24977950255777032,0.3632033868407126
1870,Henry,4104,18,1589,1579,4086,4104,1.0,0.0043859649122807015,0.9956140350877193,936,0.3871832358674464,0.3847465886939571,0.22807017543859648
1871,Henry,5954,18,3420,618,5936,5954,1.0,0.0030231776956667787,0.9969768223043333,1916,0.574403762176688,0.10379576755122606,0.32180047027208597
1872,Henry,4975,18,926,2666,4957,4975,1.0,0.0036180904522613066,0.9963819095477386,1383,0.18613065326633166,0.5358793969849246,0.2779899497487437
1873,Henry,4089,4,2567,347,4085,4089,1.0,0.0009782342871117633,0.9990217657128883,1175,0.6277818537539741,0.08486182440694547,0.28735632183908044
1874,Henry,4156,9,1891,702,4147,4156,1.0,0.002165543792107796,0.9978344562078922,1563,0.45500481231953804,0.16891241578440808,0.3760827718960539
1875,Henry,5868,48,2074,1715,5820,5868,1.0,0.0081799591002045,0.9918200408997955,2079,0.3534423994546694,0.29226312201772325,0.35429447852760737
1876,Henry,3856,29,1453,931,3827,3856,1.0,0.007520746887966805,0.9924792531120332,1472,0.37681535269709543,0.24144190871369295,0.3817427385892116
1877,Henry,5535,36,2034,679,5499,5535,1.0,0.0065040650406504065,0.9934959349593496,2822,0.367479674796748,0.12267389340560073,0.5098464317976513
1878,Henry,7334,32,3662,667,7302,7334,1.0,0.00436323970548132,0.9956367602945186,3005,0.4993182437960185,0.09094627761112627,0.4097354785928552
1879,Henry,3785,14,1213,1299,3771,3785,1.0,0.0036988110964332895,0.9963011889035667,1273,0.32047556142668426,0.34319682959048875,0.33632760898282693
1880,Henry,2105,2,684,956,2103,2105,1.0,0.0009501187648456057,0.9990498812351544,465,0.32494061757719717,0.45415676959619955,0.2209026128266033
1881,Henry,3559,12,423,2112,3547,3559,1.0,0.0033717336330429896,0.996628266366957,1024,0.11885361056476539,0.5934251194155662,0.28772127001966846
1882,Henry,5082,24,1150,2486,5058,5082,1.0,0.004722550177095631,0.9952774498229043,1446,0.226288862652499,0.48917748917748916,0.2845336481700118
1883,Henry,6529,14,3288,916,6515,6529,1.0,0.0021442793689692144,0.9978557206310308,2325,0.5035993260836269,0.1402971358554143,0.3561035380609588
1884,Henry,8172,38,3173,595,8134,8172,1.0,0.00465002447381302,0.995349975526187,4404,0.38827704356338716,0.07280959373470387,0.5389133627019089
1885,Houston,5270,18,1221,2180,5252,5270,1.0,0.003415559772296015,0.996584440227704,1869,0.2316888045540797,0.41366223908918404,0.35464895635673627
1886,Houston,10308,36,2685,4812,10272,10308,1.0,0.0034924330616996507,0.9965075669383003,2811,0.26047729918509893,0.4668218859138533,0.27270081490104775
1887,Houston,9036,28,2353,3130,9008,9036,1.0,0.003098716246126605,0.9969012837538734,3553,0.26040283311199647,0.3463922089420097,0.3932049579459938
1888,Houston,5417,10,1374,2236,5407,5417,1.0,0.0018460402436773122,0.9981539597563227,1807,0.2536459294812627,0.412774598486247,0.33357947203249033
1889,Houston,9745,29,2983,3439,9716,9745,1.0,0.0029758850692662903,0.9970241149307337,3323,0.3061056952283222,0.3528989225243715,0.3409953822473063
1890,Houston,1971,6,299,1083,1965,1971,1.0,0.0030441400304414,0.9969558599695586,589,0.15169964485032977,0.5494672754946728,0.29883307965499745
1891,Houston,7716,37,2022,1909,7679,7716,1.0,0.004795230689476413,0.9952047693105236,3785,0.2620528771384137,0.24740798341109382,0.4905391394504925
1892,Houston,1443,4,361,675,1439,1443,1.0,0.002772002772002772,0.9972279972279973,407,0.25017325017325015,0.4677754677754678,0.28205128205128205
1893,Houston,11867,63,3109,2821,11804,11867,1.0,0.005308839639335974,0.9946911603606641,5937,0.26198702283643716,0.23771804162804416,0.5002949355355186
1894,Houston,9711,36,2713,4203,9675,9711,1.0,0.0037071362372567192,0.9962928637627433,2795,0.27937390587993,0.432808155699722,0.2878179384203481
1895,Houston,2794,9,676,1120,2785,2794,1.0,0.0032211882605583395,0.9967788117394416,998,0.24194702934860415,0.4008589835361489,0.35719398711524697
1896,Houston,12536,89,3878,1087,12447,12536,1.0,0.00709955328653478,0.9929004467134652,7571,0.3093490746649649,0.08671027440970007,0.603940650925335
1897,Houston,15787,33,3554,6314,15754,15787,1.0,0.00209032748463926,0.9979096725153608,5919,0.2251219357699373,0.39994932539431177,0.37492873883575095
1898,Houston,6817,12,2098,1493,6805,6817,1.0,0.001760305119554056,0.998239694880446,3226,0.3077600117353675,0.2190112952911838,0.4732286929734487
1899,Houston,4848,9,1328,1868,4839,4848,1.0,0.0018564356435643563,0.9981435643564357,1652,0.2739273927392739,0.38531353135313534,0.34075907590759075
1900,Houston,6852,20,1578,3164,6832,6852,1.0,0.002918855808523059,0.997081144191477,2110,0.23029772329246936,0.46176298890834794,0.3079392877991827
1901,Irwin,749,4,97,430,745,749,1.0,0.0053404539385847796,0.9946595460614153,222,0.1295060080106809,0.5740987983978638,0.2963951935914553
1902,Irwin,2004,8,104,1160,1996,2004,1.0,0.003992015968063872,0.9960079840319361,740,0.05189620758483034,0.5788423153692615,0.36926147704590817
1903,Irwin,4794,6,807,1544,4788,4794,1.0,0.0012515644555694619,0.9987484355444305,2443,0.16833541927409262,0.3220692532332082,0.5095953274926992
1904,Jackson,17191,42,2429,9157,17149,17191,1.0,0.00244313885172474,0.9975568611482752,5605,0.1412948635914141,0.5326624396486533,0.3260426967599325
1905,Jackson,14909,68,1664,6920,14841,14909,1.0,0.004561003420752566,0.9954389965792474,6325,0.11161043664900396,0.4641491716412905,0.42424039170970557
1906,Jackson,8812,38,1266,4181,8774,8812,1.0,0.004312301407172038,0.9956876985928279,3365,0.1436677258284158,0.4744666364049024,0.3818656377666818
1907,Jackson,15561,34,2283,9239,15527,15561,1.0,0.002184949553370606,0.9978150504466294,4039,0.1467129361866204,0.5937279095173832,0.2595591542959964
1908,Jasper,4167,15,311,2597,4152,4167,1.0,0.003599712023038157,0.9964002879769619,1259,0.07463402927765779,0.623230141588673,0.3021358291336693
1909,Jasper,4783,7,1171,2161,4776,4783,1.0,0.0014635166213673428,0.9985364833786327,1451,0.24482542337445118,0.4518084883964039,0.3033660882291449
1910,Jasper,2168,15,279,1064,2153,2168,1.0,0.006918819188191882,0.9930811808118081,825,0.128690036900369,0.4907749077490775,0.3805350553505535
1911,Jeff Davis,834,3,68,447,831,834,1.0,0.0035971223021582736,0.9964028776978417,319,0.0815347721822542,0.5359712230215827,0.3824940047961631
1912,Jeff Davis,1410,7,43,913,1403,1410,1.0,0.004964539007092199,0.9950354609929078,454,0.03049645390070922,0.6475177304964539,0.3219858156028369
1913,Jeff Davis,1518,21,111,381,1497,1518,1.0,0.01383399209486166,0.9861660079051383,1026,0.07312252964426877,0.2509881422924901,0.6758893280632411
1914,Jeff Davis,840,1,24,493,839,840,1.0,0.0011904761904761906,0.9988095238095238,323,0.02857142857142857,0.5869047619047619,0.38452380952380955
1915,Jeff Davis,2065,13,408,406,2052,2065,1.0,0.006295399515738499,0.9937046004842615,1251,0.19757869249394674,0.19661016949152543,0.6058111380145278
1916,Jeff Davis,1718,1,127,821,1717,1718,1.0,0.0005820721769499418,0.9994179278230501,770,0.0739231664726426,0.4778812572759022,0.4481955762514552
1917,Jeff Davis,466,1,66,280,465,466,1.0,0.002145922746781116,0.9978540772532188,120,0.14163090128755365,0.6008583690987125,0.2575107296137339
1918,Jeff Davis,1204,7,152,503,1197,1204,1.0,0.005813953488372093,0.9941860465116279,549,0.12624584717607973,0.41777408637873753,0.45598006644518274
1919,Jeff Davis,801,5,29,451,796,801,1.0,0.006242197253433208,0.9937578027465668,321,0.03620474406991261,0.5630461922596754,0.40074906367041196
1920,Jefferson,435,7,50,232,428,435,1.0,0.016091954022988506,0.9839080459770115,153,0.11494252873563218,0.5333333333333333,0.35172413793103446
1921,Jefferson,494,1,169,184,493,494,1.0,0.0020242914979757085,0.9979757085020243,141,0.34210526315789475,0.3724696356275304,0.2854251012145749
1922,Jefferson,4478,5,1534,1078,4473,4478,1.0,0.0011165698972755694,0.9988834301027244,1866,0.3425636444841447,0.24073246985261276,0.4167038856632425
1923,Jefferson,634,1,137,322,633,634,1.0,0.0015772870662460567,0.998422712933754,175,0.21608832807570977,0.5078864353312302,0.27602523659305994
1924,Jefferson,783,4,172,280,779,783,1.0,0.005108556832694764,0.9948914431673053,331,0.21966794380587484,0.35759897828863346,0.4227330779054917
1925,Jefferson,578,1,117,188,577,578,1.0,0.0017301038062283738,0.9982698961937716,273,0.20242214532871972,0.32525951557093424,0.47231833910034604
1926,Jefferson,1830,5,854,371,1825,1830,1.0,0.00273224043715847,0.9972677595628415,605,0.4666666666666667,0.20273224043715846,0.33060109289617484
1927,Jefferson,3069,6,1028,882,3063,3069,1.0,0.0019550342130987292,0.9980449657869013,1159,0.3349625285109156,0.2873900293255132,0.3776474421635712
1928,Jenkins,1113,6,369,292,1107,1113,1.0,0.005390835579514825,0.9946091644204852,452,0.33153638814016173,0.26235399820305483,0.40610961365678344
1929,Jenkins,1395,0,245,488,1395,1395,1.0,0.0,1.0,662,0.17562724014336917,0.34982078853046594,0.4745519713261649
1930,Jenkins,914,7,376,242,907,914,1.0,0.007658643326039387,0.9923413566739606,296,0.4113785557986871,0.2647702407002188,0.3238512035010941
1931,Jenkins,1247,6,162,548,1241,1247,1.0,0.0048115477145148355,0.9951884522854851,537,0.12991178829190056,0.43945469125902165,0.43063352044907777
1932,Jenkins,2336,3,114,591,2333,2336,1.0,0.0012842465753424657,0.9987157534246576,1631,0.0488013698630137,0.2529965753424658,0.6982020547945206
1933,Johnson,830,0,156,460,830,830,1.0,0.0,1.0,214,0.18795180722891566,0.5542168674698795,0.25783132530120484
1934,Johnson,1018,3,53,617,1015,1018,1.0,0.0029469548133595285,0.9970530451866405,348,0.05206286836935167,0.6060903732809431,0.3418467583497053
1935,Johnson,943,5,61,522,938,943,1.0,0.005302226935312832,0.9946977730646872,360,0.06468716861081654,0.5535524920466596,0.38176033934252385
1936,Johnson,4683,1,952,1251,4682,4683,1.0,0.00021353833013025838,0.9997864616698697,2480,0.20328849028400597,0.26713645099295324,0.5295750587230408
1937,Jones,1407,0,276,742,1407,1407,1.0,0.0,1.0,389,0.19616204690831557,0.527363184079602,0.27647476901208246
1938,Jones,2235,8,468,1316,2227,2235,1.0,0.0035794183445190158,0.996420581655481,451,0.20939597315436242,0.5888143176733781,0.2017897091722595
1939,Jones,1699,5,190,960,1694,1699,1.0,0.002942907592701589,0.9970570924072985,549,0.11183048852266039,0.5650382577987051,0.3231312536786345
1940,Jones,2368,9,442,823,2359,2368,1.0,0.003800675675675676,0.9961993243243243,1103,0.1866554054054054,0.34755067567567566,0.4657939189189189
1941,Jones,2451,1,545,1441,2450,2451,1.0,0.0004079967360261118,0.9995920032639739,465,0.22235822113423093,0.5879232966136271,0.189718482252142
1942,Jones,2740,6,511,1575,2734,2740,1.0,0.0021897810218978104,0.9978102189781022,654,0.1864963503649635,0.5748175182481752,0.23868613138686132
1943,Jones,3169,11,1377,868,3158,3169,1.0,0.0034711265383401703,0.9965288734616599,924,0.4345219312085831,0.2739034395708425,0.2915746292205743
1944,Jones,1909,1,445,921,1908,1909,1.0,0.0005238344683080147,0.9994761655316919,543,0.23310633839706651,0.4824515453116815,0.284442116291252
1945,Jones,3369,1,604,1204,3368,3369,1.0,0.00029682398337785694,0.9997031760166222,1561,0.1792816859602256,0.35737607598693977,0.46334223805283464
1946,Jones,228,0,30,115,228,228,1.0,0.0,1.0,83,0.13157894736842105,0.5043859649122807,0.36403508771929827
1947,Lamar,2601,2,1013,482,2599,2601,1.0,0.0007689350249903883,0.9992310649750096,1106,0.38946559015763166,0.18531334102268357,0.42522106881968474
1948,Lamar,1521,4,207,975,1517,1521,1.0,0.0026298487836949377,0.997370151216305,339,0.13609467455621302,0.6410256410256411,0.22287968441814596
1949,Lamar,3813,5,466,1546,3808,3813,1.0,0.0013113034356150013,0.998688696564385,1801,0.12221348019931812,0.4054550222921584,0.4723314975085235
1950,Lamar,4469,9,527,2368,4460,4469,1.0,0.0020138733497426717,0.9979861266502573,1574,0.11792347281270978,0.5298724546878496,0.3522040724994406
1951,Lamar,608,0,80,389,608,608,1.0,0.0,1.0,139,0.13157894736842105,0.6398026315789473,0.22861842105263158
1952,Lamar,1529,1,322,570,1528,1529,1.0,0.0006540222367560497,0.999345977763244,637,0.210595160235448,0.3727926749509483,0.41661216481360364
1953,Lanier,7326,27,1019,2509,7299,7326,1.0,0.0036855036855036856,0.9963144963144963,3798,0.1390936390936391,0.34247884247884247,0.5184275184275184
1954,Laurens,2033,1,244,926,2032,2033,1.0,0.0004918839153959665,0.999508116084604,863,0.12001967535661584,0.45548450565666504,0.4244958189867191
1955,Laurens,1128,6,329,397,1122,1128,1.0,0.005319148936170213,0.9946808510638298,402,0.2916666666666667,0.3519503546099291,0.35638297872340424
1956,Laurens,523,0,69,249,523,523,1.0,0.0,1.0,205,0.13193116634799235,0.47609942638623326,0.3919694072657744
1957,Laurens,985,0,78,479,985,985,1.0,0.0,1.0,428,0.07918781725888324,0.4862944162436548,0.43451776649746193
1958,Laurens,7324,15,2447,849,7309,7324,1.0,0.0020480611687602405,0.9979519388312398,4028,0.3341070453304205,0.1159202621518296,0.5499726925177498
1959,Laurens,1174,3,169,761,1171,1174,1.0,0.002555366269165247,0.9974446337308348,244,0.14395229982964225,0.6482112436115843,0.20783645655877342
1960,Laurens,4408,4,1142,1912,4404,4408,1.0,0.0009074410163339383,0.9990925589836661,1354,0.2590744101633394,0.4337568058076225,0.30716878402903813
1961,Laurens,4177,17,756,2090,4160,4177,1.0,0.004069906631553747,0.9959300933684463,1331,0.18099114196791957,0.5003591094086665,0.31864974862341394
1962,Laurens,2044,6,188,1167,2038,2044,1.0,0.0029354207436399216,0.99706457925636,689,0.09197651663405088,0.5709393346379648,0.33708414872798437
1963,Laurens,412,0,124,161,412,412,1.0,0.0,1.0,127,0.30097087378640774,0.3907766990291262,0.308252427184466
1964,Laurens,2516,2,547,883,2514,2516,1.0,0.000794912559618442,0.9992050874403816,1086,0.21740858505564387,0.3509538950715421,0.431637519872814
1965,Laurens,1110,0,44,632,1110,1110,1.0,0.0,1.0,434,0.03963963963963964,0.5693693693693693,0.390990990990991
1966,Laurens,1023,5,104,583,1018,1023,1.0,0.004887585532746823,0.9951124144672532,336,0.10166177908113393,0.5698924731182796,0.3284457478005865
1967,Laurens,2749,16,398,1199,2733,2749,1.0,0.005820298290287377,0.9941797017097126,1152,0.1447799199708985,0.4361586031284103,0.4190614769006912
1968,Laurens,4055,2,931,1040,4053,4055,1.0,0.0004932182490752158,0.9995067817509248,2084,0.22959309494451294,0.2564734895191122,0.5139334155363748
1969,Laurens,2073,2,503,1165,2071,2073,1.0,0.000964785335262904,0.9990352146647371,405,0.24264351181862034,0.5619874577906416,0.19536903039073805
1970,Lee,3256,12,777,1495,3244,3256,1.0,0.0036855036855036856,0.9963144963144963,984,0.23863636363636365,0.45915233415233414,0.3022113022113022
1971,Lee,493,2,160,189,491,493,1.0,0.004056795131845842,0.9959432048681541,144,0.32454361054766734,0.38336713995943206,0.2920892494929006
1972,Lee,1592,6,65,425,1586,1592,1.0,0.0037688442211055275,0.9962311557788944,1102,0.04082914572864322,0.26695979899497485,0.6922110552763819
1973,Lee,3792,5,941,2152,3787,3792,1.0,0.0013185654008438818,0.9986814345991561,699,0.24815400843881857,0.5675105485232067,0.1843354430379747
1974,Lee,1459,0,177,808,1459,1459,1.0,0.0,1.0,474,0.12131596984235778,0.5538039753255655,0.32488005483207677
1975,Lee,3476,11,674,1558,3465,3476,1.0,0.0031645569620253164,0.9968354430379747,1244,0.19390103567318756,0.4482163406214039,0.3578826237054085
1976,Lee,4873,16,725,2749,4857,4873,1.0,0.0032833983172583622,0.9967166016827417,1399,0.14877898625076955,0.5641288733839523,0.2870921403652781
1977,Lee,1816,7,308,916,1809,1816,1.0,0.003854625550660793,0.9961453744493393,592,0.1696035242290749,0.5044052863436124,0.32599118942731276
1978,Lee,1077,2,270,407,1075,1077,1.0,0.0018570102135561746,0.9981429897864438,400,0.25069637883008355,0.3779015784586815,0.3714020427112349
1979,Lee,2831,6,461,1308,2825,2831,1.0,0.0021193924408336277,0.9978806075591664,1062,0.16283998587071707,0.46202755210173085,0.3751324620275521
1980,Liberty,6759,62,317,221,6697,6759,1.0,0.009172954579079745,0.9908270454209203,6221,0.04690042905755289,0.03269714454801006,0.920402426394437
1981,Liberty,3646,24,633,1536,3622,3646,1.0,0.006582556226001097,0.9934174437739989,1477,0.17361492046077895,0.4212835984640702,0.40510148107515087
1982,Liberty,487,0,255,94,487,487,1.0,0.0,1.0,138,0.5236139630390144,0.19301848049281314,0.28336755646817247
1983,Liberty,4490,20,884,902,4470,4490,1.0,0.004454342984409799,0.9955456570155902,2704,0.19688195991091315,0.20089086859688196,0.602227171492205
1984,Liberty,2711,10,653,521,2701,2711,1.0,0.0036886757654002213,0.9963113242345998,1537,0.24087052748063445,0.19218000737735152,0.566949465142014
1985,Liberty,3512,11,1110,440,3501,3512,1.0,0.003132118451025057,0.996867881548975,1962,0.31605922551252846,0.1252847380410023,0.5586560364464692
1986,Liberty,5241,21,1818,1034,5220,5241,1.0,0.004006868918145392,0.9959931310818546,2389,0.34688036634230107,0.19729059339820645,0.45582904025949245
1987,Liberty,4558,18,1612,1388,4540,4558,1.0,0.003949100482667837,0.9960508995173322,1558,0.3536638876700307,0.3045195261079421,0.3418165862220272
1988,Liberty,5379,32,1820,612,5347,5379,1.0,0.00594906116378509,0.9940509388362149,2947,0.338352853690277,0.11377579475738984,0.5478713515523331
1989,Liberty,2971,9,830,219,2962,2971,1.0,0.0030292830696735107,0.9969707169303265,1922,0.279367216425446,0.07371255469538876,0.6469202288791652
1990,Liberty,1012,5,629,161,1007,1012,1.0,0.004940711462450593,0.9950592885375494,222,0.6215415019762845,0.1590909090909091,0.21936758893280633
1991,Liberty,3124,9,1218,395,3115,3124,1.0,0.002880921895006402,0.9971190781049936,1511,0.38988476312419973,0.1264404609475032,0.48367477592829705
1992,Liberty,4124,20,1320,436,4104,4124,1.0,0.004849660523763337,0.9951503394762367,2368,0.3200775945683802,0.10572259941804074,0.574199806013579
1993,Lincoln,607,1,72,340,606,607,1.0,0.0016474464579901153,0.9983525535420099,195,0.1186161449752883,0.5601317957166392,0.3212520593080725
1994,Lincoln,504,3,128,232,501,504,1.0,0.005952380952380952,0.9940476190476191,144,0.25396825396825395,0.4603174603174603,0.2857142857142857
1995,Lincoln,1542,1,262,859,1541,1542,1.0,0.0006485084306095979,0.9993514915693904,421,0.16990920881971466,0.5570687418936446,0.2730220492866407
1996,Lincoln,757,5,348,230,752,757,1.0,0.0066050198150594455,0.9933949801849405,179,0.45970937912813736,0.3038309114927345,0.23645970937912814
1997,Lincoln,1265,2,185,785,1263,1265,1.0,0.0015810276679841897,0.9984189723320158,295,0.14624505928853754,0.6205533596837944,0.233201581027668
1998,Lincoln,636,5,130,303,631,636,1.0,0.007861635220125786,0.9921383647798742,203,0.20440251572327045,0.47641509433962265,0.3191823899371069
1999,Lincoln,959,0,310,430,959,959,1.0,0.0,1.0,219,0.3232533889468196,0.4483837330552659,0.2283628779979145
2000,Long,360,2,33,174,358,360,1.0,0.005555555555555556,0.9944444444444445,153,0.09166666666666666,0.48333333333333334,0.425
2001,Long,1883,29,336,516,1854,1883,1.0,0.015400955921402018,0.984599044078598,1031,0.17843866171003717,0.2740308019118428,0.54753053637812
2002,Long,1206,3,119,372,1203,1206,1.0,0.0024875621890547263,0.9975124378109452,715,0.09867330016583747,0.30845771144278605,0.5928689883913765
2003,Long,2151,15,526,627,2136,2151,1.0,0.00697350069735007,0.99302649930265,998,0.24453742445374244,0.2914923291492329,0.46397024639702467
2004,Long,3137,26,601,1060,3111,3137,1.0,0.008288173414089895,0.9917118265859101,1476,0.19158431622569333,0.3379024545744342,0.4705132291998725
2005,Long,1799,12,329,328,1787,1799,1.0,0.006670372429127293,0.9933296275708727,1142,0.1828793774319066,0.18232351306281266,0.6347971095052807
2006,Long,698,6,89,451,692,698,1.0,0.008595988538681949,0.9914040114613181,158,0.12750716332378223,0.6461318051575932,0.22636103151862463
2007,Lowndes,5203,23,806,2146,5180,5203,1.0,0.004420526619258121,0.9955794733807419,2251,0.15491062848356718,0.41245435325773594,0.4326350182586969
2008,Lowndes,4627,20,493,2415,4607,4627,1.0,0.004322455154527772,0.9956775448454722,1719,0.10654851955910957,0.5219364599092284,0.37151502053166197
2009,Lowndes,5993,31,854,3073,5962,5993,1.0,0.00517270148506591,0.9948272985149341,2066,0.14249958284665443,0.5127648923744369,0.34473552477890873
2010,Lowndes,5176,7,1835,303,5169,5176,1.0,0.0013523956723338485,0.9986476043276662,3038,0.3545208655332303,0.058539412673879444,0.5869397217928902
2011,Lowndes,1367,5,329,614,1362,1367,1.0,0.0036576444769568397,0.9963423555230432,424,0.24067300658376006,0.4491587417702999,0.31016825164594003
2012,Lowndes,35040,135,9135,6911,34905,35040,1.0,0.003852739726027397,0.9961472602739726,18994,0.2607020547945205,0.19723173515981735,0.5420662100456621
2013,Lowndes,11865,57,2395,4096,11808,11865,1.0,0.004804045512010114,0.9951959544879899,5374,0.20185419300463547,0.34521702486304257,0.45292878213232196
2014,Lowndes,4293,21,624,2154,4272,4293,1.0,0.004891684136967156,0.9951083158630328,1515,0.1453529000698812,0.5017470300489169,0.352900069881202
2015,Lowndes,15467,76,3646,3979,15391,15467,1.0,0.004913687205017133,0.9950863127949828,7842,0.23572767828279562,0.2572573866942523,0.5070149350229521
2016,Lumpkin,27689,158,3126,12163,27531,27689,1.0,0.00570623713387988,0.9942937628661201,12400,0.1128968182310665,0.4392719130340568,0.44783126873487666
2017,Macon,1710,3,409,535,1707,1710,1.0,0.0017543859649122807,0.9982456140350877,766,0.2391812865497076,0.3128654970760234,0.447953216374269
2018,Macon,1787,9,544,360,1778,1787,1.0,0.005036373810856184,0.9949636261891438,883,0.30442081701175155,0.20145495243424735,0.4941242305540011
2019,Macon,1561,5,713,344,1556,1561,1.0,0.0032030749519538757,0.9967969250480462,504,0.4567584881486227,0.22037155669442665,0.32286995515695066
2020,Macon,1647,7,680,191,1640,1647,1.0,0.004250151791135397,0.9957498482088646,776,0.41287188828172433,0.11596842744383729,0.4711596842744384
2021,Macon,3233,3,511,353,3230,3233,1.0,0.0009279307145066501,0.9990720692854933,2369,0.15805753170429943,0.10918651407361583,0.7327559542220847
2022,Madison,3660,9,702,1664,3651,3660,1.0,0.002459016393442623,0.9975409836065574,1294,0.1918032786885246,0.4546448087431694,0.35355191256830604
2023,Madison,791,1,57,403,790,791,1.0,0.0012642225031605564,0.9987357774968394,331,0.07206068268015171,0.5094816687737042,0.41845764854614415
2024,Madison,1705,1,364,716,1704,1705,1.0,0.0005865102639296188,0.9994134897360704,625,0.21348973607038124,0.419941348973607,0.36656891495601174
2025,Madison,3314,4,354,1784,3310,3314,1.0,0.0012070006035003018,0.9987929993964997,1176,0.10681955340977671,0.5383222691611346,0.3548581774290887
2026,Madison,633,1,130,273,632,633,1.0,0.001579778830963665,0.9984202211690363,230,0.20537124802527645,0.4312796208530806,0.36334913112164297
2027,Madison,671,0,34,445,671,671,1.0,0.0,1.0,192,0.05067064083457526,0.6631892697466468,0.28614008941877794
2028,Madison,4981,33,990,1950,4948,4981,1.0,0.006625175667536639,0.9933748243324634,2041,0.1987552700260992,0.3914876530817105,0.4097570768921903
2029,Madison,1948,5,168,1001,1943,1948,1.0,0.002566735112936345,0.9974332648870636,779,0.08624229979466119,0.5138603696098563,0.39989733059548255
2030,Madison,1857,1,178,1060,1856,1857,1.0,0.0005385029617662897,0.9994614970382337,619,0.09585352719439957,0.5708131394722671,0.3333333333333333
2031,Madison,273,0,27,191,273,273,1.0,0.0,1.0,55,0.0989010989010989,0.6996336996336996,0.20146520146520147
2032,Madison,2090,9,292,1135,2081,2090,1.0,0.00430622009569378,0.9956937799043062,663,0.1397129186602871,0.5430622009569378,0.31722488038277513
2033,Madison,1189,2,115,704,1187,1189,1.0,0.001682085786375105,0.9983179142136249,370,0.09671993271656855,0.592094196804037,0.31118587047939444
2034,Marion,502,4,47,262,498,502,1.0,0.00796812749003984,0.9920318725099602,193,0.09362549800796813,0.5219123505976095,0.3844621513944223
2035,Marion,2840,9,1046,730,2831,2840,1.0,0.0031690140845070424,0.9968309859154929,1064,0.3683098591549296,0.25704225352112675,0.37464788732394366
2036,Marion,1059,2,105,476,1057,1059,1.0,0.0018885741265344666,0.9981114258734656,478,0.09915014164305949,0.449480642115203,0.4513692162417375
2037,Marion,1118,3,67,600,1115,1118,1.0,0.0026833631484794273,0.9973166368515206,451,0.05992844364937388,0.5366726296958855,0.4033989266547406
2038,Marion,335,3,46,207,332,335,1.0,0.008955223880597015,0.991044776119403,82,0.1373134328358209,0.6179104477611941,0.24477611940298508
2039,McDuffie,1307,5,583,157,1302,1307,1.0,0.0038255547054322878,0.9961744452945677,567,0.44605967865340473,0.12012241775057383,0.4338179035960214
2040,McDuffie,1575,12,138,1025,1563,1575,1.0,0.007619047619047619,0.9923809523809524,412,0.08761904761904762,0.6507936507936508,0.2615873015873016
2041,McDuffie,1506,6,257,590,1500,1506,1.0,0.00398406374501992,0.9960159362549801,659,0.17065073041168657,0.39176626826029215,0.43758300132802125
2042,McDuffie,2230,10,327,1058,2220,2230,1.0,0.004484304932735426,0.9955156950672646,845,0.14663677130044844,0.4744394618834081,0.3789237668161435
2043,McDuffie,2089,2,813,511,2087,2089,1.0,0.0009573958831977022,0.9990426041168023,765,0.389181426519866,0.24461464815701292,0.3662039253231211
2044,McDuffie,3330,1,718,1442,3329,3330,1.0,0.0003003003003003003,0.9996996996996997,1170,0.21561561561561562,0.43303303303303303,0.35135135135135137
2045,McDuffie,2199,3,895,171,2196,2199,1.0,0.001364256480218281,0.9986357435197817,1133,0.4070031832651205,0.07776261937244201,0.5152341973624375
2046,McDuffie,1332,4,176,766,1328,1332,1.0,0.003003003003003003,0.996996996996997,390,0.13213213213213212,0.575075075075075,0.2927927927927928
2047,McDuffie,1047,2,261,449,1045,1047,1.0,0.0019102196752626551,0.9980897803247374,337,0.2492836676217765,0.4288443170964661,0.3218720152817574
2048,McIntosh,1965,7,868,501,1958,1965,1.0,0.0035623409669211198,0.9964376590330789,596,0.44173027989821884,0.2549618320610687,0.30330788804071246
2049,McIntosh,2303,14,654,1041,2289,2303,1.0,0.0060790273556231,0.993920972644377,608,0.2839774207555363,0.45201910551454627,0.2640034737299175
2050,McIntosh,2042,5,528,943,2037,2042,1.0,0.002448579823702253,0.9975514201762977,571,0.25857002938295787,0.46180215475024483,0.27962781586679725
2051,McIntosh,100,1,32,10,99,100,1.0,0.01,0.99,58,0.32,0.1,0.58
2052,McIntosh,2108,6,414,1213,2102,2108,1.0,0.0028462998102466793,0.9971537001897534,481,0.19639468690702086,0.575426944971537,0.22817836812144213
2053,McIntosh,522,1,116,308,521,522,1.0,0.0019157088122605363,0.9980842911877394,98,0.2222222222222222,0.5900383141762452,0.18773946360153257
2054,Meriwether,1511,7,377,723,1504,1511,1.0,0.004632693580410324,0.9953673064195897,411,0.24950363997352745,0.4784910655195235,0.27200529450694905
2055,Meriwether,506,0,48,307,506,506,1.0,0.0,1.0,151,0.09486166007905138,0.6067193675889329,0.2984189723320158
2056,Meriwether,235,0,11,151,235,235,1.0,0.0,1.0,73,0.04680851063829787,0.6425531914893617,0.31063829787234043
2057,Meriwether,783,3,173,357,780,783,1.0,0.0038314176245210726,0.9961685823754789,253,0.22094508301404853,0.4559386973180077,0.3231162196679438
2058,Meriwether,434,1,75,217,433,434,1.0,0.002304147465437788,0.9976958525345622,142,0.1728110599078341,0.5,0.3271889400921659
2059,Meriwether,2153,9,667,676,2144,2153,1.0,0.0041802136553646075,0.9958197863446354,810,0.30980027868091037,0.31398049233627495,0.3762192289828147
2060,Meriwether,1339,4,409,492,1335,1339,1.0,0.002987303958177745,0.9970126960418223,438,0.3054518297236744,0.3674383868558626,0.32710978342046304
2061,Meriwether,2875,18,687,1186,2857,2875,1.0,0.006260869565217392,0.9937391304347826,1002,0.23895652173913043,0.4125217391304348,0.34852173913043477
2062,Meriwether,1969,3,422,761,1966,1969,1.0,0.0015236160487557136,0.9984763839512443,786,0.2143219908583037,0.38649060436769933,0.39918740477399695
2063,Meriwether,1050,2,519,146,1048,1050,1.0,0.0019047619047619048,0.9980952380952381,385,0.4942857142857143,0.13904761904761906,0.36666666666666664
2064,Meriwether,339,0,93,138,339,339,1.0,0.0,1.0,108,0.2743362831858407,0.40707964601769914,0.3185840707964602
2065,Meriwether,513,2,68,311,511,513,1.0,0.003898635477582846,0.9961013645224172,134,0.13255360623781676,0.6062378167641326,0.26120857699805067
2066,Meriwether,1386,2,279,546,1384,1386,1.0,0.001443001443001443,0.9985569985569985,561,0.2012987012987013,0.3939393939393939,0.40476190476190477
2067,Meriwether,1433,0,459,513,1433,1433,1.0,0.0,1.0,461,0.32030704815073274,0.35799023028611304,0.3217027215631542
2068,Miller,4749,9,749,2066,4740,4749,1.0,0.0018951358180669614,0.998104864181933,1934,0.15771741419246157,0.4350389555695936,0.40724363023794485
2069,Mitchell,1198,1,331,400,1197,1198,1.0,0.0008347245409015025,0.9991652754590985,467,0.27629382303839733,0.333889816360601,0.38981636060100167
2070,Mitchell,702,2,82,385,700,702,1.0,0.002849002849002849,0.9971509971509972,235,0.1168091168091168,0.5484330484330484,0.33475783475783477
2071,Mitchell,2167,0,1000,248,2167,2167,1.0,0.0,1.0,919,0.46146746654360865,0.11444393170281496,0.4240886017535764
2072,Mitchell,5600,13,1171,1197,5587,5600,1.0,0.0023214285714285715,0.9976785714285714,3232,0.20910714285714285,0.21375,0.5771428571428572
2073,Mitchell,485,0,28,288,485,485,1.0,0.0,1.0,169,0.0577319587628866,0.5938144329896907,0.34845360824742266
2074,Mitchell,154,4,13,99,150,154,1.0,0.025974025974025976,0.974025974025974,42,0.08441558441558442,0.6428571428571429,0.2727272727272727
2075,Mitchell,370,2,40,213,368,370,1.0,0.005405405405405406,0.9945945945945946,117,0.10810810810810811,0.5756756756756757,0.3162162162162162
2076,Mitchell,1465,6,166,704,1459,1465,1.0,0.004095563139931741,0.9959044368600682,595,0.11331058020477816,0.4805460750853242,0.4061433447098976
2077,Mitchell,196,0,21,107,196,196,1.0,0.0,1.0,68,0.10714285714285714,0.5459183673469388,0.3469387755102041
2078,Mitchell,4342,6,1080,1080,4336,4342,1.0,0.0013818516812528789,0.9986181483187471,2182,0.24873330262551818,0.24873330262551818,0.5025333947489636
2079,Mitchell,386,0,63,214,386,386,1.0,0.0,1.0,109,0.16321243523316062,0.5544041450777202,0.2823834196891192
2080,Monroe,2433,7,402,1458,2426,2433,1.0,0.002877106452938759,0.9971228935470613,573,0.16522811344019728,0.5992601726263872,0.23551171393341552
2081,Monroe,1020,1,136,796,1019,1020,1.0,0.000980392156862745,0.9990196078431373,88,0.13333333333333333,0.7803921568627451,0.08627450980392157
2082,Monroe,2095,1,366,1523,2094,2095,1.0,0.00047732696897374703,0.9995226730310263,206,0.1747016706443914,0.7269689737470167,0.09832935560859188
2083,Monroe,843,4,152,415,839,843,1.0,0.004744958481613286,0.9952550415183867,276,0.18030842230130487,0.49228944246737844,0.3274021352313167
2084,Monroe,698,1,130,428,697,698,1.0,0.0014326647564469914,0.998567335243553,140,0.18624641833810887,0.6131805157593123,0.20057306590257878
2085,Monroe,476,0,113,214,476,476,1.0,0.0,1.0,149,0.23739495798319327,0.4495798319327731,0.3130252100840336
2086,Monroe,1026,0,135,558,1026,1026,1.0,0.0,1.0,333,0.13157894736842105,0.543859649122807,0.32456140350877194
2087,Monroe,1970,8,332,1274,1962,1970,1.0,0.0040609137055837565,0.9959390862944163,364,0.16852791878172588,0.6467005076142132,0.1847715736040609
2088,Monroe,5711,2,1732,1334,5709,5711,1.0,0.0003502013657853266,0.9996497986342147,2645,0.3032743827700928,0.23358431097881283,0.4631413062510944
2089,Monroe,2021,9,212,1069,2012,2021,1.0,0.004453240969816922,0.9955467590301831,740,0.10489856506679862,0.52894606630381,0.3661553686293914
2090,Monroe,594,0,245,305,594,594,1.0,0.0,1.0,44,0.41245791245791247,0.5134680134680135,0.07407407407407407
2091,Monroe,1291,0,168,810,1291,1291,1.0,0.0,1.0,313,0.13013168086754454,0.627420604182804,0.24244771494965142
2092,Monroe,1266,1,200,600,1265,1266,1.0,0.0007898894154818325,0.9992101105845181,466,0.1579778830963665,0.47393364928909953,0.36808846761453395
2093,Monroe,486,1,61,276,485,486,1.0,0.00205761316872428,0.9979423868312757,149,0.12551440329218108,0.5679012345679012,0.3065843621399177
2094,Montgomery,656,0,95,244,656,656,1.0,0.0,1.0,317,0.1448170731707317,0.3719512195121951,0.48323170731707316
2095,Montgomery,527,1,48,325,526,527,1.0,0.0018975332068311196,0.9981024667931688,154,0.09108159392789374,0.6166982922201139,0.2922201138519924
2096,Montgomery,1511,2,217,769,1509,1511,1.0,0.0013236267372600927,0.99867637326274,525,0.14361350099272005,0.5089344804765056,0.34745201853077434
2097,Montgomery,504,1,35,369,503,504,1.0,0.001984126984126984,0.998015873015873,100,0.06944444444444445,0.7321428571428571,0.1984126984126984
2098,Montgomery,2130,3,408,545,2127,2130,1.0,0.0014084507042253522,0.9985915492957746,1177,0.19154929577464788,0.25586854460093894,0.5525821596244131
2099,Montgomery,385,1,16,247,384,385,1.0,0.0025974025974025974,0.9974025974025974,122,0.04155844155844156,0.6415584415584416,0.3168831168831169
2100,Montgomery,1079,5,160,461,1074,1079,1.0,0.004633920296570899,0.995366079703429,458,0.14828544949026876,0.4272474513438369,0.42446709916589437
2101,Morgan,876,3,137,553,873,876,1.0,0.003424657534246575,0.9965753424657534,186,0.15639269406392695,0.6312785388127854,0.21232876712328766
2102,Morgan,3157,9,628,1543,3148,3157,1.0,0.0028508077288565093,0.9971491922711435,986,0.19892302819132088,0.48875514729173264,0.31232182451694646
2103,Morgan,720,2,94,502,718,720,1.0,0.002777777777777778,0.9972222222222222,124,0.13055555555555556,0.6972222222222222,0.17222222222222222
2104,Morgan,2311,10,395,1412,2301,2311,1.0,0.004327131112072695,0.9956728688879273,504,0.1709216789268715,0.6109909130246647,0.21808740804846388
2105,Morgan,2777,14,475,1602,2763,2777,1.0,0.005041411595246669,0.9949585884047534,700,0.17104789341015483,0.5768815268275117,0.25207057976233344
2106,Morgan,3069,0,1205,936,3069,3069,1.0,0.0,1.0,928,0.39263603779732814,0.30498533724340177,0.30237862495927015
2107,Morgan,2664,6,421,1682,2658,2664,1.0,0.0022522522522522522,0.9977477477477478,561,0.15803303303303304,0.6313813813813813,0.21058558558558557
2108,Murray,2687,25,157,1227,2662,2687,1.0,0.009304056568663937,0.990695943431336,1303,0.05842947525120953,0.45664309639002604,0.4849274283587644
2109,Murray,3518,41,238,1453,3477,3518,1.0,0.011654349061967027,0.988345650938033,1827,0.06765207504263786,0.4130187606594656,0.5193291642978966
2110,Murray,2687,12,164,1358,2675,2687,1.0,0.00446594715295869,0.9955340528470413,1165,0.06103461109043543,0.5053963528098251,0.4335690360997395
2111,Murray,4077,30,341,1677,4047,4077,1.0,0.007358351729212656,0.9926416482707874,2059,0.08363993132205053,0.41133186166298746,0.505028207014962
2112,Murray,4566,24,227,1757,4542,4566,1.0,0.005256241787122208,0.9947437582128777,2582,0.04971528690319755,0.3848007008322383,0.5654840122645641
2113,Murray,4952,56,473,2068,4896,4952,1.0,0.011308562197092083,0.9886914378029079,2411,0.09551696284329564,0.4176090468497577,0.48687399030694667
2114,Murray,7723,186,702,3403,7537,7723,1.0,0.024083905218179463,0.9759160947818205,3618,0.09089731969441926,0.44063187880357374,0.468470801502007
2115,Muscogee,3343,21,723,1031,3322,3343,1.0,0.006281782829793599,0.9937182171702064,1589,0.21627280885432246,0.30840562369129526,0.4753215674543823
2116,Muscogee,4727,8,2227,122,4719,4727,1.0,0.0016924053310767928,0.9983075946689232,2378,0.4711233340385022,0.025809181298921093,0.5030674846625767
2117,Muscogee,7054,30,1000,1118,7024,7054,1.0,0.0042529061525375675,0.9957470938474624,4936,0.14176353841791892,0.15849163595123333,0.6997448256308477
2118,Muscogee,7990,31,1841,2640,7959,7990,1.0,0.0038798498122653317,0.9961201501877347,3509,0.23041301627033792,0.3304130162703379,0.43917396745932413
2119,Muscogee,7369,34,2589,188,7335,7369,1.0,0.00461392319174922,0.9953860768082508,4592,0.3513366806893744,0.02551228117790745,0.6231510381327181
2120,Muscogee,3702,12,1365,641,3690,3702,1.0,0.0032414910858995136,0.9967585089141004,1696,0.3687196110210697,0.1731496488384657,0.4581307401404646
2121,Muscogee,6144,30,1183,1320,6114,6144,1.0,0.0048828125,0.9951171875,3641,0.19254557291666666,0.21484375,0.5926106770833334
2122,Muscogee,4469,15,2567,227,4454,4469,1.0,0.003356455582904453,0.9966435444170956,1675,0.5744014320877153,0.05079436115462072,0.3748042067576639
2123,Muscogee,2920,14,668,238,2906,2920,1.0,0.004794520547945206,0.9952054794520548,2014,0.22876712328767124,0.08150684931506849,0.6897260273972603
2124,Muscogee,9741,15,3286,664,9726,9741,1.0,0.001539882968894364,0.9984601170311056,5791,0.33733702905245866,0.06816548608972385,0.5944974848578175
2125,Muscogee,7688,49,1865,1670,7639,7688,1.0,0.006373569198751301,0.9936264308012487,4153,0.24258584807492195,0.2172216441207076,0.5401925078043704
2126,Muscogee,3955,12,1014,382,3943,3955,1.0,0.003034134007585335,0.9969658659924147,2559,0.2563843236409608,0.0965865992414665,0.6470290771175727
2127,Muscogee,7036,27,1434,2146,7009,7036,1.0,0.003837407617964753,0.9961625923820352,3456,0.2038089823763502,0.30500284252416143,0.49118817509948837
2128,Muscogee,6387,18,3465,212,6369,6387,1.0,0.0028182245185533112,0.9971817754814467,2710,0.5425082198215124,0.03319242210740567,0.4242993580710819
2129,Muscogee,10041,52,3537,864,9989,10041,1.0,0.005178767055074196,0.9948212329449259,5640,0.35225575141918136,0.08604720645354048,0.5616970421272781
2130,Muscogee,7616,13,2692,2837,7603,7616,1.0,0.0017069327731092437,0.9982930672268907,2087,0.35346638655462187,0.37250525210084034,0.27402836134453784
2131,Muscogee,8301,19,3896,553,8282,8301,1.0,0.0022888808577279846,0.9977111191422721,3852,0.46934104324780146,0.06661847970124081,0.4640404770509577
2132,Muscogee,3671,14,1129,994,3657,3671,1.0,0.003813674748025061,0.9961863252519749,1548,0.30754562789430673,0.27077090710977936,0.4216834649959139
2133,Muscogee,6539,14,3124,230,6525,6539,1.0,0.0021410001529285822,0.9978589998470714,3185,0.477748891267778,0.035173573940969566,0.4870775347912525
2134,Muscogee,6251,18,1785,2190,6233,6251,1.0,0.0028795392737162055,0.9971204607262838,2276,0.2855543113101904,0.350343944968805,0.3641017437210046
2135,Muscogee,3775,22,908,1346,3753,3775,1.0,0.005827814569536424,0.9941721854304636,1521,0.2405298013245033,0.3565562913907285,0.4029139072847682
2136,Muscogee,8671,24,2605,3024,8647,8671,1.0,0.002767846845807865,0.9972321531541921,3042,0.30042670972206204,0.348748702571791,0.35082458770614694
2137,Muscogee,6515,45,1676,3243,6470,6515,1.0,0.006907137375287797,0.9930928626247122,1596,0.25725249424405217,0.4977743668457406,0.24497313891020722
2138,Muscogee,3113,7,722,1453,3106,3113,1.0,0.0022486347574686796,0.9977513652425313,938,0.23193061355605527,0.46675232894314167,0.30131705750080306
2139,Muscogee,5804,20,2228,716,5784,5804,1.0,0.0034458993797381117,0.9965541006202618,2860,0.3838731909028256,0.1233631977946244,0.49276361130255
2140,Newton,5019,17,1655,1687,5002,5019,1.0,0.0033871289101414623,0.9966128710898585,1677,0.3297469615461247,0.33612273361227335,0.3341303048416019
2141,Newton,4991,17,2705,763,4974,4991,1.0,0.0034061310358645563,0.9965938689641355,1523,0.5419755560008015,0.15287517531556802,0.3051492686836305
2142,Newton,5367,6,2872,710,5361,5367,1.0,0.0011179429849077697,0.9988820570150923,1785,0.5351220421091858,0.13228991988075275,0.3325880380100615
2143,Newton,3848,8,676,1845,3840,3848,1.0,0.002079002079002079,0.997920997920998,1327,0.17567567567567569,0.47946985446985446,0.3448544698544699
2144,Newton,2670,0,564,1441,2670,2670,1.0,0.0,1.0,665,0.21123595505617979,0.5397003745318352,0.24906367041198502
2145,Newton,5057,31,1835,1395,5026,5057,1.0,0.006130116669962428,0.9938698833300376,1827,0.36286335772196954,0.27585525014830925,0.36128139212972116
2146,Newton,3773,17,980,759,3756,3773,1.0,0.004505698383249403,0.9954943016167506,2034,0.2597402597402597,0.20116618075801748,0.5390935595017228
2147,Newton,2277,12,642,398,2265,2277,1.0,0.005270092226613966,0.994729907773386,1237,0.28194993412384717,0.17479139218269654,0.5432586736934563
2148,Newton,3401,17,1085,946,3384,3401,1.0,0.004998529844163481,0.9950014701558365,1370,0.3190238165245516,0.27815348426933256,0.40282269920611585
2149,Newton,5232,26,2743,399,5206,5232,1.0,0.004969418960244648,0.9950305810397554,2090,0.5242737003058104,0.07626146788990826,0.39946483180428133
2150,Newton,6530,8,2374,1954,6522,6530,1.0,0.001225114854517611,0.9987748851454824,2202,0.36355283307810105,0.2992343032159265,0.3372128637059724
2151,Newton,3154,8,1573,233,3146,3154,1.0,0.0025364616360177552,0.9974635383639823,1348,0.49873176918199114,0.07387444514901712,0.4273937856689918
2152,Newton,4219,5,943,2244,4214,4219,1.0,0.0011851149561507466,0.9988148850438493,1032,0.2235126807300308,0.5318795923204551,0.2446077269495141
2153,Newton,2406,1,340,1560,2405,2406,1.0,0.00041562759767248546,0.9995843724023276,506,0.14131338320864506,0.6483790523690773,0.21030756442227763
2154,Newton,2298,6,401,1227,2292,2298,1.0,0.0026109660574412533,0.9973890339425587,670,0.17449956483899043,0.5339425587467362,0.2915578764142733
2155,Newton,4694,8,2094,837,4686,4694,1.0,0.0017043033659991478,0.9982956966340009,1763,0.4461014060502769,0.17831273966766084,0.3755858542820622
2156,Newton,1572,5,145,1066,1567,1572,1.0,0.0031806615776081423,0.9968193384223919,361,0.09223918575063614,0.678117048346056,0.2296437659033079
2157,Newton,912,0,109,494,912,912,1.0,0.0,1.0,309,0.11951754385964912,0.5416666666666666,0.33881578947368424
2158,Newton,3427,7,586,1204,3420,3427,1.0,0.0020426028596440037,0.997957397140356,1637,0.17099503939305516,0.3513276918587686,0.47767726874817623
2159,Newton,3701,2,1105,1297,3699,3701,1.0,0.0005403944879762226,0.9994596055120237,1299,0.29856795460686303,0.3504458254525804,0.3509862199405566
2160,Newton,5256,25,2416,805,5231,5256,1.0,0.004756468797564688,0.9952435312024354,2035,0.4596651445966514,0.15315829528158295,0.3871765601217656
2161,Newton,4944,12,1951,605,4932,4944,1.0,0.0024271844660194173,0.9975728155339806,2388,0.3946197411003236,0.1223705501618123,0.4830097087378641
2162,Oconee,1371,3,280,874,1368,1371,1.0,0.002188183807439825,0.9978118161925602,217,0.20423048869438365,0.637490882567469,0.15827862873814733
2163,Oconee,3106,9,857,1217,3097,3106,1.0,0.0028976175144880875,0.9971023824855119,1032,0.2759175788795879,0.3918222794591114,0.3322601416613007
2164,Oconee,1998,0,517,1086,1998,1998,1.0,0.0,1.0,395,0.25875875875875876,0.5435435435435435,0.1976976976976977
2165,Oconee,2462,6,557,1299,2456,2462,1.0,0.002437043054427295,0.9975629569455727,606,0.2262388302193339,0.5276198212835094,0.24614134849715677
2166,Oconee,3761,8,1303,1854,3753,3761,1.0,0.002127093858016485,0.9978729061419835,604,0.346450412124435,0.4929540015953204,0.16059558628024462
2167,Oconee,4286,2,1338,2268,4284,4286,1.0,0.0004666355576294914,0.9995333644423705,680,0.3121791880541297,0.5291647223518432,0.15865608959402708
2168,Oconee,1836,6,494,1101,1830,1836,1.0,0.0032679738562091504,0.9967320261437909,241,0.2690631808278867,0.5996732026143791,0.1312636165577342
2169,Oconee,3436,2,666,2309,3434,3436,1.0,0.0005820721769499418,0.9994179278230501,461,0.19383003492433062,0.6720023282887078,0.13416763678696159
2170,Oconee,718,2,174,421,716,718,1.0,0.002785515320334262,0.9972144846796658,123,0.24233983286908078,0.5863509749303621,0.1713091922005571
2171,Oconee,1784,3,483,1177,1781,1784,1.0,0.0016816143497757848,0.9983183856502242,124,0.2707399103139013,0.6597533632286996,0.06950672645739911
2172,Oconee,4152,7,1211,2217,4145,4152,1.0,0.0016859344894026974,0.9983140655105973,724,0.2916666666666667,0.5339595375722543,0.174373795761079
2173,Oconee,1311,2,282,772,1309,1311,1.0,0.0015255530129672007,0.9984744469870328,257,0.2151029748283753,0.5888634630053394,0.19603356216628529
2174,Oglethorpe,3740,28,746,1835,3712,3740,1.0,0.0074866310160427805,0.9925133689839573,1159,0.19946524064171123,0.49064171122994654,0.30989304812834223
2175,Oglethorpe,3297,12,710,1467,3285,3297,1.0,0.003639672429481347,0.9963603275705186,1120,0.21534728541097967,0.44494995450409464,0.33970276008492567
2176,Oglethorpe,4602,1,980,2291,4601,4602,1.0,0.000217296827466319,0.9997827031725337,1331,0.21295089091699262,0.4978270317253368,0.2892220773576706
2177,Paulding,7918,50,1957,3116,7868,7918,1.0,0.006314725940894165,0.9936852740591058,2845,0.24715837332659762,0.39353372063652436,0.359307906036878
2178,Paulding,6199,23,905,4036,6176,6199,1.0,0.0037102758509437008,0.9962897241490563,1258,0.14599128891756735,0.6510727536699468,0.20293595741248588
2179,Paulding,7272,20,1184,5075,7252,7272,1.0,0.0027502750275027505,0.9972497249724972,1013,0.1628162816281628,0.6978822882288229,0.1393014301430143
2180,Paulding,12052,56,1843,1516,11996,12052,1.0,0.004646531695984069,0.9953534683040159,8693,0.15292067706604712,0.1257882509127116,0.7212910720212413
2181,Paulding,9498,23,1636,2760,9475,9498,1.0,0.002421562434196673,0.9975784375658033,5102,0.1722467887976416,0.29058749210360074,0.5371657190987577
2182,Paulding,10641,33,1958,5133,10608,10641,1.0,0.0031012122920778123,0.9968987877079222,3550,0.18400526266328351,0.4823794756131943,0.33361526172352224
2183,Paulding,6521,29,1478,2588,6492,6521,1.0,0.004447170679343659,0.9955528293206564,2455,0.2266523539334458,0.39687164545315134,0.37647600061340286
2184,Paulding,5618,25,691,2210,5593,5618,1.0,0.0044499822000712,0.9955500177999288,2717,0.12299750800996796,0.39337842648629406,0.483624065503738
2185,Paulding,18454,62,5235,10738,18392,18454,1.0,0.0033597052129619594,0.9966402947870381,2481,0.28367833532025577,0.5818792673675084,0.13444239731223584
2186,Paulding,10110,32,3710,4131,10078,10110,1.0,0.003165182987141444,0.9968348170128586,2269,0.3669634025717112,0.4086053412462908,0.22443125618199802
2187,Paulding,12942,50,3000,4233,12892,12942,1.0,0.0038633905115129036,0.9961366094884871,5709,0.23180343069077422,0.32707464070468245,0.44112192860454336
2188,Paulding,16773,60,6107,8989,16713,16773,1.0,0.003577177606868181,0.9964228223931318,1677,0.36409706075239967,0.5359208251356347,0.09998211411196566
2189,Peach,2903,11,600,1408,2892,2903,1.0,0.0037891836031691355,0.9962108163968308,895,0.20668274199104375,0.48501550120564935,0.3083017568033069
2190,Peach,5763,20,1370,2299,5743,5763,1.0,0.0034704147145583897,0.9965295852854416,2094,0.2377234079472497,0.3989241714384869,0.3633524206142634
2191,Peach,1024,8,133,541,1016,1024,1.0,0.0078125,0.9921875,350,0.1298828125,0.5283203125,0.341796875
2192,Peach,3278,22,1079,681,3256,3278,1.0,0.006711409395973154,0.9932885906040269,1518,0.3291641244661379,0.20774862721171447,0.46308724832214765
2193,Peach,3508,13,1055,564,3495,3508,1.0,0.0037058152793614596,0.9962941847206386,1889,0.3007411630558723,0.16077537058152794,0.5384834663625998
2194,Peach,4116,3,1399,266,4113,4116,1.0,0.0007288629737609329,0.999271137026239,2451,0.3398931000971817,0.06462585034013606,0.5954810495626822
2195,Peach,1519,1,284,743,1518,1519,1.0,0.0006583278472679394,0.9993416721527321,492,0.1869651086240948,0.489137590520079,0.3238973008558262
2196,Pickens,2395,12,231,1136,2383,2395,1.0,0.005010438413361169,0.9949895615866389,1028,0.09645093945720251,0.474321503131524,0.4292275574112735
2197,Pickens,1925,7,241,1259,1918,1925,1.0,0.0036363636363636364,0.9963636363636363,425,0.1251948051948052,0.6540259740259741,0.22077922077922077
2198,Pickens,980,7,59,491,973,980,1.0,0.007142857142857143,0.9928571428571429,430,0.06020408163265306,0.5010204081632653,0.4387755102040816
2199,Pickens,2492,15,337,1240,2477,2492,1.0,0.006019261637239166,0.9939807383627608,915,0.13523274478330657,0.49759229534510435,0.3671749598715891
2200,Pickens,1382,2,101,755,1380,1382,1.0,0.001447178002894356,0.9985528219971056,526,0.07308248914616498,0.5463096960926194,0.38060781476121563
2201,Pickens,803,2,38,442,801,803,1.0,0.0024906600249066002,0.9975093399750934,323,0.047322540473225407,0.5504358655043586,0.40224159402241594
2202,Pickens,1580,6,151,866,1574,1580,1.0,0.0037974683544303796,0.9962025316455696,563,0.09556962025316455,0.5481012658227848,0.35632911392405064
2203,Pickens,3359,16,238,1499,3343,3359,1.0,0.004763322417386127,0.9952366775826139,1622,0.07085442095861863,0.4462637689788628,0.4828818100625186
2204,Pickens,2780,13,474,1586,2767,2780,1.0,0.004676258992805755,0.9953237410071942,720,0.17050359712230215,0.5705035971223021,0.2589928057553957
2205,Pickens,1852,10,131,1086,1842,1852,1.0,0.005399568034557235,0.9946004319654428,635,0.07073434125269978,0.5863930885529157,0.34287257019438444
2206,Pickens,2964,11,224,1654,2953,2964,1.0,0.003711201079622132,0.9962887989203779,1086,0.07557354925775979,0.558029689608637,0.36639676113360325
2207,Pickens,4287,9,583,2061,4278,4287,1.0,0.002099370188943317,0.9979006298110566,1643,0.13599253557266153,0.4807557732680196,0.3832516911593189
2208,Pierce,1100,7,55,602,1093,1100,1.0,0.006363636363636364,0.9936363636363637,443,0.05,0.5472727272727272,0.4027272727272727
2209,Pierce,3865,7,226,1969,3858,3865,1.0,0.0018111254851228978,0.9981888745148771,1670,0.05847347994825356,0.5094437257438551,0.4320827943078913
2210,Pierce,4024,23,478,1898,4001,4024,1.0,0.005715705765407555,0.9942842942345924,1648,0.11878727634194831,0.4716699801192843,0.4095427435387674
2211,Pierce,465,0,25,337,465,465,1.0,0.0,1.0,103,0.053763440860215055,0.7247311827956989,0.221505376344086
2212,Pierce,1674,5,80,935,1669,1674,1.0,0.002986857825567503,0.9970131421744325,659,0.04778972520908005,0.5585424133811231,0.39366786140979687
2213,Pierce,1637,5,131,821,1632,1637,1.0,0.0030543677458766036,0.9969456322541234,685,0.08002443494196701,0.5015271838729383,0.4184483811850947
2214,Pierce,1857,8,101,1113,1849,1857,1.0,0.004308023694130318,0.9956919763058697,643,0.05438879913839526,0.5993537964458805,0.3462574044157243
2215,Pierce,277,0,4,224,277,277,1.0,0.0,1.0,49,0.01444043321299639,0.8086642599277978,0.17689530685920576
2216,Pike,1423,2,246,881,1421,1423,1.0,0.0014054813773717498,0.9985945186226283,296,0.17287420941672524,0.6191145467322557,0.20801124385101896
2217,Pike,1758,3,113,1277,1755,1758,1.0,0.0017064846416382253,0.9982935153583617,368,0.06427758816837315,0.7263936291240045,0.20932878270762229
2218,Pike,1193,0,104,771,1193,1193,1.0,0.0,1.0,318,0.08717518860016764,0.6462699077954736,0.26655490360435874
2219,Pike,1386,2,103,907,1384,1386,1.0,0.001443001443001443,0.9985569985569985,376,0.07431457431457432,0.6544011544011544,0.2712842712842713
2220,Pike,1559,6,181,980,1553,1559,1.0,0.003848620910840282,0.9961513790891597,398,0.11610006414368185,0.6286080821039127,0.2552918537524054
2221,Pike,2681,7,243,1799,2674,2681,1.0,0.0026109660574412533,0.9973890339425587,639,0.09063782170831779,0.6710182767624021,0.23834390152928012
2222,Pike,1727,1,160,1244,1726,1727,1.0,0.0005790387955993051,0.9994209612044007,323,0.09264620729588882,0.7203242617255357,0.18702953097857555
2223,Pike,2610,3,355,1268,2607,2610,1.0,0.0011494252873563218,0.9988505747126437,987,0.1360153256704981,0.48582375478927203,0.3781609195402299
2224,Polk,4008,9,386,1926,3999,4008,1.0,0.002245508982035928,0.9977544910179641,1696,0.09630738522954092,0.4805389221556886,0.4231536926147705
2225,Polk,2102,11,187,966,2091,2102,1.0,0.005233111322549952,0.99476688867745,949,0.0889628924833492,0.45956232159847765,0.4514747859181732
2226,Polk,10053,124,1331,2783,9929,10053,1.0,0.012334626479657813,0.9876653735203422,5939,0.1323982890679399,0.2768327862329653,0.5907689246990948
2227,Polk,3149,1,294,1584,3148,3149,1.0,0.00031756113051762465,0.9996824388694824,1271,0.09336297237218165,0.5030168307399174,0.4036201968879009
2228,Polk,3229,11,306,1901,3218,3229,1.0,0.0034066274388355527,0.9965933725611644,1022,0.09476618148033447,0.5887271601114896,0.3165066584081759
2229,Polk,7180,32,989,3178,7148,7180,1.0,0.004456824512534819,0.9955431754874652,3013,0.13774373259052924,0.44261838440111423,0.4196378830083565
2230,Polk,2517,12,165,1251,2505,2517,1.0,0.004767580452920143,0.9952324195470799,1101,0.06555423122765197,0.4970202622169249,0.4374255065554231
2231,Pulaski,8012,13,1217,2805,7999,8012,1.0,0.0016225661507738391,0.9983774338492262,3990,0.1518971542685971,0.350099850224663,0.4980029955067399
2232,Putnam,3979,26,991,1216,3953,3979,1.0,0.006534305101784368,0.9934656948982157,1772,0.24905755214878111,0.30560442322191506,0.44533802462930383
2233,Putnam,4067,10,1148,1181,4057,4067,1.0,0.0024588148512417014,0.9975411851487583,1738,0.2822719449225473,0.29038603393164497,0.4273420211458077
2234,Putnam,3926,13,558,2472,3913,3926,1.0,0.0033112582781456954,0.9966887417218543,896,0.14212939378502293,0.6296484971981661,0.228222109016811
2235,Putnam,1450,6,160,843,1444,1450,1.0,0.004137931034482759,0.9958620689655172,447,0.1103448275862069,0.5813793103448276,0.3082758620689655
2236,Putnam,4425,17,591,2579,4408,4425,1.0,0.0038418079096045198,0.9961581920903955,1255,0.1335593220338983,0.5828248587570621,0.28361581920903955
2237,Quitman,1763,10,467,565,1753,1763,1.0,0.005672149744753261,0.9943278502552467,731,0.26488939307997733,0.3204764605785593,0.4146341463414634
2238,Quitman,107,3,30,39,104,107,1.0,0.028037383177570093,0.9719626168224299,38,0.2803738317757009,0.3644859813084112,0.35514018691588783
2239,Rabun,13767,53,1984,7474,13714,13767,1.0,0.003849785719474105,0.9961502142805259,4309,0.14411273334786082,0.5428924239122539,0.31299484273988526
2240,Randolph,309,0,77,179,309,309,1.0,0.0,1.0,53,0.24919093851132687,0.5792880258899676,0.1715210355987055
2241,Randolph,256,1,80,90,255,256,1.0,0.00390625,0.99609375,86,0.3125,0.3515625,0.3359375
2242,Randolph,466,5,225,11,461,466,1.0,0.01072961373390558,0.9892703862660944,230,0.48283261802575106,0.023605150214592276,0.49356223175965663
2243,Randolph,2681,4,833,690,2677,2681,1.0,0.0014919806042521448,0.9985080193957478,1158,0.31070496083550914,0.257366654233495,0.4319283849309959
2244,Randolph,940,1,331,358,939,940,1.0,0.0010638297872340426,0.9989361702127659,251,0.35212765957446807,0.38085106382978723,0.2670212765957447
2245,Randolph,325,1,125,63,324,325,1.0,0.003076923076923077,0.9969230769230769,137,0.38461538461538464,0.19384615384615383,0.42153846153846153
2246,Richmond,1043,2,355,294,1041,1043,1.0,0.0019175455417066154,0.9980824544582934,394,0.34036433365292423,0.28187919463087246,0.37775647171620325
2247,Richmond,2152,10,483,160,2142,2152,1.0,0.004646840148698885,0.9953531598513011,1509,0.22444237918215612,0.07434944237918216,0.7012081784386617
2248,Richmond,1657,1,752,26,1656,1657,1.0,0.0006035003017501509,0.9993964996982498,879,0.45383222691611347,0.015691007845503924,0.5304767652383826
2249,Richmond,3024,0,1540,109,3024,3024,1.0,0.0,1.0,1375,0.5092592592592593,0.036044973544973546,0.4546957671957672
2250,Richmond,1387,3,511,34,1384,1387,1.0,0.0021629416005767843,0.9978370583994232,842,0.3684210526315789,0.024513338139870222,0.6070656092285508
2251,Richmond,1241,12,384,125,1229,1241,1.0,0.009669621273166801,0.9903303787268332,732,0.30942788074133765,0.10072522159548751,0.5898468976631749
2252,Richmond,1994,6,697,578,1988,1994,1.0,0.003009027081243731,0.9969909729187563,719,0.34954864593781343,0.28986960882647944,0.36058174523570713
2253,Richmond,498,2,287,40,496,498,1.0,0.004016064257028112,0.9959839357429718,171,0.5763052208835341,0.08032128514056225,0.3433734939759036
2254,Richmond,1522,1,515,98,1521,1522,1.0,0.000657030223390276,0.9993429697766097,909,0.3383705650459921,0.06438896189224705,0.5972404730617609
2255,Richmond,1657,0,704,184,1657,1657,1.0,0.0,1.0,769,0.4248642124321062,0.11104405552202776,0.464091732045866
2256,Richmond,1476,7,336,202,1469,1476,1.0,0.0047425474254742545,0.9952574525745257,938,0.22764227642276422,0.13685636856368563,0.6355013550135501
2257,Richmond,883,0,385,56,883,883,1.0,0.0,1.0,442,0.4360135900339751,0.06342015855039637,0.5005662514156285
2258,Richmond,751,6,146,108,745,751,1.0,0.007989347536617843,0.9920106524633822,497,0.19440745672436752,0.14380825565912117,0.6617842876165113
2259,Richmond,1560,0,749,34,1560,1560,1.0,0.0,1.0,777,0.48012820512820514,0.021794871794871794,0.4980769230769231
2260,Richmond,5254,6,1790,727,5248,5254,1.0,0.0011419870574800152,0.99885801294252,2737,0.34069280548153785,0.1383707651313285,0.5209364293871336
2261,Richmond,1057,0,526,11,1057,1057,1.0,0.0,1.0,520,0.49763481551561023,0.010406811731315043,0.49195837275307475
2262,Richmond,1998,4,563,510,1994,1998,1.0,0.002002002002002002,0.997997997997998,925,0.28178178178178176,0.2552552552552553,0.46296296296296297
2263,Richmond,2737,12,1221,151,2725,2737,1.0,0.004384362440628425,0.9956156375593715,1365,0.44610887833394225,0.05516989404457435,0.49872122762148335
2264,Richmond,3144,7,1192,241,3137,3144,1.0,0.0022264631043256997,0.9977735368956743,1711,0.3791348600508906,0.07665394402035623,0.5442111959287532
2265,Richmond,2251,5,823,149,2246,2251,1.0,0.002221235006663705,0.9977787649933363,1279,0.36561528209684585,0.06619280319857841,0.5681919147045758
2266,Richmond,2565,3,761,1154,2562,2565,1.0,0.0011695906432748538,0.9988304093567252,650,0.29668615984405455,0.4499025341130604,0.253411306042885
2267,Richmond,1583,5,470,135,1578,1583,1.0,0.003158559696778269,0.9968414403032217,978,0.2969046114971573,0.08528111181301326,0.6178142766898295
2268,Richmond,1424,3,359,779,1421,1424,1.0,0.002106741573033708,0.9978932584269663,286,0.2521067415730337,0.5470505617977528,0.20084269662921347
2269,Richmond,373,2,112,158,371,373,1.0,0.005361930294906166,0.9946380697050938,103,0.3002680965147453,0.42359249329758714,0.2761394101876676
2270,Richmond,401,1,101,276,400,401,1.0,0.0024937655860349127,0.9975062344139651,24,0.2518703241895262,0.6882793017456359,0.059850374064837904
2271,Richmond,5588,17,1681,867,5571,5588,1.0,0.003042233357193987,0.996957766642806,3040,0.300823192555476,0.15515390121689335,0.5440229062276306
2272,Richmond,1908,6,472,702,1902,1908,1.0,0.0031446540880503146,0.9968553459119497,734,0.24737945492662475,0.36792452830188677,0.38469601677148846
2273,Richmond,949,1,235,152,948,949,1.0,0.001053740779768177,0.9989462592202318,562,0.2476290832455216,0.1601685985247629,0.5922023182297155
2274,Richmond,3502,18,2135,307,3484,3502,1.0,0.005139920045688178,0.9948600799543118,1060,0.6096516276413478,0.08766419189034837,0.3026841804683038
2275,Richmond,6973,26,2736,801,6947,6973,1.0,0.003728667718342177,0.9962713322816579,3436,0.3923705722070845,0.11487164778431092,0.4927577800086046
2276,Richmond,2058,0,1424,94,2058,2058,1.0,0.0,1.0,540,0.6919339164237124,0.0456754130223518,0.26239067055393583
2277,Richmond,7621,18,1495,189,7603,7621,1.0,0.0023618947644666053,0.9976381052355334,5937,0.19616848182653196,0.024799895026899357,0.7790316231465687
2278,Richmond,1953,3,1030,142,1950,1953,1.0,0.0015360983102918587,0.9984639016897081,781,0.5273937532002048,0.07270865335381464,0.3998975934459805
2279,Richmond,4333,18,2917,264,4315,4333,1.0,0.004154165705054235,0.9958458342949458,1152,0.6732056312024002,0.060927763674128776,0.26586660512347104
2280,Richmond,3054,17,2130,205,3037,3054,1.0,0.005566470203012442,0.9944335297969875,719,0.6974459724950884,0.06712508185985593,0.23542894564505568
2281,Richmond,3586,2,1861,269,3584,3586,1.0,0.0005577244841048522,0.9994422755158952,1456,0.518962632459565,0.07501394311210262,0.4060234244283324
2282,Richmond,4354,29,2296,249,4325,4354,1.0,0.00666054203031695,0.993339457969683,1809,0.5273311897106109,0.05718879191548002,0.4154800183739091
2283,Richmond,4444,10,2061,363,4434,4444,1.0,0.0022502250225022503,0.9977497749774977,2020,0.46377137713771377,0.08168316831683169,0.45454545454545453
2284,Richmond,3186,15,909,336,3171,3186,1.0,0.004708097928436911,0.995291902071563,1941,0.2853107344632768,0.10546139359698682,0.6092278719397364
2285,Richmond,480,8,162,69,472,480,1.0,0.016666666666666666,0.9833333333333333,249,0.3375,0.14375,0.51875
2286,Richmond,1352,8,487,147,1344,1352,1.0,0.005917159763313609,0.9940828402366864,718,0.36020710059171596,0.10872781065088757,0.5310650887573964
2287,Richmond,2152,11,1248,197,2141,2152,1.0,0.005111524163568773,0.9948884758364313,707,0.5799256505576208,0.09154275092936803,0.32853159851301117
2288,Richmond,4985,41,1693,523,4944,4985,1.0,0.008224674022066199,0.9917753259779338,2769,0.33961885656970914,0.1049147442326981,0.5554663991975928
2289,Richmond,3855,21,1181,1038,3834,3855,1.0,0.005447470817120622,0.9945525291828794,1636,0.3063553826199741,0.26926070038910505,0.4243839169909209
2290,Richmond,2134,16,724,313,2118,2134,1.0,0.007497656982193065,0.9925023430178069,1097,0.3392689784442362,0.14667291471415184,0.514058106841612
2291,Richmond,4768,11,1508,755,4757,4768,1.0,0.002307046979865772,0.9976929530201343,2505,0.3162751677852349,0.15834731543624161,0.5253775167785235
2292,Richmond,1727,2,1145,80,1725,1727,1.0,0.0011580775911986102,0.9988419224088014,502,0.6629994209612045,0.04632310364794441,0.2906774753908512
2293,Richmond,1564,6,420,590,1558,1564,1.0,0.0038363171355498722,0.9961636828644501,554,0.26854219948849106,0.3772378516624041,0.35421994884910485
2294,Richmond,2368,0,710,1087,2368,2368,1.0,0.0,1.0,571,0.2998310810810811,0.45903716216216217,0.24113175675675674
2295,Richmond,2193,10,530,852,2183,2193,1.0,0.004559963520291838,0.9954400364797081,811,0.2416780665754674,0.38850889192886456,0.369813041495668
2296,Richmond,6123,14,1647,1189,6109,6123,1.0,0.002286460885187,0.997713539114813,3287,0.2689857912787849,0.19418585660623877,0.5368283521149764
2297,Richmond,2535,3,732,928,2532,2535,1.0,0.001183431952662722,0.9988165680473373,875,0.28875739644970416,0.3660749506903353,0.34516765285996054
2298,Richmond,3843,13,972,1451,3830,3843,1.0,0.0033827738745771533,0.9966172261254228,1420,0.2529274004683841,0.3775696070778038,0.36950299245381213
2299,Richmond,3019,4,858,506,3015,3019,1.0,0.001324942033786022,0.998675057966214,1655,0.2842000662471017,0.16760516727393177,0.5481947664789666
2300,Richmond,437,0,73,161,437,437,1.0,0.0,1.0,203,0.16704805491990846,0.3684210526315789,0.4645308924485126
2301,Richmond,658,4,211,194,654,658,1.0,0.0060790273556231,0.993920972644377,253,0.32066869300911854,0.2948328267477204,0.3844984802431611
2302,Richmond,586,3,114,248,583,586,1.0,0.005119453924914676,0.9948805460750854,224,0.1945392491467577,0.4232081911262799,0.3822525597269625
2303,Richmond,531,8,92,276,523,531,1.0,0.015065913370998116,0.9849340866290018,163,0.17325800376647835,0.519774011299435,0.3069679849340866
2304,Richmond,3730,12,729,1344,3718,3730,1.0,0.0032171581769436996,0.9967828418230563,1657,0.19544235924932976,0.36032171581769434,0.44423592493297587
2305,Richmond,2028,1,77,32,2027,2028,1.0,0.0004930966469428008,0.9995069033530573,1919,0.03796844181459566,0.015779092702169626,0.9462524654832347
2306,Richmond,2162,7,808,567,2155,2162,1.0,0.0032377428307123032,0.9967622571692877,787,0.3737280296022202,0.2622571692876966,0.3640148011100833
2307,Richmond,2985,22,900,1001,2963,2985,1.0,0.007370184254606365,0.9926298157453937,1084,0.3015075376884422,0.3353433835845896,0.36314907872696817
2308,Richmond,835,6,379,166,829,835,1.0,0.00718562874251497,0.9928143712574851,290,0.4538922155688623,0.19880239520958085,0.3473053892215569
2309,Richmond,1243,8,329,495,1235,1243,1.0,0.006436041834271922,0.9935639581657281,419,0.26468222043443285,0.39823008849557523,0.337087691069992
2310,Richmond,1828,11,698,232,1817,1828,1.0,0.006017505470459519,0.9939824945295405,898,0.38183807439824946,0.12691466083150985,0.4912472647702407
2311,Richmond,2383,5,832,843,2378,2383,1.0,0.00209819555182543,0.9979018044481746,708,0.34913973982375157,0.35375577003776754,0.2971044901384809
2312,Richmond,832,2,586,45,830,832,1.0,0.002403846153846154,0.9975961538461539,201,0.7043269230769231,0.054086538461538464,0.24158653846153846
2313,Richmond,422,3,135,173,419,422,1.0,0.0071090047393364926,0.9928909952606635,114,0.31990521327014215,0.4099526066350711,0.27014218009478674
2314,Rockdale,4725,10,2204,1274,4715,4725,1.0,0.0021164021164021165,0.9978835978835979,1247,0.46645502645502646,0.2696296296296296,0.26391534391534394
2315,Rockdale,4331,14,1099,1600,4317,4331,1.0,0.0032325098129762178,0.9967674901870238,1632,0.2537520203186331,0.36942969291156774,0.3768182867697991
2316,Rockdale,4458,20,1714,453,4438,4458,1.0,0.004486316733961417,0.9955136832660386,2291,0.3844773441004935,0.1016150740242261,0.5139075818752804
2317,Rockdale,6961,22,3672,609,6939,6961,1.0,0.0031604654503663266,0.9968395345496337,2680,0.5275104151702341,0.08748742996695877,0.3850021548628071
2318,Rockdale,3992,18,2198,571,3974,3992,1.0,0.0045090180360721445,0.9954909819639278,1223,0.5506012024048096,0.14303607214428857,0.3063627254509018
2319,Rockdale,3767,16,1611,835,3751,3767,1.0,0.004247411733474914,0.9957525882665251,1321,0.4276612689142554,0.22166179984072207,0.3506769312450226
2320,Rockdale,2485,5,968,762,2480,2485,1.0,0.002012072434607646,0.9979879275653923,755,0.38953722334004026,0.3066398390342052,0.3038229376257545
2321,Rockdale,3817,9,1798,1200,3808,3817,1.0,0.002357872674875557,0.9976421273251245,819,0.47105056326958344,0.3143830233167409,0.21456641341367566
2322,Rockdale,3477,11,1226,962,3466,3477,1.0,0.0031636468219729654,0.996836353178027,1289,0.3526028185217141,0.276675294794363,0.3707218866839229
2323,Rockdale,4836,8,2054,557,4828,4836,1.0,0.0016542597187758478,0.9983457402812241,2225,0.42473118279569894,0.11517783291976841,0.46009098428453266
2324,Rockdale,8101,25,3107,553,8076,8101,1.0,0.003086038760646834,0.9969139612393532,4441,0.3835328971731885,0.06826317738550797,0.5482039254413036
2325,Rockdale,4967,15,2339,834,4952,4967,1.0,0.0030199315482182403,0.9969800684517818,1794,0.4709079927521643,0.16790819408093416,0.36118381316690157
2326,Rockdale,4061,10,2326,763,4051,4061,1.0,0.002462447672986949,0.997537552327013,972,0.5727653287367643,0.1878847574489042,0.23934991381433143
2327,Rockdale,4795,18,2600,759,4777,4795,1.0,0.003753910323253389,0.9962460896767467,1436,0.5422314911366006,0.15828988529718457,0.2994786235662148
2328,Rockdale,3361,2,1473,929,3359,3361,1.0,0.0005950609937518596,0.9994049390062482,959,0.43826242189824455,0.2764058315977388,0.28533174650401666
2329,Rockdale,3369,33,855,351,3336,3369,1.0,0.009795191451469279,0.9902048085485308,2163,0.25378450578806766,0.10418521816562779,0.6420302760463046
2330,Schley,3328,1,462,1800,3327,3328,1.0,0.00030048076923076925,0.9996995192307693,1066,0.1388221153846154,0.5408653846153846,0.3203125
2331,Screven,1148,7,102,606,1141,1148,1.0,0.006097560975609756,0.9939024390243902,440,0.08885017421602788,0.5278745644599303,0.3832752613240418
2332,Screven,203,0,128,57,203,203,1.0,0.0,1.0,18,0.6305418719211823,0.28078817733990147,0.08866995073891626
2333,Screven,626,2,146,479,624,626,1.1927480916030535,0.003194888178913738,0.9968051118210862,1,0.23322683706070288,0.7651757188498403,0.001597444089456869
2334,Screven,944,4,286,327,940,944,1.0,0.00423728813559322,0.9957627118644068,331,0.3029661016949153,0.3463983050847458,0.350635593220339
2335,Screven,1084,0,128,228,1084,1084,1.0,0.0,1.0,728,0.11808118081180811,0.21033210332103322,0.6715867158671587
2336,Screven,359,0,84,209,359,359,1.0,0.0,1.0,66,0.233983286908078,0.5821727019498607,0.18384401114206128
2337,Screven,1186,6,402,386,1180,1186,1.0,0.00505902192242833,0.9949409780775716,398,0.33895446880269814,0.3254637436762226,0.33558178752107926
2338,Screven,1258,1,253,506,1257,1258,1.0,0.000794912559618442,0.9992050874403816,499,0.20111287758346583,0.40222575516693165,0.39666136724960255
2339,Screven,575,8,86,293,567,575,1.0,0.01391304347826087,0.9860869565217392,196,0.14956521739130435,0.5095652173913043,0.3408695652173913
2340,Screven,471,1,154,128,470,471,1.0,0.0021231422505307855,0.9978768577494692,189,0.32696390658174096,0.27176220806794055,0.4012738853503185
2341,Screven,1517,5,519,264,1512,1517,1.0,0.0032959789057350032,0.996704021094265,734,0.34212261041529335,0.17402768622280818,0.4838497033618985
2342,Screven,1624,3,373,433,1621,1624,1.0,0.0018472906403940886,0.9981527093596059,818,0.22967980295566504,0.2666256157635468,0.5036945812807881
2343,Seminole,1459,0,215,659,1459,1459,1.0,0.0,1.0,585,0.14736120630568883,0.4516792323509253,0.4009595613433859
2344,Seminole,1473,2,257,492,1471,1473,1.0,0.0013577732518669382,0.9986422267481331,724,0.17447386286490157,0.3340122199592668,0.49151391717583165
2345,Seminole,1289,0,530,89,1289,1289,1.0,0.0,1.0,670,0.41117145073700545,0.06904577191621412,0.5197827773467805
2346,Seminole,1344,2,155,619,1342,1344,1.0,0.001488095238095238,0.9985119047619048,570,0.11532738095238096,0.46056547619047616,0.42410714285714285
2347,Seminole,1712,3,97,752,1709,1712,1.0,0.0017523364485981308,0.9982476635514018,863,0.0566588785046729,0.4392523364485981,0.5040887850467289
2348,Spalding,2951,5,859,152,2946,2951,1.0,0.0016943409013893595,0.9983056590986107,1940,0.291087766858692,0.05150796340223653,0.6574042697390715
2349,Spalding,2259,14,844,116,2245,2259,1.0,0.00619743249225321,0.9938025675077468,1299,0.3736166445329792,0.051350154935812305,0.5750332005312085
2350,Spalding,2932,5,575,1516,2927,2932,1.0,0.0017053206002728514,0.9982946793997272,841,0.1961118690313779,0.5170532060027285,0.2868349249658936
2351,Spalding,4509,12,1190,875,4497,4509,1.0,0.0026613439787092482,0.9973386560212908,2444,0.26391661122200044,0.1940563317808827,0.5420270569971168
2352,Spalding,3098,13,952,292,3085,3098,1.0,0.004196255648805681,0.9958037443511943,1854,0.30729502905100065,0.09425435765009683,0.5984506132989025
2353,Spalding,1723,4,327,964,1719,1723,1.0,0.0023215322112594312,0.9976784677887406,432,0.1897852582704585,0.559489262913523,0.2507254788160186
2354,Spalding,1952,3,362,939,1949,1952,1.0,0.0015368852459016393,0.9984631147540983,651,0.18545081967213115,0.48104508196721313,0.33350409836065575
2355,Spalding,2124,10,206,1106,2114,2124,1.0,0.004708097928436911,0.995291902071563,812,0.09698681732580038,0.5207156308851224,0.3822975517890772
2356,Spalding,2506,6,537,910,2500,2506,1.0,0.0023942537909018356,0.9976057462090981,1059,0.21428571428571427,0.36312849162011174,0.42258579409417396
2357,Spalding,2733,6,615,1195,2727,2733,1.0,0.0021953896816684962,0.9978046103183315,923,0.22502744237102085,0.4372484449323088,0.33772411269667035
2358,Spalding,2433,6,279,1306,2427,2433,1.0,0.002466091245376079,0.9975339087546239,848,0.11467324290998766,0.5367858610768599,0.34854089601315247
2359,Spalding,2838,4,249,1445,2834,2838,1.0,0.0014094432699083862,0.9985905567300916,1144,0.08773784355179703,0.5091613812544045,0.40310077519379844
2360,Spalding,2614,11,364,817,2603,2614,1.0,0.004208110175975516,0.9957918898240244,1433,0.13925019127773527,0.31254781943381793,0.5482019892884469
2361,Spalding,5086,14,1755,849,5072,5086,1.0,0.0027526543452615023,0.9972473456547385,2482,0.3450648839952812,0.16692882422335825,0.4880062917813606
2362,Spalding,2332,23,397,755,2309,2332,1.0,0.00986277873070326,0.9901372212692967,1180,0.1702401372212693,0.3237564322469983,0.5060034305317325
2363,Spalding,2946,14,537,1334,2932,2946,1.0,0.0047522063815342835,0.9952477936184657,1075,0.18228105906313646,0.4528173794976239,0.36490156143923963
2364,Spalding,2360,12,238,1252,2348,2360,1.0,0.005084745762711864,0.9949152542372881,870,0.10084745762711865,0.5305084745762711,0.3686440677966102
2365,Spalding,4727,14,1498,2234,4713,4727,1.0,0.0029617093293843877,0.9970382906706157,995,0.3169028982441295,0.4726041887031944,0.21049291305267612
2366,Stephens,21163,75,2385,9368,21088,21163,1.0,0.0035439209941879697,0.996456079005812,9410,0.11269668761517743,0.44265935831403863,0.44464395407078394
2367,Stewart,288,0,125,83,288,288,1.0,0.0,1.0,80,0.4340277777777778,0.2881944444444444,0.2777777777777778
2368,Stewart,2612,7,478,292,2605,2612,1.0,0.002679938744257274,0.9973200612557427,1842,0.18300153139356815,0.11179173047473201,0.7052067381316999
2369,Stewart,229,0,78,81,229,229,1.0,0.0,1.0,70,0.3406113537117904,0.3537117903930131,0.3056768558951965
2370,Stewart,1488,4,501,345,1484,1488,1.0,0.002688172043010753,0.9973118279569892,642,0.33669354838709675,0.2318548387096774,0.4314516129032258
2371,Sumter,1810,0,416,770,1810,1810,1.0,0.0,1.0,624,0.22983425414364642,0.425414364640884,0.3447513812154696
2372,Sumter,843,2,216,227,841,843,1.0,0.002372479240806643,0.9976275207591934,400,0.25622775800711745,0.269276393831554,0.4744958481613286
2373,Sumter,1012,4,219,465,1008,1012,1.0,0.003952569169960474,0.9960474308300395,328,0.21640316205533597,0.45948616600790515,0.3241106719367589
2374,Sumter,520,3,87,268,517,520,1.0,0.0057692307692307696,0.9942307692307693,165,0.1673076923076923,0.5153846153846153,0.3173076923076923
2375,Sumter,4057,9,1357,368,4048,4057,1.0,0.002218387971407444,0.9977816120285925,2332,0.3344836085777668,0.09070741927532659,0.5748089721469066
2376,Sumter,4809,11,975,1091,4798,4809,1.0,0.0022873778332293615,0.9977126221667706,2743,0.20274485339987525,0.22686629236847577,0.570388854231649
2377,Sumter,3371,1,1437,296,3370,3371,1.0,0.0002966478789676654,0.9997033521210323,1638,0.42628300207653513,0.08780777217442895,0.4859092257490359
2378,Sumter,2037,9,614,728,2028,2037,1.0,0.004418262150220913,0.9955817378497791,695,0.3014236622484045,0.35738831615120276,0.34118802160039274
2379,Sumter,427,0,41,260,427,427,1.0,0.0,1.0,126,0.09601873536299765,0.6088992974238876,0.29508196721311475
2380,Sumter,1304,13,379,397,1291,1304,1.0,0.009969325153374233,0.9900306748466258,528,0.2906441717791411,0.3044478527607362,0.4049079754601227
2381,Sumter,2846,6,577,862,2840,2846,1.0,0.0021082220660576245,0.9978917779339423,1407,0.20274068868587491,0.30288123682361207,0.494378074490513
2382,Talbot,542,0,144,200,542,542,1.0,0.0,1.0,198,0.2656826568265683,0.36900369003690037,0.36531365313653136
2383,Talbot,1172,0,488,330,1172,1172,1.0,0.0,1.0,354,0.41638225255972694,0.2815699658703072,0.30204778156996587
2384,Talbot,485,1,217,158,484,485,1.0,0.002061855670103093,0.9979381443298969,110,0.44742268041237115,0.32577319587628867,0.2268041237113402
2385,Talbot,460,0,203,120,460,460,1.0,0.0,1.0,137,0.44130434782608696,0.2608695652173913,0.29782608695652174
2386,Talbot,522,2,256,189,520,522,1.0,0.0038314176245210726,0.9961685823754789,77,0.4904214559386973,0.3620689655172414,0.1475095785440613
2387,Talbot,854,1,517,123,853,854,1.0,0.00117096018735363,0.9988290398126464,214,0.6053864168618267,0.14402810304449648,0.2505854800936768
2388,Talbot,748,1,289,272,747,748,1.0,0.001336898395721925,0.9986631016042781,187,0.38636363636363635,0.36363636363636365,0.25
2389,Taliaferro,1037,2,447,289,1035,1037,1.0,0.0019286403085824494,0.9980713596914176,301,0.43105110896817744,0.2786885245901639,0.29026036644165865
2390,Taliaferro,252,0,114,71,252,252,1.0,0.0,1.0,67,0.4523809523809524,0.28174603174603174,0.26587301587301587
2391,Tattnall,999,10,99,436,989,999,1.0,0.01001001001001001,0.98998998998999,464,0.0990990990990991,0.4364364364364364,0.4644644644644645
2392,Tattnall,1652,6,227,783,1646,1652,1.0,0.0036319612590799033,0.9963680387409201,642,0.137409200968523,0.47397094430992737,0.38861985472154964
2393,Tattnall,3111,13,532,1073,3098,3111,1.0,0.004178720668595307,0.9958212793314047,1506,0.17100610736097718,0.34490517518482805,0.4840887174541948
2394,Tattnall,2929,6,512,1221,2923,2929,1.0,0.0020484807101399795,0.99795151928986,1196,0.17480368726527826,0.4168658245134858,0.4083304882212359
2395,Tattnall,1219,8,93,620,1211,1219,1.0,0.006562756357670222,0.9934372436423298,506,0.07629204265791632,0.5086136177194421,0.41509433962264153
2396,Tattnall,3090,12,365,1405,3078,3090,1.0,0.003883495145631068,0.996116504854369,1320,0.11812297734627832,0.4546925566343042,0.42718446601941745
2397,Tattnall,278,0,51,145,278,278,1.0,0.0,1.0,82,0.18345323741007194,0.5215827338129496,0.2949640287769784
2398,Tattnall,4376,10,182,370,4366,4376,1.0,0.0022851919561243145,0.9977148080438757,3824,0.041590493601462525,0.08455210237659963,0.8738574040219378
2399,Taylor,1255,1,555,119,1254,1255,1.0,0.0007968127490039841,0.999203187250996,581,0.44223107569721115,0.09482071713147411,0.46294820717131474
2400,Taylor,2644,6,252,1364,2638,2644,1.0,0.0022692889561270802,0.9977307110438729,1028,0.09531013615733737,0.5158850226928896,0.3888048411497731
2401,Taylor,2221,9,580,935,2212,2221,1.0,0.00405222872579919,0.9959477712742009,706,0.2611436289959478,0.42098153984691583,0.31787483115713644
2402,Telfair,2490,6,216,438,2484,2490,1.0,0.0024096385542168677,0.9975903614457832,1836,0.08674698795180723,0.17590361445783131,0.7373493975903614
2403,Telfair,720,4,95,351,716,720,1.0,0.005555555555555556,0.9944444444444445,274,0.13194444444444445,0.4875,0.38055555555555554
2404,Telfair,1217,2,334,386,1215,1217,1.0,0.0016433853738701725,0.9983566146261298,497,0.2744453574363188,0.3171733771569433,0.40838126540673786
2405,Telfair,4465,13,715,893,4452,4465,1.0,0.0029115341545352742,0.9970884658454647,2857,0.1601343784994401,0.2,0.6398656215005599
2406,Telfair,929,0,73,558,929,929,1.0,0.0,1.0,298,0.07857911733046287,0.6006458557588805,0.3207750269106566
2407,Telfair,369,0,54,199,369,369,1.0,0.0,1.0,116,0.14634146341463414,0.5392953929539296,0.3143631436314363
2408,Terrell,777,0,281,315,777,777,1.0,0.0,1.0,181,0.36164736164736166,0.40540540540540543,0.23294723294723294
2409,Terrell,3630,9,1434,439,3621,3630,1.0,0.0024793388429752068,0.9975206611570248,1757,0.3950413223140496,0.1209366391184573,0.4840220385674931
2410,Terrell,661,0,146,289,661,661,1.0,0.0,1.0,226,0.22087745839636913,0.4372163388804841,0.34190620272314676
2411,Terrell,272,1,91,118,271,272,1.0,0.003676470588235294,0.9963235294117647,63,0.33455882352941174,0.4338235294117647,0.23161764705882354
2412,Terrell,480,0,114,206,480,480,1.0,0.0,1.0,160,0.2375,0.42916666666666664,0.3333333333333333
2413,Terrell,1384,1,310,637,1383,1384,1.0,0.000722543352601156,0.9992774566473989,437,0.2239884393063584,0.4602601156069364,0.3157514450867052
2414,Thomas,735,5,103,380,730,735,1.0,0.006802721088435374,0.9931972789115646,252,0.1401360544217687,0.5170068027210885,0.34285714285714286
2415,Thomas,1900,11,546,592,1889,1900,1.0,0.005789473684210527,0.9942105263157894,762,0.2873684210526316,0.31157894736842107,0.4010526315789474
2416,Thomas,4052,12,850,1719,4040,4052,1.0,0.0029615004935834156,0.9970384995064165,1483,0.20977295162882528,0.42423494570582426,0.3659921026653504
2417,Thomas,1193,10,162,561,1183,1193,1.0,0.008382229673093043,0.991617770326907,470,0.1357921207041073,0.4702430846605197,0.393964794635373
2418,Thomas,2981,6,1211,263,2975,2981,1.0,0.0020127474002012745,0.9979872525997987,1507,0.40623951694062393,0.08822542770882254,0.5055350553505535
2419,Thomas,1204,2,182,730,1202,1204,1.0,0.0016611295681063123,0.9983388704318937,292,0.1511627906976744,0.606312292358804,0.2425249169435216
2420,Thomas,1521,8,324,798,1513,1521,1.0,0.005259697567389875,0.9947403024326101,399,0.21301775147928995,0.52465483234714,0.26232741617357
2421,Thomas,2463,13,408,1157,2450,2463,1.0,0.005278116118554608,0.9947218838814454,898,0.1656516443361754,0.4697523345513601,0.3645960211124645
2422,Thomas,2232,1,999,300,2231,2232,1.0,0.00044802867383512545,0.9995519713261649,933,0.4475806451612903,0.13440860215053763,0.41801075268817206
2423,Thomas,2128,7,580,883,2121,2128,1.0,0.003289473684210526,0.9967105263157895,665,0.2725563909774436,0.4149436090225564,0.3125
2424,Thomas,1055,3,239,344,1052,1055,1.0,0.002843601895734597,0.9971563981042654,472,0.22654028436018958,0.32606635071090045,0.44739336492890996
2425,Thomas,867,8,133,368,859,867,1.0,0.00922722029988466,0.9907727797001153,366,0.15340253748558247,0.4244521337946944,0.42214532871972316
2426,Thomas,357,1,64,163,356,357,1.0,0.0028011204481792717,0.9971988795518207,130,0.1792717086834734,0.4565826330532213,0.3641456582633053
2427,Thomas,2503,8,412,1160,2495,2503,1.0,0.0031961646024770275,0.9968038353975229,931,0.16460247702756692,0.463443867359169,0.3719536556132641
2428,Thomas,1502,16,149,684,1486,1502,1.0,0.010652463382157125,0.9893475366178429,669,0.09920106524633822,0.45539280958721706,0.44540612516644473
2429,Thomas,483,7,58,251,476,483,1.0,0.014492753623188406,0.9855072463768116,174,0.12008281573498965,0.5196687370600414,0.36024844720496896
2430,Thomas,849,2,90,401,847,849,1.0,0.002355712603062426,0.9976442873969376,358,0.10600706713780919,0.4723203769140165,0.4216725559481743
2431,Thomas,2669,2,635,973,2667,2669,1.0,0.0007493443237167478,0.9992506556762832,1061,0.23791682278006743,0.3645560134881978,0.39752716373173475
2432,Thomas,1526,6,811,71,1520,1526,1.0,0.003931847968545216,0.9960681520314548,644,0.5314547837483617,0.04652686762778506,0.42201834862385323
2433,Thomas,2817,11,752,1156,2806,2817,1.0,0.0039048633297834577,0.9960951366702165,909,0.26695065672701457,0.4103656372026979,0.3226837060702875
2434,Tift,2378,4,304,1480,2374,2378,1.0,0.001682085786375105,0.9983179142136249,594,0.127838519764508,0.6223717409587889,0.24978973927670312
2435,Tift,2072,2,162,882,2070,2072,1.0,0.0009652509652509653,0.999034749034749,1028,0.07818532818532818,0.42567567567567566,0.49613899613899615
2436,Tift,1438,0,158,899,1438,1438,1.0,0.0,1.0,381,0.10987482614742698,0.625173852573018,0.26495132127955495
2437,Tift,1081,4,90,756,1077,1081,1.0,0.0037002775208140612,0.996299722479186,235,0.08325624421831637,0.6993524514338575,0.21739130434782608
2438,Tift,1581,5,111,771,1576,1581,1.0,0.0031625553447185324,0.9968374446552815,699,0.07020872865275142,0.4876660341555977,0.44212523719165087
2439,Tift,3405,15,1174,272,3390,3405,1.0,0.004405286343612335,0.9955947136563876,1959,0.3447870778267254,0.07988252569750368,0.5753303964757709
2440,Tift,1427,1,129,403,1426,1427,1.0,0.000700770847932726,0.9992992291520673,895,0.09039943938332165,0.28241065171688856,0.6271899088997898
2441,Tift,4307,9,701,1344,4298,4307,1.0,0.0020896215463199444,0.99791037845368,2262,0.16275830044114234,0.3120501509171117,0.525191548641746
2442,Tift,4546,27,818,1291,4519,4546,1.0,0.005939287285525737,0.9940607127144743,2437,0.17993840739111305,0.2839859216893973,0.5360756709194897
2443,Tift,4848,10,685,1637,4838,4848,1.0,0.0020627062706270625,0.9979372937293729,2526,0.1412953795379538,0.33766501650165015,0.5210396039603961
2444,Tift,2738,6,783,409,2732,2738,1.0,0.002191380569758948,0.997808619430241,1546,0.28597516435354275,0.1493791088385683,0.5646457268078889
2445,Tift,1403,3,207,640,1400,1403,1.0,0.0021382751247327157,0.9978617248752673,556,0.14754098360655737,0.45616535994297935,0.39629365645046327
2446,Toombs,5205,11,597,1656,5194,5205,1.0,0.0021133525456292026,0.9978866474543708,2952,0.11469740634005764,0.31815561959654176,0.5671469740634005
2447,Toombs,1757,12,109,946,1745,1757,1.0,0.006829823562891292,0.9931701764371087,702,0.062037564029595905,0.5384177575412635,0.3995446784291406
2448,Toombs,1772,6,72,908,1766,1772,1.0,0.003386004514672686,0.9966139954853274,792,0.040632054176072234,0.5124153498871332,0.4469525959367946
2449,Toombs,6561,30,1271,2709,6531,6561,1.0,0.004572473708276178,0.9954275262917238,2581,0.19372046944063406,0.41289437585733885,0.3933851547020271
2450,Toombs,4966,9,890,1653,4957,4966,1.0,0.0018123238018525976,0.9981876761981474,2423,0.1792186870720902,0.3328634716069271,0.4879178413209827
2451,Towns,4439,6,523,2162,4433,4439,1.0,0.0013516557783284523,0.9986483442216716,1754,0.11781932867763009,0.48704663212435234,0.3951340391980176
2452,Towns,3016,7,477,2299,3009,3016,1.0,0.0023209549071618036,0.9976790450928382,240,0.15815649867374004,0.7622679045092838,0.07957559681697612
2453,Towns,3461,7,550,1923,3454,3461,1.0,0.0020225368390638545,0.9979774631609362,988,0.15891360878358857,0.555619763074256,0.28546662814215545
2454,Treutlen,2163,11,133,1300,2152,2163,1.0,0.005085529357374018,0.994914470642626,730,0.061488673139158574,0.6010171058714748,0.3374942209893666
2455,Treutlen,2771,5,819,801,2766,2771,1.0,0.001804402742692169,0.9981955972573078,1151,0.29556116925297726,0.2890653193792855,0.41537351136773726
2456,Troup,5234,12,1423,645,5222,5234,1.0,0.0022927015666794038,0.9977072984333206,3166,0.2718761941153993,0.12323270920901797,0.6048910966755827
2457,Troup,3429,7,443,1958,3422,3429,1.0,0.002041411490230388,0.9979585885097696,1028,0.12919218431029456,0.5710119568387285,0.299795858850977
2458,Troup,3016,10,886,1195,3006,3016,1.0,0.0033156498673740055,0.996684350132626,935,0.2937665782493369,0.39622015915119363,0.3100132625994695
2459,Troup,2106,1,357,991,2105,2106,1.0,0.0004748338081671415,0.9995251661918328,758,0.16951566951566951,0.47056030389363723,0.3599240265906933
2460,Troup,2927,8,1153,94,2919,2927,1.0,0.0027331738981892723,0.9972668261018107,1680,0.39391868807652886,0.03211479330372395,0.5739665186197472
2461,Troup,5920,25,1709,1025,5895,5920,1.0,0.004222972972972973,0.995777027027027,3186,0.2886824324324324,0.17314189189189189,0.5381756756756757
2462,Troup,2069,2,605,511,2067,2069,1.0,0.0009666505558240696,0.9990333494441759,953,0.29241179313678106,0.24697921701304978,0.4606089898501692
2463,Troup,3893,14,857,1817,3879,3893,1.0,0.0035961983046493705,0.9964038016953506,1219,0.22013871050603648,0.4667351656819933,0.3131261238119702
2464,Troup,4437,5,707,1997,4432,4437,1.0,0.001126887536623845,0.9988731124633762,1733,0.15934189767861168,0.4500788821275637,0.3905792201938247
2465,Troup,3610,17,626,1772,3593,3610,1.0,0.004709141274238227,0.9952908587257617,1212,0.17340720221606648,0.49085872576177286,0.33573407202216066
2466,Troup,3950,8,629,2132,3942,3950,1.0,0.0020253164556962027,0.9979746835443037,1189,0.15924050632911393,0.5397468354430379,0.3010126582278481
2468,Troup,3190,7,791,1042,3183,3190,1.0,0.00219435736677116,0.9978056426332288,1357,0.24796238244514107,0.3266457680250784,0.42539184952978054
2469,Troup,4377,6,561,2515,4371,4377,1.0,0.0013708019191226869,0.9986291980808774,1301,0.1281699794379712,0.5745944710989263,0.2972355494631026
2470,Troup,2468,9,831,449,2459,2468,1.0,0.003646677471636953,0.9963533225283631,1188,0.336709886547812,0.18192868719611022,0.4813614262560778
2471,Turner,4358,1,1217,1025,4357,4358,1.0,0.0002294630564479119,0.9997705369435521,2116,0.2792565396971088,0.2351996328591097,0.48554382744378155
2472,Turner,574,0,45,289,574,574,1.0,0.0,1.0,240,0.078397212543554,0.5034843205574913,0.4181184668989547
2473,Turner,2028,0,148,1035,2028,2028,1.0,0.0,1.0,845,0.07297830374753451,0.5103550295857988,0.4166666666666667
2474,Twiggs,1747,12,190,781,1735,1747,1.0,0.006868918145392101,0.9931310818546079,776,0.10875787063537493,0.4470520892959359,0.4441900400686892
2475,Twiggs,1799,5,687,484,1794,1799,1.0,0.0027793218454697055,0.9972206781545303,628,0.3818788215675375,0.26903835464146747,0.349082823790995
2476,Twiggs,821,1,151,410,820,821,1.0,0.001218026796589525,0.9987819732034104,260,0.18392204628501826,0.4993909866017052,0.3166869671132765
2477,Twiggs,1441,1,710,401,1440,1441,1.0,0.0006939625260235947,0.9993060374739764,330,0.49271339347675225,0.2782789729354615,0.22900763358778625
2478,Twiggs,781,3,306,294,778,781,1.0,0.0038412291933418692,0.9961587708066582,181,0.39180537772087065,0.3764404609475032,0.23175416133162613
2479,Union,3082,6,355,1518,3076,3082,1.0,0.001946787800129786,0.9980532121998702,1209,0.11518494484101233,0.4925373134328358,0.3922777417261519
2480,Union,1225,8,199,908,1217,1225,1.0,0.006530612244897959,0.9934693877551021,118,0.16244897959183674,0.7412244897959184,0.0963265306122449
2481,Union,2659,6,268,1575,2653,2659,1.0,0.0022564874012786762,0.9977435125987213,816,0.10078977059044754,0.5923279428356525,0.3068822865739
2482,Union,1548,9,260,950,1539,1548,1.0,0.005813953488372093,0.9941860465116279,338,0.16795865633074936,0.6136950904392765,0.21834625322997417
2483,Union,2252,8,277,1429,2244,2252,1.0,0.003552397868561279,0.9964476021314387,546,0.12300177619893428,0.6345470692717584,0.2424511545293073
2484,Union,2224,6,267,1400,2218,2224,1.0,0.002697841726618705,0.9973021582733813,557,0.12005395683453238,0.6294964028776978,0.2504496402877698
2485,Union,2047,4,276,1342,2043,2047,1.0,0.0019540791402051783,0.9980459208597948,429,0.1348314606741573,0.6555935515388374,0.20957498778700537
2486,Union,1485,3,258,962,1482,1485,1.0,0.00202020202020202,0.997979797979798,265,0.17373737373737375,0.6478114478114478,0.17845117845117844
2487,Union,2322,15,368,1488,2307,2322,1.0,0.006459948320413436,0.9935400516795866,466,0.15848406546080965,0.6408268733850129,0.20068906115417742
2488,Union,648,4,93,381,644,648,1.0,0.006172839506172839,0.9938271604938271,174,0.14351851851851852,0.5879629629629629,0.26851851851851855
2489,Union,1323,6,180,698,1317,1323,1.0,0.0045351473922902496,0.9954648526077098,445,0.1360544217687075,0.527588813303099,0.3363567649281935
2490,Upson,9751,33,1280,4717,9718,9751,1.0,0.0033842682801763922,0.9966157317198236,3754,0.1312685878371449,0.48374525689672854,0.38498615526612656
2491,Upson,354,0,266,44,354,354,1.0,0.0,1.0,44,0.751412429378531,0.12429378531073447,0.12429378531073447
2492,Upson,10056,28,2405,3064,10028,10056,1.0,0.0027844073190135244,0.9972155926809865,4587,0.2391607000795545,0.3046937151949085,0.456145584725537
2493,Upson,1550,9,250,783,1541,1550,1.0,0.005806451612903226,0.9941935483870967,517,0.16129032258064516,0.5051612903225806,0.3335483870967742
2494,Walker,1625,3,164,885,1622,1625,1.0,0.0018461538461538461,0.9981538461538462,576,0.10092307692307692,0.5446153846153846,0.35446153846153844
2495,Walker,7336,13,996,3442,7323,7336,1.0,0.001772082878953108,0.9982279171210469,2898,0.13576881134133043,0.4691930207197383,0.3950381679389313
2496,Walker,7731,28,846,4089,7703,7731,1.0,0.0036217824343551933,0.9963782175656448,2796,0.10942956926658906,0.5289095847885138,0.36166084594489717
2497,Walker,4085,22,418,1449,4063,4085,1.0,0.005385556915544675,0.9946144430844553,2218,0.10232558139534884,0.3547123623011016,0.5429620563035495
2498,Walker,1197,1,321,593,1196,1197,1.0,0.000835421888053467,0.9991645781119465,283,0.2681704260651629,0.4954051796157059,0.23642439431913115
2499,Walker,1544,5,199,751,1539,1544,1.0,0.003238341968911917,0.9967616580310881,594,0.12888601036269431,0.48639896373056996,0.38471502590673573
2500,Walker,8443,44,832,3325,8399,8443,1.0,0.005211417742508587,0.9947885822574914,4286,0.09854317185834419,0.3938173634963875,0.5076394646452683
2501,Walker,1544,3,178,714,1541,1544,1.0,0.0019430051813471502,0.9980569948186528,652,0.11528497409326424,0.46243523316062174,0.422279792746114
2502,Walker,7685,5,700,3831,7680,7685,1.0,0.0006506180871828237,0.9993493819128172,3154,0.09108653220559532,0.4985035783994795,0.4104098893949252
2503,Walker,8897,41,943,2710,8856,8897,1.0,0.004608294930875576,0.9953917050691244,5244,0.10599078341013825,0.30459705518714175,0.58941216140272
2504,Walker,2707,5,172,1385,2702,2707,1.0,0.001847063169560399,0.9981529368304396,1150,0.06353897303287773,0.5116364979682305,0.4248245289988918
2505,Walton,3329,16,498,2064,3313,3329,1.0,0.004806248122559327,0.9951937518774406,767,0.14959447281465907,0.6200060078101532,0.23039951937518774
2506,Walton,4827,5,763,3113,4822,4827,1.0,0.0010358400662937642,0.9989641599337062,951,0.15806919411642842,0.6449140252744976,0.19701678060907396
2507,Walton,1155,0,107,816,1155,1155,1.0,0.0,1.0,232,0.09264069264069263,0.7064935064935065,0.20086580086580086
2508,Walton,4598,17,738,2969,4581,4598,1.0,0.0036972596781209223,0.996302740321879,891,0.1605045672031318,0.6457155284906481,0.1937799043062201
2509,Walton,4462,15,605,2616,4447,4462,1.0,0.0033617212012550424,0.996638278798745,1241,0.1355894217839534,0.5862841774988794,0.2781264007171672
2510,Walton,4546,17,922,1388,4529,4546,1.0,0.003739551253849538,0.9962604487461505,2236,0.20281566212054553,0.30532336119665643,0.49186097668279805
2511,Walton,2113,3,239,1425,2110,2113,1.0,0.001419782300047326,0.9985802176999526,449,0.11310932323710364,0.6743965925224799,0.21249408424041646
2512,Walton,1196,0,131,896,1196,1196,1.0,0.0,1.0,169,0.10953177257525083,0.7491638795986622,0.14130434782608695
2513,Walton,2061,1,155,1412,2060,2061,1.0,0.00048520135856380397,0.9995147986414362,494,0.07520621057738962,0.6851043182920912,0.23968947113051917
2514,Walton,5655,14,993,2559,5641,5655,1.0,0.002475685234305924,0.997524314765694,2103,0.17559681697612733,0.4525198938992042,0.37188328912466845
2515,Walton,3943,21,830,1797,3922,3943,1.0,0.005325893989348212,0.9946741060106518,1316,0.21049961957900076,0.4557443570885113,0.33375602333248794
2516,Walton,1788,7,182,1026,1781,1788,1.0,0.0039149888143176735,0.9960850111856824,580,0.1017897091722595,0.5738255033557047,0.3243847874720358
2517,Walton,5214,13,1512,1311,5201,5214,1.0,0.002493287303413886,0.9975067126965861,2391,0.2899884925201381,0.25143843498273877,0.45857307249712315
2518,Walton,5010,14,928,2347,4996,5010,1.0,0.0027944111776447107,0.9972055888223553,1735,0.18522954091816368,0.4684630738522954,0.3463073852295409
2519,Walton,4558,9,755,1779,4549,4558,1.0,0.0019745502413339184,0.998025449758666,2024,0.16564282580078982,0.39030276437033784,0.4440544098288723
2520,Walton,4029,18,1382,1633,4011,4029,1.0,0.004467609828741623,0.9955323901712584,1014,0.34301315462894016,0.4053114916852817,0.2516753536857781
2521,Walton,2067,8,313,1276,2059,2067,1.0,0.0038703434929850023,0.996129656507015,478,0.1514271891630382,0.6173197871311079,0.2312530237058539
2522,Walton,4237,21,499,2348,4216,4237,1.0,0.004956337030918102,0.9950436629690819,1390,0.11777200849657776,0.5541656832664621,0.3280623082369601
2523,Walton,2841,16,295,1629,2825,2841,1.0,0.005631819781766983,0.994368180218233,917,0.10383667722632876,0.573389651531151,0.32277367124252027
2524,Walton,4216,5,703,2564,4211,4216,1.0,0.0011859582542694497,0.9988140417457305,949,0.16674573055028463,0.6081593927893738,0.22509487666034156
2525,Walton,1253,3,132,874,1250,1253,1.0,0.0023942537909018356,0.9976057462090981,247,0.10534716679968077,0.6975259377494014,0.1971268954509178
2526,Ware,6374,15,630,2087,6359,6374,1.0,0.002353310323187951,0.997646689676812,3657,0.09883903357389394,0.3274239096328836,0.5737370567932225
2527,Ware,1568,5,113,679,1563,1568,1.0,0.0031887755102040817,0.9968112244897959,776,0.07206632653061225,0.4330357142857143,0.49489795918367346
2528,Ware,3978,14,364,2212,3964,3978,1.0,0.003519356460532931,0.9964806435394671,1402,0.0915032679738562,0.5560583207642031,0.3524384112619407
2529,Ware,466,1,24,263,465,466,1.0,0.002145922746781116,0.9978540772532188,179,0.05150214592274678,0.5643776824034334,0.38412017167381973
2530,Ware,4675,10,2001,479,4665,4675,1.0,0.0021390374331550803,0.9978609625668449,2195,0.42802139037433157,0.10245989304812834,0.46951871657754013
2531,Ware,3050,10,574,1062,3040,3050,1.0,0.003278688524590164,0.9967213114754099,1414,0.1881967213114754,0.3481967213114754,0.4636065573770492
2532,Ware,2227,12,290,206,2215,2227,1.0,0.005388414907947912,0.994611585092052,1731,0.13022002694207455,0.09250112258643915,0.7772788504714863
2533,Ware,754,5,23,454,749,754,1.0,0.006631299734748011,0.993368700265252,277,0.03050397877984085,0.6021220159151194,0.3673740053050398
2534,Ware,2265,6,104,1067,2259,2265,1.0,0.0026490066225165563,0.9973509933774835,1094,0.045916114790286976,0.47108167770419423,0.48300220750551875
2535,Ware,624,1,17,339,623,624,1.0,0.0016025641025641025,0.9983974358974359,268,0.027243589743589744,0.5432692307692307,0.42948717948717946
2536,Ware,641,0,19,359,641,641,1.0,0.0,1.0,263,0.029641185647425898,0.5600624024960998,0.41029641185647425
2537,Ware,1166,3,52,658,1163,1166,1.0,0.002572898799313894,0.9974271012006861,456,0.044596912521440824,0.5643224699828473,0.3910806174957118
2538,Warren,4159,7,1469,1166,4152,4159,1.0,0.001683096898292859,0.9983169031017072,1524,0.3532099062274585,0.2803558547727819,0.3664342389997596
2539,Washington,2398,7,254,354,2391,2398,1.0,0.0029190992493744786,0.9970809007506255,1790,0.10592160133444536,0.14762301918265222,0.7464553794829024
2540,Washington,563,0,111,312,563,563,1.0,0.0,1.0,140,0.19715808170515098,0.5541740674955595,0.24866785079928952
2541,Washington,1078,8,252,494,1070,1078,1.0,0.0074211502782931356,0.9925788497217068,332,0.23376623376623376,0.4582560296846011,0.3079777365491651
2542,Washington,579,0,208,227,579,579,1.0,0.0,1.0,144,0.3592400690846287,0.3920552677029361,0.24870466321243523
2543,Washington,648,5,149,281,643,648,1.0,0.007716049382716049,0.9922839506172839,218,0.22993827160493827,0.43364197530864196,0.33641975308641975
2544,Washington,6809,8,2486,1942,6801,6809,1.0,0.001174915552944632,0.9988250844470554,2381,0.3651050080775444,0.2852107504773094,0.34968424144514615
2545,Washington,2916,5,1024,726,2911,2916,1.0,0.0017146776406035665,0.9982853223593965,1166,0.3511659807956104,0.24897119341563786,0.3998628257887517
2546,Washington,718,0,246,327,718,718,1.0,0.0,1.0,145,0.3426183844011142,0.4554317548746518,0.201949860724234
2547,Wayne,3559,13,408,1379,3546,3559,1.0,0.003652711435796572,0.9963472885642034,1772,0.11463894352346164,0.38746838999719024,0.49789266647934816
2548,Wayne,1262,0,73,795,1262,1262,1.0,0.0,1.0,394,0.05784469096671949,0.6299524564183835,0.312202852614897
2549,Wayne,1282,7,78,737,1275,1282,1.0,0.00546021840873635,0.9945397815912637,467,0.060842433697347896,0.5748829953198128,0.36427457098283933
2550,Wayne,1358,1,64,845,1357,1358,1.0,0.0007363770250368188,0.9992636229749632,449,0.047128129602356406,0.6222385861561119,0.33063328424153166
2551,Wayne,1393,14,89,906,1379,1393,1.0,0.010050251256281407,0.9899497487437185,398,0.06389088298636038,0.6503948312993539,0.2857142857142857
2552,Wayne,1920,5,168,1092,1915,1920,1.0,0.0026041666666666665,0.9973958333333334,660,0.0875,0.56875,0.34375
2553,Wayne,1782,6,337,395,1776,1782,1.0,0.003367003367003367,0.9966329966329966,1050,0.18911335578002245,0.22166105499438832,0.5892255892255892
2554,Wayne,3108,18,282,960,3090,3108,1.0,0.005791505791505791,0.9942084942084942,1866,0.09073359073359073,0.3088803088803089,0.6003861003861004
2555,Wayne,1269,3,130,565,1266,1269,1.0,0.002364066193853428,0.9976359338061466,574,0.1024428684003152,0.44523246650906223,0.4523246650906225
2556,Wayne,2137,10,195,1190,2127,2137,1.0,0.004679457182966776,0.9953205428170332,752,0.09124941506785213,0.5568554047730463,0.35189518015910154
2557,Wayne,2509,6,363,967,2503,2509,1.0,0.0023913909924272616,0.9976086090075728,1179,0.14467915504184933,0.3854125149461937,0.469908330011957
2558,Wayne,1526,2,500,156,1524,1526,1.0,0.001310615989515072,0.9986893840104849,870,0.32765399737876805,0.10222804718217562,0.5701179554390564
2559,Webster,1847,3,639,748,1844,1847,1.0,0.0016242555495397943,0.9983757444504602,460,0.3459664320519762,0.40498105035192206,0.24905251759610178
2560,Wheeler,4421,11,452,906,4410,4421,1.0,0.0024881248586292692,0.9975118751413707,3063,0.10223931237276634,0.2049310110834653,0.6928296765437684
2561,Wheeler,1796,12,237,677,1784,1796,1.0,0.0066815144766146995,0.9933184855233853,882,0.1319599109131403,0.3769487750556793,0.4910913140311804
2562,White,2538,7,359,1412,2531,2538,1.0,0.0027580772261623326,0.9972419227738377,767,0.14144996059889678,0.5563435776201734,0.30220646178092986
2563,White,984,2,89,559,982,984,1.0,0.0020325203252032522,0.9979674796747967,336,0.09044715447154472,0.568089430894309,0.34146341463414637
2564,White,562,0,112,307,562,562,1.0,0.0,1.0,143,0.199288256227758,0.5462633451957295,0.25444839857651247
2565,White,3457,13,253,1977,3444,3457,1.0,0.0037604859704946487,0.9962395140295054,1227,0.07318484234885739,0.5718831356667631,0.3549320219843795
2566,White,5412,47,544,2549,5365,5412,1.0,0.00868440502586844,0.9913155949741316,2319,0.10051736881005174,0.47099039172209906,0.4284922394678492
2567,White,1386,1,365,866,1385,1386,1.0,0.0007215007215007215,0.9992784992784993,155,0.26334776334776333,0.6248196248196248,0.11183261183261184
2568,White,388,1,69,245,387,388,1.0,0.002577319587628866,0.9974226804123711,74,0.17783505154639176,0.6314432989690721,0.19072164948453607
2569,White,2893,23,181,1464,2870,2893,1.0,0.007950224680262703,0.9920497753197373,1248,0.06256481161424127,0.506049083995852,0.43138610438990665
2570,White,1232,5,158,743,1227,1232,1.0,0.004058441558441558,0.9959415584415584,331,0.12824675324675325,0.6030844155844156,0.26866883116883117
2571,White,1708,9,169,948,1699,1708,1.0,0.005269320843091335,0.9947306791569087,591,0.09894613583138173,0.5550351288056206,0.34601873536299765
2572,White,1922,12,112,1152,1910,1922,1.0,0.006243496357960458,0.9937565036420395,658,0.05827263267429761,0.5993756503642039,0.34235171696149846
2573,Whitfield,4983,149,689,651,4834,4983,1.0,0.029901665663255066,0.970098334336745,3643,0.13827011840256873,0.13064419024683926,0.731085691350592
2574,Whitfield,3856,32,678,1451,3824,3856,1.0,0.008298755186721992,0.991701244813278,1727,0.1758298755186722,0.3762966804979253,0.4478734439834025
2575,Whitfield,2577,27,559,974,2550,2577,1.0,0.010477299185098952,0.989522700814901,1044,0.21691889794334498,0.37795886689949554,0.4051222351571595
2576,Whitfield,3037,59,710,1169,2978,3037,1.0,0.019427066183733948,0.9805729338162661,1158,0.23378333882120514,0.38491932828449127,0.38129733289430356
2577,Whitfield,4223,175,782,346,4048,4223,1.0,0.041439734785697374,0.9585602652143026,3095,0.18517641487094483,0.08193227563343594,0.7328913094956192
2578,Whitfield,4144,249,565,259,3895,4144,1.0,0.060086872586872585,0.9399131274131274,3320,0.13634169884169883,0.0625,0.8011583011583011
2579,Whitfield,4324,129,618,693,4195,4324,1.0,0.029833487511563367,0.9701665124884367,3013,0.1429232192414431,0.16026827012025902,0.6968085106382979
2580,Whitfield,2759,28,240,980,2731,2759,1.0,0.010148604566872055,0.989851395433128,1539,0.08698803914461761,0.3552011598405219,0.5578108010148605
2581,Whitfield,1785,3,177,844,1782,1785,1.0,0.0016806722689075631,0.9983193277310924,764,0.09915966386554621,0.47282913165266105,0.4280112044817927
2582,Whitfield,4699,78,698,1542,4621,4699,1.0,0.016599276441796127,0.9834007235582038,2459,0.148542243030432,0.3281549265801234,0.5233028303894446
2583,Whitfield,2834,74,343,618,2760,2834,1.0,0.02611150317572336,0.9738884968242767,1873,0.12103034580098801,0.2180663373323924,0.6609033168666196
2584,Whitfield,2949,33,395,983,2916,2949,1.0,0.011190233977619531,0.9888097660223805,1571,0.1339437097321126,0.3333333333333333,0.5327229569345541
2585,Whitfield,3858,56,616,1004,3802,3858,1.0,0.014515292897874546,0.9854847071021254,2238,0.15966822187662,0.26023846552617935,0.5800933125972006
2586,Whitfield,1360,2,111,758,1358,1360,1.0,0.0014705882352941176,0.9985294117647059,491,0.08161764705882353,0.5573529411764706,0.3610294117647059
2587,Whitfield,1884,4,164,1061,1880,1884,1.0,0.0021231422505307855,0.9978768577494692,659,0.0870488322717622,0.5631634819532909,0.3497876857749469
2588,Whitfield,3303,33,278,1430,3270,3303,1.0,0.009990917347865577,0.9900090826521344,1595,0.0841659097789888,0.43293975174084165,0.48289433848016955
2589,Whitfield,6139,72,911,2376,6067,6139,1.0,0.011728294510506597,0.9882717054894934,2852,0.14839550415377098,0.3870337188467177,0.4645707769995113
2590,Whitfield,4703,16,546,2072,4687,4703,1.0,0.0034020837763129915,0.996597916223687,2085,0.11609610886668084,0.44056984903253243,0.44333404210078675
2591,Whitfield,1077,16,76,430,1061,1077,1.0,0.014856081708449397,0.9851439182915506,571,0.07056638811513463,0.39925719591457753,0.5301764159702879
2592,Whitfield,1430,6,132,900,1424,1430,1.0,0.004195804195804196,0.9958041958041958,398,0.09230769230769231,0.6293706293706294,0.2783216783216783
2593,Whitfield,1247,6,104,683,1241,1247,1.0,0.0048115477145148355,0.9951884522854851,460,0.08340016038492382,0.5477145148356054,0.3688853247794707
2594,Whitfield,6140,42,838,2919,6098,6140,1.0,0.0068403908794788275,0.9931596091205211,2383,0.13648208469055376,0.4754071661237785,0.38811074918566774
2595,Whitfield,2951,11,440,1493,2940,2951,1.0,0.003727549983056591,0.9962724500169434,1018,0.14910199932226365,0.5059301931548628,0.3449678075228736
2596,Wilcox,585,1,109,272,584,585,1.0,0.0017094017094017094,0.9982905982905983,204,0.18632478632478633,0.46495726495726497,0.3487179487179487
2597,Wilcox,3037,0,149,554,3037,3037,1.0,0.0,1.0,2334,0.04906157392163319,0.18241685874217978,0.768521567336187
2598,Wilcox,779,0,194,264,779,779,1.0,0.0,1.0,321,0.2490372272143774,0.33889602053915274,0.4120667522464698
2599,Wilcox,1057,2,76,563,1055,1057,1.0,0.001892147587511826,0.9981078524124882,418,0.07190160832544938,0.532639545884579,0.3954588457899716
2600,Wilcox,544,0,235,92,544,544,1.0,0.0,1.0,217,0.4319852941176471,0.16911764705882354,0.39889705882352944
2601,Wilcox,1216,0,99,658,1216,1216,1.0,0.0,1.0,459,0.08141447368421052,0.5411184210526315,0.3774671052631579
2602,Wilkes,1054,4,255,498,1050,1054,1.0,0.003795066413662239,0.9962049335863378,301,0.24193548387096775,0.47248576850094876,0.2855787476280835
2603,Wilkes,1096,2,484,192,1094,1096,1.0,0.0018248175182481751,0.9981751824817519,420,0.4416058394160584,0.17518248175182483,0.38321167883211676
2604,Wilkes,700,3,132,328,697,700,1.0,0.004285714285714286,0.9957142857142857,240,0.18857142857142858,0.4685714285714286,0.34285714285714286
2605,Wilkes,701,3,136,275,698,701,1.0,0.0042796005706134095,0.9957203994293866,290,0.19400855920114124,0.39229671897289586,0.4136947218259629
2606,Wilkes,1849,5,677,389,1844,1849,1.0,0.0027041644131963224,0.9972958355868037,783,0.366143861546782,0.21038399134667388,0.4234721471065441
2607,Wilkes,1024,2,260,431,1022,1024,1.0,0.001953125,0.998046875,333,0.25390625,0.4208984375,0.3251953125
2608,Wilkes,1227,5,216,710,1222,1227,1.0,0.004074979625101874,0.9959250203748982,301,0.17603911980440098,0.5786471067644662,0.24531377343113284
2609,Wilkinson,476,0,36,315,476,476,1.0,0.0,1.0,125,0.07563025210084033,0.6617647058823529,0.26260504201680673
2610,Wilkinson,190,2,31,125,188,190,1.0,0.010526315789473684,0.9894736842105263,34,0.1631578947368421,0.6578947368421053,0.17894736842105263
2611,Wilkinson,197,1,27,110,196,197,1.0,0.005076142131979695,0.9949238578680203,60,0.13705583756345177,0.5583756345177665,0.30456852791878175
2612,Wilkinson,933,7,360,295,926,933,1.0,0.007502679528403001,0.992497320471597,278,0.3858520900321543,0.3161843515541265,0.2979635584137192
2613,Wilkinson,1152,8,89,549,1144,1152,1.0,0.006944444444444444,0.9930555555555556,514,0.07725694444444445,0.4765625,0.4461805555555556
2614,Wilkinson,858,4,233,317,854,858,1.0,0.004662004662004662,0.9953379953379954,308,0.2715617715617716,0.36946386946386944,0.358974358974359
2615,Wilkinson,956,0,534,121,956,956,1.0,0.0,1.0,301,0.5585774058577406,0.12656903765690378,0.3148535564853556
2616,Wilkinson,1859,3,667,585,1856,1859,1.0,0.0016137708445400753,0.9983862291554599,607,0.3587950511027434,0.3146853146853147,0.3265196342119419
2617,Wilkinson,405,3,98,247,402,405,1.0,0.007407407407407408,0.9925925925925926,60,0.2419753086419753,0.6098765432098765,0.14814814814814814
2618,Worth,1439,7,134,689,1432,1439,1.0,0.004864489228630994,0.995135510771369,616,0.09312022237665045,0.4788047255038221,0.42807505211952745
2619,Worth,995,0,83,415,995,995,1.0,0.0,1.0,497,0.08341708542713568,0.41708542713567837,0.4994974874371859
2620,Worth,497,2,30,284,495,497,1.0,0.004024144869215292,0.9959758551307847,183,0.060362173038229376,0.5714285714285714,0.3682092555331992
2621,Worth,1503,5,126,879,1498,1503,1.0,0.00332667997338656,0.9966733200266135,498,0.08383233532934131,0.5848303393213573,0.3313373253493014
2622,Worth,608,0,29,383,608,608,1.0,0.0,1.0,196,0.047697368421052634,0.6299342105263158,0.3223684210526316
2623,Worth,208,3,47,104,205,208,1.0,0.014423076923076924,0.9855769230769231,57,0.22596153846153846,0.5,0.27403846153846156
2624,Worth,363,6,83,127,357,363,1.0,0.01652892561983471,0.9834710743801653,153,0.22865013774104684,0.349862258953168,0.4214876033057851
2625,Worth,955,6,112,485,949,955,1.0,0.0062827225130890054,0.993717277486911,358,0.11727748691099477,0.5078534031413613,0.374869109947644
2626,Worth,1337,2,152,585,1335,1337,1.0,0.0014958863126402393,0.9985041136873598,600,0.11368735976065819,0.43754674644727,0.4487658937920718
2627,Worth,753,1,28,380,752,753,1.0,0.0013280212483399733,0.99867197875166,345,0.03718459495351926,0.5046480743691899,0.4581673306772908
2628,Worth,597,2,45,375,595,597,1.0,0.0033500837520938024,0.9966499162479062,177,0.07537688442211055,0.628140703517588,0.2964824120603015
2629,Worth,975,7,113,462,968,975,1.0,0.0071794871794871795,0.9928205128205129,400,0.1158974358974359,0.47384615384615386,0.41025641025641024
2630,Worth,1625,1,225,709,1624,1625,1.0,0.0006153846153846154,0.9993846153846154,691,0.13846153846153847,0.4363076923076923,0.42523076923076925
2631,Worth,3243,6,1045,616,3237,3243,1.0,0.0018501387604070306,0.9981498612395929,1582,0.32223250077089116,0.18994757940178847,0.48781991982732037
2632,Worth,1346,0,143,337,1346,1346,1.0,0.0,1.0,866,0.1062407132243685,0.25037147102526003,0.6433878157503715
