,COUNTYFP20,VAP,AMINVAP,PRES20D,PRES20R,OVAP,TOT_VOTES,factor,AMINVAP_pct,OVAP_pct,PRES20None,PRES20D_pct,PRES20R_pct,PRES20None_pct
0,001,582,7,94,283,575,582,1.0,0.012027491408934709,0.9879725085910653,205,0.16151202749140894,0.48625429553264604,0.35223367697594504
1,001,3208,3096,1982,273,112,3208,1.0,0.9650872817955112,0.034912718204488775,953,0.6178304239401496,0.0850997506234414,0.297069825436409
2,001,2108,1800,989,148,308,2108,1.0,0.8538899430740038,0.1461100569259962,971,0.4691650853889943,0.07020872865275142,0.4606261859582543
3,001,2540,43,333,1486,2497,2540,1.0,0.016929133858267716,0.9830708661417323,721,0.1311023622047244,0.5850393700787402,0.28385826771653544
4,001,535,525,393,76,10,535,1.0,0.9813084112149533,0.018691588785046728,66,0.7345794392523365,0.14205607476635515,0.1233644859813084
5,001,1048,29,111,746,1019,1048,1.0,0.02767175572519084,0.9723282442748091,191,0.10591603053435114,0.7118320610687023,0.18225190839694658
6,001,1131,1116,748,87,15,1131,1.0,0.986737400530504,0.013262599469496022,296,0.6613616268788682,0.07692307692307693,0.26171529619805484
7,001,793,782,560,90,11,793,1.0,0.9861286254728878,0.013871374527112233,143,0.7061790668348046,0.11349306431273644,0.18032786885245902
8,001,1196,27,159,862,1169,1196,1.0,0.0225752508361204,0.9774247491638796,175,0.13294314381270902,0.7207357859531772,0.14632107023411373
9,001,1228,53,105,684,1175,1228,1.0,0.04315960912052117,0.9568403908794788,439,0.08550488599348534,0.5570032573289903,0.3574918566775244
10,001,3192,2926,1940,416,266,3192,1.0,0.9166666666666666,0.08333333333333333,836,0.6077694235588973,0.13032581453634084,0.2619047619047619
11,001,660,620,416,65,40,660,1.0,0.9393939393939394,0.06060606060606061,179,0.6303030303030303,0.09848484848484848,0.27121212121212124
12,001,829,779,647,119,50,829,1.0,0.9396863691194209,0.06031363088057901,63,0.7804583835946924,0.14354644149577805,0.07599517490952955
13,001,147,2,42,91,145,147,1.0,0.013605442176870748,0.9863945578231292,14,0.2857142857142857,0.6190476190476191,0.09523809523809523
14,001,1006,974,548,168,32,1006,1.0,0.9681908548707754,0.03180914512922465,290,0.5447316103379721,0.16699801192842942,0.2882703777335984
15,001,1105,1091,591,61,14,1105,1.0,0.9873303167420815,0.012669683257918552,453,0.534841628959276,0.05520361990950226,0.4099547511312217
16,001,627,613,436,109,14,627,1.0,0.9776714513556619,0.022328548644338118,82,0.6953748006379585,0.17384370015948963,0.13078149920255183
17,001,1336,1323,889,103,13,1336,1.0,0.9902694610778443,0.009730538922155689,344,0.6654191616766467,0.07709580838323353,0.25748502994011974
18,001,571,547,321,74,24,571,1.0,0.957968476357268,0.04203152364273205,176,0.5621716287215411,0.1295971978984238,0.30823117338003503
19,001,295,281,85,29,14,295,1.0,0.9525423728813559,0.04745762711864407,181,0.288135593220339,0.09830508474576272,0.6135593220338983
20,001,1722,1664,1030,123,58,1722,1.0,0.9663182346109176,0.03368176538908246,569,0.5981416957026713,0.07142857142857142,0.33042973286875726
21,001,252,248,135,29,4,252,1.0,0.9841269841269841,0.015873015873015872,88,0.5357142857142857,0.11507936507936507,0.3492063492063492
22,001,817,805,554,110,12,817,1.0,0.98531211750306,0.014687882496940025,153,0.6780905752753978,0.1346389228886169,0.18727050183598531
23,001,413,2,79,225,411,413,1.0,0.004842615012106538,0.9951573849878934,109,0.19128329297820823,0.5447941888619855,0.2639225181598063
24,001,364,354,282,42,10,364,1.0,0.9725274725274725,0.027472527472527472,40,0.7747252747252747,0.11538461538461539,0.10989010989010989
25,001,1636,1390,724,327,246,1636,1.0,0.8496332518337408,0.15036674816625917,585,0.44254278728606355,0.19987775061124693,0.3575794621026895
26,001,321,286,173,26,35,321,1.0,0.8909657320872274,0.10903426791277258,122,0.5389408099688473,0.08099688473520249,0.38006230529595014
27,001,796,783,317,167,13,796,1.0,0.9836683417085427,0.016331658291457288,312,0.39824120603015073,0.20979899497487436,0.39195979899497485
28,001,1002,963,802,111,39,1002,1.0,0.9610778443113772,0.038922155688622756,89,0.8003992015968064,0.11077844311377245,0.08882235528942116
29,001,874,862,526,57,12,874,1.0,0.9862700228832952,0.013729977116704805,291,0.6018306636155606,0.06521739130434782,0.3329519450800915
30,001,756,733,566,61,23,756,1.0,0.9695767195767195,0.03042328042328042,129,0.7486772486772487,0.08068783068783068,0.17063492063492064
31,001,1316,59,92,558,1257,1316,1.0,0.044832826747720364,0.9551671732522796,666,0.06990881458966565,0.42401215805471126,0.506079027355623
32,001,1705,108,236,873,1597,1705,1.0,0.06334310850439882,0.9366568914956012,596,0.13841642228739004,0.5120234604105571,0.3495601173020528
33,001,3864,3686,2320,418,178,3864,1.0,0.9539337474120083,0.04606625258799172,1126,0.6004140786749482,0.10817805383022774,0.291407867494824
34,001,722,708,480,85,14,722,1.0,0.9806094182825484,0.019390581717451522,157,0.6648199445983379,0.11772853185595568,0.21745152354570638
35,001,1266,47,159,666,1219,1266,1.0,0.03712480252764613,0.9628751974723538,441,0.12559241706161137,0.5260663507109005,0.34834123222748814
36,001,1240,1210,736,93,30,1240,1.0,0.9758064516129032,0.024193548387096774,411,0.5935483870967742,0.075,0.33145161290322583
37,001,547,527,312,76,20,547,1.0,0.9634369287020109,0.03656307129798903,159,0.5703839122486288,0.13893967093235832,0.2906764168190128
38,001,330,326,294,35,4,330,1.0444444444444445,0.9878787878787879,0.012121212121212121,1,0.8909090909090909,0.10606060606060606,0.0030303030303030303
39,001,642,627,436,101,15,642,1.0,0.9766355140186916,0.02336448598130841,105,0.6791277258566978,0.1573208722741433,0.16355140186915887
40,001,1862,67,238,1140,1795,1862,1.0,0.0359828141783029,0.9640171858216972,484,0.12781954887218044,0.6122448979591837,0.25993555316863587
41,001,1838,1407,988,79,431,1838,1.0,0.76550598476605,0.23449401523394994,771,0.5375408052230686,0.04298150163220892,0.41947769314472255
42,001,698,686,425,70,12,698,1.0,0.9828080229226361,0.017191977077363897,203,0.6088825214899714,0.10028653295128939,0.29083094555873923
43,003,2223,27,442,958,2196,2223,1.0,0.012145748987854251,0.9878542510121457,823,0.19883040935672514,0.43094916779127307,0.3702204228520018
44,003,2332,33,445,1239,2299,2332,1.0,0.014150943396226415,0.9858490566037735,648,0.19082332761578044,0.5313036020583191,0.27787307032590053
45,003,2408,32,508,986,2376,2408,1.0,0.013289036544850499,0.9867109634551495,914,0.21096345514950166,0.40946843853820597,0.3795681063122924
46,003,1619,14,908,223,1605,1619,1.0,0.008647313156269302,0.9913526868437307,488,0.560840024706609,0.13773934527486104,0.30142063001853
47,003,1708,27,698,440,1681,1708,1.0,0.015807962529274005,0.984192037470726,570,0.40866510538641687,0.2576112412177986,0.3337236533957845
48,003,1684,16,783,366,1668,1684,1.0,0.009501187648456057,0.9904988123515439,535,0.4649643705463183,0.2173396674584323,0.3176959619952494
49,003,510,7,62,148,503,510,1.0,0.013725490196078431,0.9862745098039216,300,0.12156862745098039,0.2901960784313726,0.5882352941176471
50,003,1963,24,404,1006,1939,1963,1.0,0.012226184411614875,0.9877738155883852,553,0.20580743759551706,0.5124808965868568,0.2817116658176261
51,003,1837,15,751,257,1822,1837,1.0,0.008165487207403375,0.9918345127925966,829,0.4088187261839956,0.13990201415351117,0.4512792596624932
52,003,2378,27,926,413,2351,2378,1.0,0.011354079058031959,0.988645920941968,1039,0.3894028595458368,0.1736753574432296,0.43692178301093354
53,003,2688,47,891,250,2641,2688,1.0,0.017485119047619048,0.9825148809523809,1547,0.3314732142857143,0.09300595238095238,0.5755208333333334
54,003,2260,34,664,212,2226,2260,1.0,0.01504424778761062,0.9849557522123894,1384,0.2938053097345133,0.09380530973451327,0.6123893805309735
55,003,2294,38,641,380,2256,2294,1.0,0.016564952048823016,0.983435047951177,1273,0.2794245858761988,0.16564952048823017,0.5549258936355711
56,003,2061,33,390,1053,2028,2061,1.0,0.01601164483260553,0.9839883551673945,618,0.18922852983988356,0.5109170305676856,0.29985443959243085
57,003,2111,20,567,1180,2091,2111,1.0,0.009474182851729039,0.9905258171482709,364,0.26859308384651825,0.5589767882520132,0.1724301279014685
58,003,1424,17,296,462,1407,1424,1.0,0.011938202247191011,0.988061797752809,666,0.20786516853932585,0.324438202247191,0.46769662921348315
59,003,971,14,231,511,957,971,1.0,0.014418125643666324,0.9855818743563337,229,0.23789907312049433,0.5262615859938208,0.23583934088568487
60,003,876,2,314,153,874,876,1.0,0.00228310502283105,0.997716894977169,409,0.3584474885844749,0.17465753424657535,0.4668949771689498
61,003,1580,23,341,781,1557,1580,1.0,0.014556962025316455,0.9854430379746836,458,0.2158227848101266,0.49430379746835446,0.289873417721519
62,003,3850,109,576,332,3741,3850,1.0,0.028311688311688312,0.9716883116883117,2942,0.1496103896103896,0.08623376623376623,0.7641558441558441
63,003,1313,7,271,694,1306,1313,1.0,0.005331302361005331,0.9946686976389947,348,0.2063975628332064,0.5285605483625285,0.26504188880426505
64,003,369,3,130,147,366,369,1.0,0.008130081300813009,0.991869918699187,92,0.3523035230352303,0.3983739837398374,0.24932249322493225
65,003,328,5,31,147,323,328,1.0,0.01524390243902439,0.9847560975609756,150,0.09451219512195122,0.4481707317073171,0.4573170731707317
66,003,2052,24,332,1239,2028,2052,1.0,0.011695906432748537,0.9883040935672515,481,0.1617933723196881,0.6038011695906432,0.23440545808966862
67,003,573,6,123,290,567,573,1.0,0.010471204188481676,0.9895287958115183,160,0.21465968586387435,0.506108202443281,0.2792321116928447
68,003,2856,30,722,1151,2826,2856,1.0,0.01050420168067227,0.9894957983193278,983,0.25280112044817926,0.40301120448179273,0.344187675070028
69,003,2997,17,871,1468,2980,2997,1.0,0.005672339005672339,0.9943276609943277,658,0.29062395729062396,0.48982315648982316,0.21955288621955288
70,003,2612,34,576,737,2578,2612,1.0,0.013016845329249618,0.9869831546707504,1299,0.22052067381316998,0.2821592649310873,0.49732006125574274
71,003,1574,14,372,524,1560,1574,1.0,0.008894536213468869,0.9911054637865311,678,0.2363405336721728,0.33290978398983484,0.4307496823379924
72,003,1546,8,327,412,1538,1546,1.0,0.00517464424320828,0.9948253557567918,807,0.2115135834411384,0.2664941785252264,0.5219922380336351
73,003,2437,19,624,849,2418,2437,1.0,0.007796471070988921,0.9922035289290111,964,0.2560525235945835,0.3483791546983997,0.39556832170701683
74,003,2371,8,685,1261,2363,2371,1.0,0.003374103753690426,0.9966258962463096,425,0.2889076339097427,0.5318431041754534,0.1792492619148039
75,003,2566,32,584,937,2534,2566,1.0,0.012470771628994544,0.9875292283710054,1045,0.22759158222915044,0.3651597817614965,0.40724863600935307
76,003,2560,35,517,758,2525,2560,1.0,0.013671875,0.986328125,1285,0.201953125,0.29609375,0.501953125
77,003,2300,24,442,1175,2276,2300,1.0,0.010434782608695653,0.9895652173913043,683,0.19217391304347825,0.5108695652173914,0.29695652173913045
78,003,1944,15,446,699,1929,1944,1.0,0.007716049382716049,0.9922839506172839,799,0.2294238683127572,0.3595679012345679,0.41100823045267487
79,003,1716,25,422,880,1691,1716,1.0,0.014568764568764568,0.9854312354312355,414,0.24592074592074592,0.5128205128205128,0.24125874125874125
80,003,1469,17,406,559,1452,1469,1.0,0.011572498298162015,0.988427501701838,504,0.2763784887678693,0.3805309734513274,0.3430905377808033
81,003,6716,80,849,964,6636,6716,1.0,0.011911852293031567,0.9880881477069684,4903,0.1264145324597975,0.14353782013103036,0.7300476474091722
82,003,2213,21,550,1125,2192,2213,1.0,0.009489380930863081,0.990510619069137,538,0.24853140533212834,0.508359692724808,0.24310890194306373
83,003,2771,17,731,1267,2754,2771,1.0,0.006134969325153374,0.9938650306748467,773,0.26380368098159507,0.4572356549981956,0.2789606640202093
84,003,2357,30,583,841,2327,2357,1.0,0.012728044123886296,0.9872719558761137,933,0.24734832414085703,0.35680950360627917,0.39584217225286383
85,003,2232,20,602,1330,2212,2232,1.0,0.008960573476702509,0.9910394265232975,300,0.26971326164874554,0.5958781362007168,0.13440860215053763
86,003,1791,22,346,994,1769,1791,1.0,0.012283640424343942,0.9877163595756561,451,0.19318816303740927,0.5549972082635399,0.2518146286990508
87,003,716,11,133,341,705,716,1.0,0.015363128491620111,0.9846368715083799,242,0.1857541899441341,0.4762569832402235,0.33798882681564246
88,003,2759,33,501,1360,2726,2759,1.0,0.011960855382384922,0.9880391446176151,898,0.18158753171438927,0.4929322218194998,0.3254802464661109
89,003,2191,52,285,804,2139,2191,1.0,0.023733455043359195,0.9762665449566408,1102,0.1300775901414879,0.36695572797809217,0.5029666818804199
90,003,1688,15,205,758,1673,1688,1.0,0.008886255924170616,0.9911137440758294,725,0.12144549763033176,0.4490521327014218,0.42950236966824645
91,003,1536,31,228,496,1505,1536,1.0,0.020182291666666668,0.9798177083333334,812,0.1484375,0.3229166666666667,0.5286458333333334
92,005,1880,159,1178,357,1721,1880,1.0,0.08457446808510638,0.9154255319148936,345,0.6265957446808511,0.1898936170212766,0.18351063829787234
93,005,1600,94,1060,202,1506,1600,1.0,0.05875,0.94125,338,0.6625,0.12625,0.21125
94,005,1249,51,798,125,1198,1249,1.0,0.04083266613290633,0.9591673338670936,326,0.6389111289031225,0.100080064051241,0.2610088070456365
95,005,1575,52,1149,347,1523,1575,1.0,0.03301587301587302,0.966984126984127,79,0.7295238095238096,0.22031746031746033,0.05015873015873016
96,005,2230,86,1342,623,2144,2230,1.0,0.03856502242152467,0.9614349775784753,265,0.6017937219730942,0.27937219730941704,0.11883408071748879
97,005,2427,86,1091,655,2341,2427,1.0,0.03543469303667079,0.9645653069633292,681,0.4495261639884631,0.2698805109188298,0.28059332509270707
98,005,2512,78,860,418,2434,2512,1.0,0.03105095541401274,0.9689490445859873,1234,0.34235668789808915,0.1664012738853503,0.4912420382165605
99,005,975,94,611,196,881,975,1.0,0.09641025641025641,0.9035897435897436,168,0.6266666666666667,0.20102564102564102,0.1723076923076923
100,005,4896,700,1193,405,4196,4896,1.0,0.14297385620915032,0.8570261437908496,3298,0.24366830065359477,0.08272058823529412,0.6736111111111112
101,005,2145,104,162,35,2041,2145,1.0,0.048484848484848485,0.9515151515151515,1948,0.07552447552447553,0.016317016317016316,0.9081585081585082
102,005,1761,423,595,240,1338,1761,1.0,0.2402044293015332,0.7597955706984668,926,0.3378762067007382,0.1362862010221465,0.5258375922771152
103,005,2243,189,872,174,2054,2243,1.0,0.08426214890771289,0.9157378510922871,1197,0.38876504681230495,0.07757467677218012,0.533660276415515
104,005,4193,142,248,63,4051,4193,1.0,0.033865967088003816,0.9661340329119962,3882,0.05914619604102075,0.015025041736227046,0.9258287622227522
105,005,3226,445,903,282,2781,3226,1.0,0.1379417234965902,0.8620582765034098,2041,0.27991320520768753,0.08741475511469311,0.6326720396776193
106,005,4530,930,1622,647,3600,4530,1.0,0.2052980132450331,0.7947019867549668,2261,0.35805739514348783,0.14282560706401767,0.49911699779249447
107,005,2064,173,1181,533,1891,2064,1.0,0.08381782945736434,0.9161821705426356,350,0.5721899224806202,0.25823643410852715,0.1695736434108527
108,005,989,112,382,216,877,989,1.0,0.11324570273003033,0.8867542972699697,391,0.3862487360970677,0.21840242669362994,0.3953488372093023
109,005,1069,148,382,279,921,1069,1.0,0.1384471468662301,0.8615528531337698,408,0.35734331150608045,0.2609915809167446,0.3816651075771749
110,005,2072,176,1000,612,1896,2072,1.0,0.08494208494208494,0.915057915057915,460,0.4826254826254826,0.2953667953667954,0.222007722007722
111,005,4047,161,427,118,3886,4047,1.0,0.03978255497899679,0.9602174450210033,3502,0.10551025450951322,0.02915740054361255,0.8653323449468743
112,005,2644,104,1303,699,2540,2644,1.0,0.039334341906202726,0.9606656580937972,642,0.49281391830559756,0.2643721633888048,0.2428139183055976
113,005,3645,311,1658,973,3334,3645,1.0,0.08532235939643347,0.9146776406035665,1014,0.45486968449931414,0.26694101508916324,0.2781893004115226
114,005,2629,465,994,455,2164,2629,1.0,0.17687333586915177,0.8231266641308482,1180,0.3780905287181438,0.17306960821605172,0.4488398630658045
115,005,3319,278,1502,1032,3041,3319,1.0,0.08376016872551974,0.9162398312744803,785,0.4525459475745707,0.3109370292256704,0.23651702319975895
116,005,2385,221,1119,645,2164,2385,1.0,0.09266247379454927,0.9073375262054507,621,0.4691823899371069,0.27044025157232704,0.26037735849056604
117,005,1732,404,549,411,1328,1732,1.0,0.23325635103926096,0.766743648960739,772,0.3169745958429561,0.23729792147806006,0.4457274826789838
118,005,837,42,282,338,795,837,1.0,0.05017921146953405,0.9498207885304659,217,0.33691756272401435,0.4038231780167264,0.25925925925925924
119,005,611,7,143,467,604,611,1.0016420361247949,0.011456628477905073,0.9885433715220949,1,0.23404255319148937,0.7643207855973814,0.0016366612111292963
120,005,1020,988,566,174,32,1020,1.0,0.9686274509803922,0.03137254901960784,280,0.5549019607843138,0.17058823529411765,0.27450980392156865
121,005,872,839,653,140,33,872,1.0,0.9621559633027523,0.03784403669724771,79,0.7488532110091743,0.16055045871559634,0.09059633027522936
122,005,408,393,319,88,15,408,1.1243093922651934,0.9632352941176471,0.03676470588235294,1,0.7818627450980392,0.21568627450980393,0.0024509803921568627
123,005,328,322,186,23,6,328,1.0,0.9817073170731707,0.018292682926829267,119,0.5670731707317073,0.0701219512195122,0.3628048780487805
124,005,2186,269,752,1019,1917,2186,1.0,0.12305580969807868,0.8769441903019213,415,0.34400731930466605,0.46614821591948763,0.1898444647758463
125,005,93,6,39,36,87,93,1.0,0.06451612903225806,0.9354838709677419,18,0.41935483870967744,0.3870967741935484,0.1935483870967742
126,005,2020,215,688,946,1805,2020,1.0,0.10643564356435643,0.8935643564356436,386,0.3405940594059406,0.46831683168316834,0.1910891089108911
127,005,162,4,40,111,158,162,1.0,0.024691358024691357,0.9753086419753086,11,0.24691358024691357,0.6851851851851852,0.06790123456790123
128,005,341,2,197,117,339,341,1.0,0.005865102639296188,0.9941348973607038,27,0.5777126099706745,0.34310850439882695,0.07917888563049853
129,005,717,2,363,307,715,717,1.0,0.002789400278940028,0.99721059972106,47,0.5062761506276151,0.4281729428172943,0.06555090655509066
130,005,1076,102,116,482,974,1076,1.0,0.09479553903345725,0.9052044609665427,478,0.10780669144981413,0.4479553903345725,0.44423791821561337
131,005,1570,294,495,149,1276,1570,1.0,0.18726114649681527,0.8127388535031848,926,0.31528662420382164,0.09490445859872612,0.5898089171974522
132,005,168,127,57,5,41,168,1.0,0.7559523809523809,0.24404761904761904,106,0.3392857142857143,0.02976190476190476,0.6309523809523809
133,005,654,636,307,154,18,654,1.0,0.9724770642201835,0.027522935779816515,193,0.4694189602446483,0.23547400611620795,0.29510703363914376
134,005,3295,150,1696,1063,3145,3295,1.0,0.04552352048558422,0.9544764795144158,536,0.5147192716236723,0.3226100151745068,0.16267071320182094
135,005,197,12,61,114,185,197,1.0,0.06091370558375635,0.9390862944162437,22,0.3096446700507614,0.5786802030456852,0.1116751269035533
136,005,53,6,4,12,47,53,1.0,0.11320754716981132,0.8867924528301887,37,0.07547169811320754,0.22641509433962265,0.6981132075471698
137,005,1319,1293,735,218,26,1319,1.0,0.9802880970432145,0.019711902956785442,366,0.5572403335860501,0.1652767247915087,0.27748294162244125
138,005,922,43,135,430,879,922,1.0,0.046637744034707156,0.9533622559652929,357,0.14642082429501085,0.46637744034707157,0.3872017353579176
139,005,1066,1001,534,186,65,1066,1.0,0.9390243902439024,0.06097560975609756,346,0.50093808630394,0.17448405253283303,0.324577861163227
140,005,1429,1391,844,198,38,1429,1.0,0.9734079776067179,0.026592022393282014,387,0.5906228131560531,0.13855843247025892,0.2708187543736879
141,005,582,565,257,26,17,582,1.0,0.9707903780068728,0.029209621993127148,299,0.4415807560137457,0.044673539518900345,0.5137457044673539
142,005,92,89,71,19,3,92,1.0,0.967391304347826,0.03260869565217391,2,0.7717391304347826,0.20652173913043478,0.021739130434782608
143,005,1559,492,350,452,1067,1559,1.0,0.31558691468890315,0.6844130853110969,757,0.22450288646568314,0.28992944194996795,0.48556767158434894
144,005,1281,292,313,519,989,1281,1.0,0.22794691647150664,0.7720530835284933,449,0.24434035909445745,0.405152224824356,0.3505074160811866
145,005,1655,1061,330,285,594,1655,1.0,0.6410876132930513,0.35891238670694864,1040,0.19939577039274925,0.17220543806646527,0.6283987915407855
146,005,1365,182,387,544,1183,1365,1.0,0.13333333333333333,0.8666666666666667,434,0.2835164835164835,0.39853479853479856,0.31794871794871793
147,005,1226,19,303,700,1207,1226,1.0,0.015497553017944535,0.9845024469820555,223,0.24714518760195758,0.5709624796084829,0.18189233278955955
148,005,1000,11,316,552,989,1000,1.0,0.011,0.989,132,0.316,0.552,0.132
149,005,1203,9,456,331,1194,1203,1.0,0.007481296758104738,0.9925187032418953,416,0.3790523690773067,0.27514546965918535,0.3458021612635079
150,005,1665,7,797,607,1658,1665,1.0,0.004204204204204204,0.9957957957957958,261,0.4786786786786787,0.36456456456456454,0.15675675675675677
151,005,654,68,228,252,586,654,1.0,0.10397553516819572,0.8960244648318043,174,0.3486238532110092,0.3853211009174312,0.26605504587155965
152,005,2084,182,692,966,1902,2084,1.0,0.0873320537428023,0.9126679462571977,426,0.33205374280230326,0.463531669865643,0.20441458733205375
153,005,296,6,101,141,290,296,1.0,0.02027027027027027,0.9797297297297297,54,0.34121621621621623,0.47635135135135137,0.18243243243243243
154,005,420,415,269,40,5,420,1.0,0.9880952380952381,0.011904761904761904,111,0.6404761904761904,0.09523809523809523,0.2642857142857143
155,005,1676,1636,1140,241,40,1676,1.0,0.9761336515513126,0.02386634844868735,295,0.6801909307875895,0.14379474940334128,0.1760143198090692
156,005,2116,319,694,848,1797,2116,1.0,0.15075614366729678,0.8492438563327032,574,0.3279773156899811,0.4007561436672968,0.2712665406427221
157,005,1211,1042,654,136,169,1211,1.0,0.8604459124690339,0.13955408753096615,421,0.5400495458298926,0.11230388109000826,0.3476465730800991
158,005,1107,1055,564,83,52,1107,1.0,0.953026196928636,0.04697380307136405,460,0.5094850948509485,0.07497741644083107,0.41553748870822044
159,005,4149,3931,2302,350,218,4149,1.0,0.9474572186068932,0.05254278139310677,1497,0.5548324897565678,0.08435767654856592,0.36080983369486624
160,005,1147,162,258,335,985,1147,1.0,0.14123801220575413,0.8587619877942458,554,0.22493461203138623,0.2920662598081953,0.48299912816041846
161,005,2963,59,525,1568,2904,2963,1.0,0.01991225109686129,0.9800877489031387,870,0.1771852851839352,0.5291933850826864,0.29362132973337834
162,005,1208,25,298,538,1183,1208,1.0,0.020695364238410598,0.9793046357615894,372,0.24668874172185432,0.445364238410596,0.3079470198675497
163,007,1323,73,263,540,1250,1323,1.0,0.05517762660619804,0.9448223733938019,520,0.19879062736205594,0.40816326530612246,0.3930461073318216
164,007,289,25,81,96,264,289,1.0,0.08650519031141868,0.9134948096885813,112,0.28027681660899656,0.33217993079584773,0.3875432525951557
165,007,206,11,47,57,195,206,1.0,0.05339805825242718,0.9466019417475728,102,0.22815533980582525,0.2766990291262136,0.49514563106796117
166,007,800,37,229,248,763,800,1.0,0.04625,0.95375,323,0.28625,0.31,0.40375
167,007,1386,194,262,444,1192,1386,1.0,0.13997113997113997,0.86002886002886,680,0.18903318903318903,0.3203463203463203,0.4906204906204906
168,007,1353,323,260,474,1030,1353,1.0,0.23872875092387288,0.7612712490761271,619,0.19216555801921656,0.35033259423503327,0.4575018477457502
169,007,610,40,138,231,570,610,1.0,0.06557377049180328,0.9344262295081968,241,0.2262295081967213,0.37868852459016394,0.3950819672131147
170,007,761,39,187,206,722,761,1.0,0.051248357424441525,0.9487516425755584,368,0.2457293035479632,0.2706964520367937,0.4835742444152431
171,007,3612,3502,1265,260,110,3612,1.0,0.969545957918051,0.03045404208194906,2087,0.3502214839424142,0.07198228128460686,0.5777962347729789
172,007,1125,1069,264,47,56,1125,1.0,0.9502222222222222,0.049777777777777775,814,0.23466666666666666,0.041777777777777775,0.7235555555555555
173,007,926,20,162,403,906,926,1.0,0.02159827213822894,0.978401727861771,361,0.17494600431965443,0.4352051835853132,0.3898488120950324
174,007,652,24,148,211,628,652,1.0,0.03680981595092025,0.9631901840490797,293,0.22699386503067484,0.3236196319018405,0.4493865030674847
175,007,715,31,168,156,684,715,1.0,0.043356643356643354,0.9566433566433566,391,0.23496503496503496,0.21818181818181817,0.5468531468531469
176,007,750,5,148,181,745,750,1.0,0.006666666666666667,0.9933333333333333,421,0.19733333333333333,0.24133333333333334,0.5613333333333334
177,007,726,33,110,234,693,726,1.0,0.045454545454545456,0.9545454545454546,382,0.15151515151515152,0.32231404958677684,0.5261707988980716
178,007,1062,29,165,416,1033,1062,1.0,0.027306967984934087,0.972693032015066,481,0.1553672316384181,0.391713747645951,0.4529190207156309
179,007,1077,40,205,361,1037,1077,1.0,0.03714020427112349,0.9628597957288765,511,0.1903435468895079,0.33519034354688954,0.4744661095636026
180,007,288,3,48,152,285,288,1.0,0.010416666666666666,0.9895833333333334,88,0.16666666666666666,0.5277777777777778,0.3055555555555556
181,007,220,4,20,106,216,220,1.0,0.01818181818181818,0.9818181818181818,94,0.09090909090909091,0.4818181818181818,0.42727272727272725
182,007,1492,5,209,906,1487,1492,1.0,0.003351206434316354,0.9966487935656837,377,0.1400804289544236,0.6072386058981233,0.2526809651474531
183,007,1862,37,263,851,1825,1862,1.0,0.01987110633727175,0.9801288936627283,748,0.14124597207303974,0.45703544575725025,0.40171858216971
184,007,2358,138,414,1268,2220,2358,1.0,0.058524173027989825,0.9414758269720102,676,0.17557251908396945,0.53774385072095,0.2866836301950806
185,007,2864,52,639,1708,2812,2864,1.0,0.018156424581005588,0.9818435754189944,517,0.22311452513966482,0.5963687150837989,0.1805167597765363
186,007,1418,14,322,694,1404,1418,1.0,0.009873060648801129,0.9901269393511989,402,0.22708039492242596,0.4894217207334274,0.2834978843441467
187,007,1547,34,255,744,1513,1547,1.0,0.02197802197802198,0.978021978021978,548,0.16483516483516483,0.48093083387201035,0.35423400129282484
188,007,1147,11,217,589,1136,1147,1.0,0.00959023539668701,0.990409764603313,341,0.1891891891891892,0.5135135135135135,0.2972972972972973
189,007,1643,11,313,881,1632,1643,1.0,0.006695069993913573,0.9933049300060864,449,0.1905051734631771,0.5362142422398052,0.2732805842970176
190,007,2088,11,369,1140,2077,2088,1.0,0.005268199233716475,0.9947318007662835,579,0.17672413793103448,0.5459770114942529,0.27729885057471265
191,007,2902,30,480,1685,2872,2902,1.0,0.010337698139214336,0.9896623018607856,737,0.16540317022742937,0.5806340454858718,0.25396278428669883
192,007,291,2,52,165,289,291,1.0,0.006872852233676976,0.993127147766323,74,0.17869415807560138,0.5670103092783505,0.2542955326460481
193,007,597,2,159,381,595,597,1.0,0.0033500837520938024,0.9966499162479062,57,0.2663316582914573,0.6381909547738693,0.09547738693467336
194,007,732,13,97,374,719,732,1.0,0.017759562841530054,0.98224043715847,261,0.1325136612021858,0.5109289617486339,0.35655737704918034
195,007,627,9,65,417,618,627,1.0,0.014354066985645933,0.9856459330143541,145,0.10366826156299841,0.6650717703349283,0.23125996810207336
196,007,2010,15,430,1188,1995,2010,1.0,0.007462686567164179,0.9925373134328358,392,0.21393034825870647,0.591044776119403,0.19502487562189055
197,007,72,66,12,2,6,72,1.0,0.9166666666666666,0.08333333333333333,58,0.16666666666666666,0.027777777777777776,0.8055555555555556
198,007,650,18,149,413,632,650,1.0,0.027692307692307693,0.9723076923076923,88,0.22923076923076924,0.6353846153846154,0.13538461538461538
199,007,825,12,328,148,813,825,1.0,0.014545454545454545,0.9854545454545455,349,0.3975757575757576,0.17939393939393938,0.42303030303030303
200,009,2190,51,242,534,2139,2190,1.0,0.023287671232876714,0.9767123287671233,1414,0.11050228310502283,0.24383561643835616,0.645662100456621
201,009,2587,52,382,791,2535,2587,1.0,0.020100502512562814,0.9798994974874372,1414,0.14766138384228836,0.30575956706609975,0.5465790490916119
202,009,895,23,134,412,872,895,1.0,0.02569832402234637,0.9743016759776536,349,0.14972067039106146,0.46033519553072627,0.38994413407821227
203,009,780,23,177,305,757,780,1.0,0.029487179487179487,0.9705128205128205,298,0.22692307692307692,0.391025641025641,0.382051282051282
204,009,1942,37,296,876,1905,1942,1.0,0.01905252317198764,0.9809474768280123,770,0.15242018537590113,0.451081359423275,0.3964984552008239
205,009,1085,19,90,623,1066,1085,1.0,0.017511520737327188,0.9824884792626728,372,0.08294930875576037,0.5741935483870968,0.34285714285714286
206,009,2425,60,296,1149,2365,2425,1.0,0.024742268041237112,0.9752577319587629,980,0.1220618556701031,0.4738144329896907,0.4041237113402062
207,009,670,13,37,449,657,670,1.0,0.019402985074626865,0.9805970149253731,184,0.05522388059701493,0.6701492537313433,0.2746268656716418
208,009,3603,67,289,1715,3536,3603,1.0,0.018595614765473216,0.9814043852345268,1599,0.08021093533166805,0.475992228698307,0.443796835970025
209,009,321,8,22,196,313,321,1.0,0.024922118380062305,0.9750778816199377,103,0.06853582554517133,0.6105919003115264,0.32087227414330216
210,009,1385,1368,606,87,17,1385,1.0,0.9877256317689531,0.01227436823104693,692,0.4375451263537906,0.0628158844765343,0.4996389891696751
211,009,65,2,14,41,63,65,1.0,0.03076923076923077,0.9692307692307692,10,0.2153846153846154,0.6307692307692307,0.15384615384615385
212,009,147,0,12,113,147,147,1.0,0.0,1.0,22,0.08163265306122448,0.7687074829931972,0.14965986394557823
213,009,430,11,55,235,419,430,1.0,0.02558139534883721,0.9744186046511628,140,0.12790697674418605,0.5465116279069767,0.32558139534883723
214,009,2240,37,415,856,2203,2240,1.0,0.016517857142857143,0.9834821428571429,969,0.18526785714285715,0.3821428571428571,0.43258928571428573
215,009,1546,1516,471,88,30,1546,1.0,0.9805950840879689,0.019404915912031046,987,0.30465717981888746,0.056921086675291076,0.6384217335058214
216,009,314,4,46,123,310,314,1.0,0.012738853503184714,0.9872611464968153,145,0.1464968152866242,0.39171974522292996,0.46178343949044587
217,009,1377,18,174,788,1359,1377,1.0,0.013071895424836602,0.9869281045751634,415,0.12636165577342048,0.5722585330428468,0.30137981118373275
218,009,1651,13,152,754,1638,1651,1.0,0.007874015748031496,0.9921259842519685,745,0.09206541490006057,0.4566929133858268,0.45124167171411267
219,009,1852,123,100,531,1729,1852,1.0,0.066414686825054,0.933585313174946,1221,0.05399568034557235,0.2867170626349892,0.6592872570194385
220,009,124,5,13,64,119,124,1.0,0.04032258064516129,0.9596774193548387,47,0.10483870967741936,0.5161290322580645,0.3790322580645161
221,009,86,2,11,19,84,86,1.0,0.023255813953488372,0.9767441860465116,56,0.12790697674418605,0.22093023255813954,0.6511627906976745
222,011,42,3,1,14,39,42,1.0,0.07142857142857142,0.9285714285714286,27,0.023809523809523808,0.3333333333333333,0.6428571428571429
223,011,60,1,2,23,59,60,1.0,0.016666666666666666,0.9833333333333333,35,0.03333333333333333,0.38333333333333336,0.5833333333333334
224,011,1532,63,329,400,1469,1532,1.0,0.041122715404699736,0.9588772845953003,803,0.21475195822454307,0.26109660574412535,0.5241514360313316
225,011,678,2,226,227,676,678,1.0,0.0029498525073746312,0.9970501474926253,225,0.3333333333333333,0.33480825958702065,0.33185840707964603
226,011,1924,101,278,594,1823,1924,1.0,0.0524948024948025,0.9475051975051975,1052,0.1444906444906445,0.3087318087318087,0.5467775467775468
227,011,609,29,46,152,580,609,1.0,0.047619047619047616,0.9523809523809523,411,0.0755336617405583,0.24958949096880131,0.6748768472906403
228,011,960,18,157,433,942,960,1.0,0.01875,0.98125,370,0.16354166666666667,0.4510416666666667,0.3854166666666667
229,011,1038,9,143,590,1029,1038,1.0,0.008670520231213872,0.9913294797687862,305,0.13776493256262043,0.5684007707129094,0.29383429672447015
230,012,4232,1321,0,0,2911,4232,1.0,0.31214555765595464,0.6878544423440454,4232,0.0,0.0,1.0
231,012,691,402,167,73,289,691,1.0,0.5817655571635311,0.4182344428364689,451,0.24167872648335745,0.10564399421128799,0.6526772793053546
232,012,2123,59,290,1235,2064,2123,1.0,0.027790861987753178,0.9722091380122468,598,0.1365991521431936,0.5817239755063589,0.28167687235044747
233,012,692,3,73,340,689,692,1.0,0.004335260115606936,0.9956647398843931,279,0.10549132947976879,0.4913294797687861,0.4031791907514451
234,012,354,6,36,101,348,354,1.0,0.01694915254237288,0.9830508474576272,217,0.1016949152542373,0.2853107344632768,0.6129943502824858
235,012,2933,23,1161,1771,2910,2933,1.9026606099935106,0.007841800204568702,0.9921581997954313,1,0.3958404364132288,0.60381861575179,0.00034094783498124785
236,012,1718,11,231,725,1707,1718,1.0,0.006402793946449359,0.9935972060535506,762,0.13445867287543656,0.4220023282887078,0.4435389988358556
237,012,199,0,14,80,199,199,1.0,0.0,1.0,105,0.07035175879396985,0.4020100502512563,0.5276381909547738
238,012,654,10,86,281,644,654,1.0,0.01529051987767584,0.9847094801223242,287,0.13149847094801223,0.42966360856269115,0.43883792048929665
239,012,415,2,47,174,413,415,1.0,0.004819277108433735,0.9951807228915662,194,0.11325301204819277,0.41927710843373495,0.4674698795180723
240,012,886,10,131,349,876,886,1.0,0.011286681715575621,0.9887133182844243,406,0.14785553047404063,0.3939051918735892,0.4582392776523702
242,013,7172,184,1770,1475,6988,7172,1.0,0.025655326268823202,0.9743446737311768,3927,0.2467930842163971,0.20566090351366426,0.5475460122699386
243,013,3591,23,1029,1788,3568,3591,1.0,0.006404901141743247,0.9935950988582567,774,0.28654970760233917,0.4979114452798663,0.21553884711779447
244,013,6883,208,1655,328,6675,6883,1.0,0.030219381083829724,0.9697806189161703,4900,0.24044747929681826,0.047653639401423795,0.7118988813017579
245,013,3567,49,875,1192,3518,3567,1.0,0.013737033922063359,0.9862629660779366,1500,0.24530417717970282,0.3341743762265209,0.42052144659377627
246,013,8662,63,2853,4067,8599,8662,1.0,0.00727314707919649,0.9927268529208035,1742,0.32936966058646966,0.46952205033479566,0.2011082890787347
247,013,1967,9,575,804,1958,1967,1.0,0.004575495678698526,0.9954245043213015,588,0.2923233350279614,0.40874428063040164,0.298932384341637
248,013,702,13,103,224,689,702,1.0,0.018518518518518517,0.9814814814814815,375,0.1467236467236467,0.3190883190883191,0.5341880341880342
249,013,4270,71,1936,1468,4199,4270,1.0,0.016627634660421546,0.9833723653395785,866,0.4533957845433255,0.3437939110070258,0.2028103044496487
250,013,4424,65,1422,1200,4359,4424,1.0,0.01469258589511754,0.9853074141048824,1802,0.32142857142857145,0.27124773960216997,0.4073236889692586
251,013,5783,219,1825,1300,5564,5783,1.0,0.03786961784540896,0.962130382154591,2658,0.31558014871174134,0.22479681826041847,0.45962303302784024
252,013,5046,40,2729,1874,5006,5046,1.0,0.007927070947284977,0.992072929052715,443,0.5408244153785177,0.37138327388030123,0.08779231074118113
253,013,3078,124,586,220,2954,3078,1.0,0.04028589993502274,0.9597141000649773,2272,0.1903833658219623,0.0714749837556855,0.7381416504223521
254,013,2267,8,662,955,2259,2267,1.0,0.0035288928098809,0.9964711071901191,650,0.29201588001764445,0.42126157917953244,0.2867225408028231
255,013,2817,32,304,489,2785,2817,1.0,0.011359602413915513,0.9886403975860845,2024,0.10791622293219737,0.17358892438764642,0.7184948526801562
256,013,1759,17,449,802,1742,1759,1.0,0.009664582148948267,0.9903354178510517,508,0.25525866969869243,0.4559408754974417,0.28880045480386585
257,013,3825,82,1096,549,3743,3825,1.0,0.021437908496732026,0.978562091503268,2180,0.2865359477124183,0.14352941176470588,0.5699346405228758
258,013,1925,16,811,708,1909,1925,1.0,0.008311688311688312,0.9916883116883117,406,0.4212987012987013,0.3677922077922078,0.2109090909090909
259,013,3301,77,914,906,3224,3301,1.0,0.023326264768252045,0.9766737352317479,1481,0.27688579218418663,0.2744622841563163,0.44865192365949713
260,013,4217,79,1179,1007,4138,4217,1.0,0.018733696940953285,0.9812663030590467,2031,0.2795826416884041,0.23879535214607542,0.48162200616552053
261,013,5612,33,1747,2191,5579,5612,1.0,0.005880256593014968,0.9941197434069851,1674,0.31129722024233786,0.39041339985744833,0.2982893799002138
262,013,4253,31,1430,1464,4222,4253,1.0,0.0072889724900070535,0.992711027509993,1359,0.3362332471196802,0.3442276040442041,0.31953914883611567
263,013,2602,26,462,875,2576,2602,1.0,0.009992313604919293,0.9900076863950807,1265,0.17755572636433511,0.33627978478093773,0.48616448885472713
264,013,3041,22,812,1117,3019,3041,1.0,0.007234462347911871,0.9927655376520881,1112,0.2670174284774745,0.3673133837553436,0.3656691877671818
265,013,6707,68,1704,2678,6639,6707,1.0,0.010138661100342925,0.9898613388996571,2325,0.25406291933800507,0.3992843298046817,0.34665275085731323
266,013,7255,40,2750,2884,7215,7255,1.0,0.005513439007580979,0.994486560992419,1621,0.37904893177119225,0.3975189524465886,0.22343211578221917
267,013,4466,71,1101,2368,4395,4466,1.0,0.015897895208240035,0.98410210479176,997,0.2465293327362293,0.5302283922973579,0.22324227496641288
268,013,3711,65,1702,1056,3646,3711,1.0,0.01751549447588251,0.9824845055241175,953,0.458636486122339,0.28455941794664513,0.2568040959310159
269,013,5075,131,2408,847,4944,5075,1.0,0.025812807881773397,0.9741871921182266,1820,0.47448275862068967,0.16689655172413792,0.3586206896551724
270,013,291,8,21,128,283,291,1.0,0.027491408934707903,0.9725085910652921,142,0.07216494845360824,0.43986254295532645,0.4879725085910653
271,013,2409,9,810,1012,2400,2409,1.0,0.0037359900373599006,0.9962640099626401,587,0.33623910336239105,0.4200913242009132,0.24366957243669574
272,013,3422,44,1323,1294,3378,3422,1.0,0.012857977790765635,0.9871420222092344,805,0.38661601402688484,0.3781414377556984,0.23524254821741672
273,013,2268,7,928,1124,2261,2268,1.0,0.0030864197530864196,0.9969135802469136,216,0.4091710758377425,0.49559082892416223,0.09523809523809523
274,013,4397,43,1062,1310,4354,4397,1.0,0.00977939504207414,0.9902206049579259,2025,0.24152831476006367,0.2979304070957471,0.4605412781441892
275,013,1744,53,544,356,1691,1744,1.0,0.030389908256880736,0.9696100917431193,844,0.3119266055045872,0.20412844036697247,0.48394495412844035
276,013,4339,41,1207,1869,4298,4339,1.0,0.00944918183913344,0.9905508181608665,1263,0.2781746946300991,0.4307444111546439,0.29108089421525696
277,013,4709,13,2036,2009,4696,4709,1.0,0.0027606710554257804,0.9972393289445742,664,0.43236355914206837,0.426629857719261,0.14100658313867062
278,013,4259,107,901,377,4152,4259,1.0,0.025123268372857478,0.9748767316271425,2981,0.2115520075135008,0.08851843155670346,0.6999295609297957
279,013,6596,87,1628,1960,6509,6596,1.0,0.013189812007277138,0.9868101879927229,3008,0.24681625227410553,0.2971497877501516,0.45603395997574286
280,013,5023,187,2038,950,4836,5023,1.0,0.037228747760302605,0.9627712522396974,2035,0.40573362532351187,0.18913000199084212,0.405136372685646
281,013,8872,444,2324,599,8428,8872,1.0,0.05004508566275924,0.9499549143372408,5949,0.26194770063119927,0.06751577998196573,0.670536519386835
282,013,2532,12,1089,779,2520,2532,1.0,0.004739336492890996,0.995260663507109,664,0.43009478672985785,0.3076619273301738,0.26224328593996843
283,013,6846,84,2563,2604,6762,6846,1.0,0.012269938650306749,0.9877300613496932,1679,0.37437919953257376,0.3803680981595092,0.24525270230791704
284,013,5283,21,1719,2538,5262,5283,1.0,0.003975014196479273,0.9960249858035207,1026,0.32538330494037476,0.4804088586030664,0.19420783645655879
285,013,2439,37,812,734,2402,2439,1.0,0.015170151701517014,0.984829848298483,893,0.3329233292332923,0.3009430094300943,0.36613366133661335
286,013,1826,3,877,689,1823,1826,1.0,0.0016429353778751369,0.9983570646221248,260,0.48028477546549836,0.3773274917853231,0.14238773274917854
287,013,2500,53,500,216,2447,2500,1.0,0.0212,0.9788,1784,0.2,0.0864,0.7136
288,013,8049,355,902,202,7694,8049,1.0,0.04410485774630389,0.9558951422536961,6945,0.1120636103863834,0.02509628525282644,0.8628401043607902
289,013,2762,13,1301,1078,2749,2762,1.0,0.004706734250543085,0.9952932657494569,383,0.4710354815351195,0.390296886314265,0.1386676321506155
290,013,4989,195,907,1895,4794,4989,1.0,0.039085989176187615,0.9609140108238123,2187,0.18179995991180598,0.37983563840448986,0.43836440168370416
291,013,13368,527,2650,1579,12841,13368,1.0,0.03942250149611012,0.9605774985038898,9139,0.19823459006582886,0.1181178934769599,0.6836475164572112
292,013,3126,8,900,1442,3118,3126,1.0,0.0025591810620601407,0.9974408189379399,784,0.28790786948176583,0.46129238643634035,0.2507997440818938
293,013,5256,75,1442,1511,5181,5256,1.0,0.014269406392694063,0.985730593607306,2303,0.2743531202435312,0.2874809741248097,0.4381659056316591
294,013,3349,77,746,1119,3272,3349,1.0,0.02299193789190803,0.977008062108092,1484,0.222753060615109,0.3341295909226635,0.44311734846222756
295,013,1261,0,361,601,1261,1261,1.0,0.0,1.0,299,0.28628072957969863,0.4766058683584457,0.23711340206185566
296,013,9292,146,2610,2094,9146,9292,1.0,0.01571244080929832,0.9842875591907017,4588,0.280886784330607,0.2253551442100732,0.4937580714593198
297,013,4482,69,1215,1508,4413,4482,1.0,0.015394912985274432,0.9846050870147256,1759,0.2710843373493976,0.3364569388665774,0.39245872378402497
298,013,2293,10,680,999,2283,2293,1.0,0.00436109899694723,0.9956389010030527,614,0.2965547317924117,0.43567378979502835,0.26777147841255994
299,013,3583,102,423,155,3481,3583,1.0,0.028467764443204018,0.971532235556796,3005,0.11805749372034607,0.043259838124476695,0.8386826681551772
300,013,4812,56,1259,1707,4756,4812,1.0,0.011637572734829594,0.9883624272651704,1846,0.26163757273482957,0.35473815461346636,0.38362427265170407
301,013,3867,3,1382,1968,3864,3867,1.0,0.0007757951900698216,0.9992242048099301,517,0.3573829842254978,0.5089216446858029,0.13369537108869925
302,013,7222,44,2218,3669,7178,7222,1.0,0.006092495153697037,0.993907504846303,1335,0.30711714206590973,0.5080310163389643,0.184851841595126
303,013,3176,86,520,717,3090,3176,1.0,0.02707808564231738,0.9729219143576826,1939,0.163727959697733,0.22575566750629722,0.6105163727959698
304,013,4742,216,1175,831,4526,4742,1.0,0.04555040067482075,0.9544495993251793,2736,0.24778574441164067,0.1752425137072965,0.5769717418810628
305,013,5219,67,1733,1719,5152,5219,1.0,0.01283770837325158,0.9871622916267484,1767,0.33205594941559685,0.32937344318835027,0.3385706073960529
306,013,209,2,40,81,207,209,1.0,0.009569377990430622,0.9904306220095693,88,0.19138755980861244,0.3875598086124402,0.42105263157894735
307,013,2263,20,831,885,2243,2263,1.0,0.008837825894829872,0.9911621741051702,547,0.3672116659301812,0.3910737958462218,0.241714538223597
308,013,755,4,104,231,751,755,1.0,0.005298013245033113,0.9947019867549669,420,0.13774834437086092,0.30596026490066225,0.5562913907284768
309,013,4731,175,1469,521,4556,4731,1.0,0.03699006552525893,0.963009934474741,2741,0.31050517860917354,0.11012470936377088,0.5793701120270556
310,013,10877,283,2828,2125,10594,10877,1.0,0.02601820354877264,0.9739817964512274,5924,0.25999816125769976,0.19536636940332813,0.5446354693389721
311,013,3267,7,1132,1473,3260,3267,1.0,0.0021426385062748698,0.9978573614937252,662,0.3464952555861647,0.4508723599632691,0.20263238445056628
312,013,3659,68,1699,650,3591,3659,1.0,0.018584312653730527,0.9814156873462695,1310,0.4643345176277672,0.17764416507242417,0.3580213172998087
313,013,2481,34,603,674,2447,2481,1.0,0.013704151551793631,0.9862958484482064,1204,0.2430471584038694,0.27166465135026197,0.4852881902458686
314,013,1498,6,841,574,1492,1498,1.0,0.004005340453938585,0.9959946595460614,83,0.5614152202937249,0.38317757009345793,0.05540720961281709
315,013,4428,36,1049,1434,4392,4428,1.0,0.008130081300813009,0.991869918699187,1945,0.2369015356820235,0.3238482384823848,0.4392502258355917
316,013,1788,66,418,95,1722,1788,1.0,0.03691275167785235,0.9630872483221476,1275,0.23378076062639822,0.053131991051454136,0.7130872483221476
317,013,4942,37,2498,2092,4905,4942,1.0,0.007486847430190206,0.9925131525698098,352,0.5054633751517604,0.42331040064751113,0.07122622420072845
318,013,3869,8,1180,1648,3861,3869,1.0,0.002067717756526234,0.9979322822434737,1041,0.30498836908761956,0.42594985784440426,0.26906177306797624
319,013,4098,20,1200,2203,4078,4098,1.0,0.004880429477794046,0.995119570522206,695,0.29282576866764276,0.5375793069790141,0.16959492435334309
320,013,2583,36,1104,628,2547,2583,1.0,0.013937282229965157,0.9860627177700348,851,0.4274099883855981,0.24312814556716997,0.3294618660472319
321,013,5069,58,1367,2704,5011,5069,1.0,0.01144209903333991,0.9885579009666601,998,0.2696784375616492,0.5334385480370882,0.19688301440126257
322,013,2917,17,1394,1189,2900,2917,1.0,0.005827905382242029,0.994172094617758,334,0.47788824134384644,0.4076105587932808,0.11450119986287281
323,013,247,1,97,141,246,247,1.0,0.004048582995951417,0.9959514170040485,9,0.39271255060728744,0.5708502024291497,0.03643724696356275
324,013,4185,44,1211,1884,4141,4185,1.0,0.010513739545997611,0.9894862604540023,1090,0.2893667861409797,0.45017921146953405,0.26045400238948624
325,013,3860,124,1227,425,3736,3860,1.0,0.03212435233160622,0.9678756476683937,2208,0.31787564766839377,0.11010362694300518,0.572020725388601
326,013,3632,34,1812,1206,3598,3632,1.0,0.009361233480176211,0.9906387665198237,614,0.4988986784140969,0.33204845814977973,0.16905286343612336
327,013,3461,17,1127,1853,3444,3461,1.0,0.004911875180583647,0.9950881248194163,481,0.3256284310892806,0.5353943946836175,0.13897717422710198
328,013,6755,180,1735,632,6575,6755,1.0,0.026646928201332347,0.9733530717986677,4388,0.25684678016284235,0.09356032568467802,0.6495928941524797
329,013,4315,120,1334,784,4195,4315,1.0,0.027809965237543453,0.9721900347624566,2197,0.30915411355735806,0.1816917728852839,0.5091541135573581
330,013,6552,82,1499,2060,6470,6552,1.0,0.012515262515262516,0.9874847374847375,2993,0.22878510378510378,0.3144078144078144,0.4568070818070818
331,013,3656,78,1086,1095,3578,3656,1.0,0.021334792122538294,0.9786652078774617,1475,0.29704595185995625,0.299507658643326,0.40344638949671774
332,013,3940,101,1473,1164,3839,3940,1.0,0.025634517766497462,0.9743654822335025,1303,0.3738578680203046,0.2954314720812183,0.33071065989847714
333,013,4979,140,1882,931,4839,4979,1.0,0.028118096003213498,0.9718819039967865,2166,0.37798754770034143,0.18698533842136975,0.4350271138782888
334,013,9890,210,3463,1174,9680,9890,1.0,0.021233569261880688,0.9787664307381193,5253,0.35015166835187056,0.11870576339737109,0.5311425682507583
335,013,3470,33,1028,1528,3437,3470,1.0,0.009510086455331412,0.9904899135446686,914,0.2962536023054755,0.4403458213256484,0.2634005763688761
336,013,5675,5,2177,2261,5670,5675,1.0,0.000881057268722467,0.9991189427312775,1237,0.3836123348017621,0.3984140969162996,0.2179735682819383
337,013,3794,13,1200,2039,3781,3794,1.0,0.003426462836056932,0.996573537163943,555,0.316288877174486,0.5374275171323142,0.1462836056931998
338,013,5880,387,2021,843,5493,5880,1.0,0.06581632653061224,0.9341836734693878,3016,0.34370748299319726,0.1433673469387755,0.5129251700680272
339,013,3666,141,802,750,3525,3666,1.0,0.038461538461538464,0.9615384615384616,2114,0.21876704855428258,0.20458265139116202,0.5766503000545554
340,013,4981,282,1952,597,4699,4981,1.0,0.056615137522585825,0.9433848624774142,2432,0.391889178879743,0.1198554507127083,0.4882553704075487
341,013,5820,166,1328,561,5654,5820,1.0,0.02852233676975945,0.9714776632302405,3931,0.2281786941580756,0.09639175257731959,0.6754295532646049
342,013,5857,31,2006,2793,5826,5857,1.0,0.005292812019805361,0.9947071879801946,1058,0.34249615844288883,0.4768652893973024,0.18063855215980879
343,013,3392,182,760,163,3210,3392,1.0,0.05365566037735849,0.9463443396226415,2469,0.2240566037735849,0.04805424528301887,0.7278891509433962
344,013,8127,258,3404,1051,7869,8127,1.0,0.031746031746031744,0.9682539682539683,3672,0.41885074443213977,0.12932201304294327,0.45182724252491696
345,013,3209,6,1188,1832,3203,3209,1.0,0.001869741352446245,0.9981302586475538,189,0.3702087877843565,0.5708943596135868,0.058896852602056717
346,013,2493,90,930,694,2403,2493,1.0,0.036101083032490974,0.9638989169675091,869,0.3730445246690734,0.27837946249498596,0.34857601283594064
347,013,6124,168,1607,1227,5956,6124,1.0,0.027433050293925537,0.9725669497060745,3290,0.2624101894186806,0.2003592423252776,0.5372305682560418
348,013,2356,52,690,762,2304,2356,1.0,0.022071307300509338,0.9779286926994907,904,0.2928692699490662,0.3234295415959253,0.3837011884550085
349,013,3896,17,1535,1618,3879,3896,1.0,0.004363449691991786,0.9956365503080082,743,0.39399383983572894,0.4152977412731006,0.19070841889117043
350,013,3962,40,1218,1246,3922,3962,1.0,0.010095911155981827,0.9899040888440181,1498,0.30742049469964666,0.31448763250883394,0.37809187279151946
351,013,3177,95,1515,754,3082,3177,1.0,0.029902423670129054,0.9700975763298709,908,0.4768649669499528,0.23733081523449795,0.28580421781554927
352,013,5828,102,1429,1505,5726,5828,1.0,0.017501715854495538,0.9824982841455044,2894,0.2451956074124914,0.2582361015785861,0.49656829100892247
353,013,8632,85,1624,2148,8547,8632,1.0,0.00984708063021316,0.9901529193697869,4860,0.1881371640407785,0.24884151992585726,0.5630213160333642
354,013,685,2,169,409,683,685,1.0,0.00291970802919708,0.997080291970803,107,0.24671532846715327,0.5970802919708029,0.1562043795620438
355,013,3955,10,1548,1554,3945,3955,1.0,0.0025284450063211127,0.9974715549936789,853,0.39140328697850824,0.3929203539823009,0.21567635903919088
356,013,1221,6,530,618,1215,1221,1.0,0.004914004914004914,0.995085995085995,73,0.43407043407043405,0.5061425061425061,0.05978705978705979
357,013,1481,18,780,440,1463,1481,1.0,0.012153950033760972,0.987846049966239,261,0.5266711681296421,0.2970965563808238,0.1762322754895341
358,013,4368,31,1594,2004,4337,4368,1.0,0.007097069597069597,0.9929029304029304,770,0.3649267399267399,0.45879120879120877,0.1762820512820513
359,013,2203,70,522,405,2133,2203,1.0,0.03177485247389923,0.9682251475261008,1276,0.23694961416250568,0.18384021788470267,0.5792101679527917
360,013,6039,68,2708,2258,5971,6039,1.0,0.011260142407683391,0.9887398575923166,1073,0.4484186123530386,0.3739029640668985,0.17767842358006292
361,013,2310,6,795,953,2304,2310,1.0,0.0025974025974025974,0.9974025974025974,562,0.34415584415584416,0.41255411255411256,0.24329004329004328
362,013,5596,125,1918,903,5471,5596,1.0,0.022337383845604002,0.977662616154396,2775,0.3427448177269478,0.16136526090064332,0.49588992137240884
363,013,7126,111,2644,2505,7015,7126,1.0,0.015576761156328936,0.9844232388436711,1977,0.37103564412012346,0.3515296098793152,0.27743474600056134
364,013,4251,62,1994,964,4189,4251,1.0,0.014584803575629263,0.9854151964243707,1293,0.46906610209362504,0.22677017172430017,0.3041637261820748
365,013,2855,72,878,397,2783,2855,1.0,0.025218914185639228,0.9747810858143607,1580,0.3075306479859895,0.13905429071803854,0.553415061295972
366,013,4804,71,1333,1588,4733,4804,1.0,0.014779350541215654,0.9852206494587843,1883,0.27747710241465445,0.3305578684429642,0.39196502914238135
367,013,4067,110,1191,583,3957,4067,1.0,0.027046963363658718,0.9729530366363413,2293,0.29284484878288664,0.1433489058273912,0.5638062453897221
368,013,7339,74,2676,2355,7265,7339,1.0,0.010083117590952446,0.9899168824090475,2308,0.36462733342417225,0.3208884044147704,0.31448426216105735
369,013,2172,37,874,763,2135,2172,1.0,0.01703499079189687,0.9829650092081031,535,0.40239410681399634,0.35128913443830573,0.24631675874769798
370,013,2253,30,913,762,2223,2253,1.0,0.013315579227696404,0.9866844207723036,578,0.40523746116289394,0.3382157123834887,0.25654682645361737
371,013,1709,2,472,817,1707,1709,1.0,0.0011702750146284377,0.9988297249853716,420,0.2761849034523113,0.47805734347571677,0.24575775307197192
372,013,2328,53,667,692,2275,2328,1.0,0.02276632302405498,0.977233676975945,969,0.2865120274914089,0.2972508591065292,0.4162371134020619
373,013,2919,3,1240,1289,2916,2919,1.0,0.0010277492291880781,0.998972250770812,390,0.4248030147310723,0.4415895854744776,0.13360739979445016
374,013,2385,37,745,712,2348,2385,1.0,0.01551362683438155,0.9844863731656185,928,0.31236897274633124,0.29853249475890986,0.3890985324947589
375,013,2840,67,773,280,2773,2840,1.0,0.023591549295774648,0.9764084507042253,1787,0.2721830985915493,0.09859154929577464,0.629225352112676
376,013,4470,72,2202,1302,4398,4470,1.0,0.016107382550335572,0.9838926174496644,966,0.49261744966442955,0.2912751677852349,0.21610738255033557
377,013,2753,56,1056,423,2697,2753,1.0,0.020341445695604796,0.9796585543043952,1274,0.3835815474028333,0.15365056302215765,0.4627678895750091
378,013,4854,60,1483,855,4794,4854,1.0,0.012360939431396786,0.9876390605686032,2516,0.3055212196126906,0.1761433868974042,0.5183353934899052
379,013,9134,540,538,258,8594,9134,1.0,0.05911977227939567,0.9408802277206043,8338,0.058900810159842346,0.028246113422377928,0.9128530764177797
380,013,1975,31,926,615,1944,1975,1.0,0.01569620253164557,0.9843037974683544,434,0.4688607594936709,0.31139240506329113,0.21974683544303797
381,013,4492,97,1690,1262,4395,4492,1.0,0.021593944790739093,0.9784060552092609,1540,0.37622439893143367,0.2809439002671416,0.3428317008014248
382,013,3380,28,1047,1718,3352,3380,1.0,0.008284023668639054,0.991715976331361,615,0.30976331360946746,0.508284023668639,0.1819526627218935
383,013,3606,119,680,440,3487,3606,1.0,0.03300055463117027,0.9669994453688298,2486,0.18857459789240155,0.12201885745978924,0.6894065446478093
384,013,10679,348,2046,2611,10331,10679,1.0,0.03258732091019759,0.9674126790898024,6022,0.19159097293754096,0.24449854855323533,0.5639104785092237
385,013,5330,15,1638,2415,5315,5330,1.0,0.0028142589118198874,0.9971857410881801,1277,0.3073170731707317,0.4530956848030019,0.2395872420262664
386,013,2080,26,489,569,2054,2080,1.0,0.0125,0.9875,1022,0.23509615384615384,0.27355769230769234,0.4913461538461538
387,013,1268,22,351,382,1246,1268,1.0,0.017350157728706624,0.9826498422712934,535,0.27681388012618297,0.30126182965299686,0.4219242902208202
388,013,3678,66,1037,1638,3612,3678,1.0,0.01794453507340946,0.9820554649265906,1003,0.28194671016856987,0.4453507340946166,0.2727025557368135
389,013,3993,38,1196,1333,3955,3993,1.0,0.009516654144753318,0.9904833458552467,1464,0.2995241672927623,0.3338342098672677,0.3666416228399699
390,013,4717,17,1169,2579,4700,4717,1.0,0.003603985584057664,0.9963960144159424,969,0.24782700869196522,0.546745813016748,0.20542717829128684
391,013,3278,27,802,1327,3251,3278,1.0,0.00823672971323978,0.9917632702867603,1149,0.24466137888956682,0.40482001220256253,0.3505186089078707
392,013,5135,43,1466,2320,5092,5135,1.0,0.008373904576436221,0.9916260954235637,1349,0.285491723466407,0.45180136319376824,0.2627069133398247
393,013,6910,251,1901,667,6659,6910,1.0,0.03632416787264833,0.9636758321273516,4342,0.2751085383502171,0.09652677279305355,0.6283646888567294
394,013,1417,1,411,661,1416,1417,1.0,0.0007057163020465773,0.9992942836979535,345,0.2900494001411433,0.4664784756527876,0.24347212420606917
395,013,5971,147,2221,1867,5824,5971,1.0,0.0246189917936694,0.9753810082063306,1883,0.371964495059454,0.3126779433930665,0.31535756154747946
396,013,2261,5,600,1008,2256,2261,1.0,0.0022114108801415304,0.9977885891198585,653,0.26536930561698363,0.4458204334365325,0.2888102609464839
397,013,1732,7,482,661,1725,1732,1.0,0.0040415704387990765,0.995958429561201,589,0.27829099307159355,0.3816397228637413,0.34006928406466513
398,013,7078,62,2257,2804,7016,7078,1.0,0.0087595365922577,0.9912404634077423,2017,0.3188753885278327,0.3961571065272676,0.2849675049448997
399,013,7759,151,2522,1626,7608,7759,1.0,0.019461270782317307,0.9805387292176827,3611,0.32504188684108776,0.20956308802680756,0.4653950251321047
400,013,3226,43,1142,1029,3183,3226,1.0,0.013329200247985121,0.9866707997520149,1055,0.3539987600743955,0.3189708617482951,0.32703037817730934
401,013,3495,89,961,265,3406,3495,1.0,0.025464949928469243,0.9745350500715307,2269,0.274964234620887,0.07582260371959942,0.6492131616595136
402,013,3156,50,646,875,3106,3156,1.0,0.015842839036755388,0.9841571609632446,1635,0.2046894803548796,0.27724968314321924,0.5180608365019012
403,013,2675,36,782,821,2639,2675,1.0,0.013457943925233645,0.9865420560747663,1072,0.29233644859813085,0.3069158878504673,0.40074766355140184
404,013,7207,128,1350,2157,7079,7207,1.0,0.01776051061468017,0.9822394893853198,3700,0.18731788538920494,0.2992923546551963,0.5133897599555988
405,013,3963,55,1080,1559,3908,3963,1.0,0.01387837496845824,0.9861216250315418,1324,0.27252081756245267,0.3933888468332072,0.33409033560434015
406,013,7043,233,1845,867,6810,7043,1.0,0.03308249325571489,0.9669175067442851,4331,0.2619622320034076,0.12310095129916229,0.61493681669743
407,013,3105,109,1229,460,2996,3105,1.0,0.03510466988727858,0.9648953301127214,1416,0.3958132045088567,0.14814814814814814,0.45603864734299515
408,013,7996,8,2997,3595,7988,7996,1.0,0.0010005002501250625,0.9989994997498749,1404,0.3748124062031016,0.44959979989994997,0.17558779389694848
409,013,5309,26,1038,3440,5283,5309,1.0,0.00489734413260501,0.995102655867395,831,0.19551704652476926,0.6479563006215859,0.15652665285364475
410,013,3989,77,960,1565,3912,3989,1.0,0.019303083479568814,0.9806969165204312,1464,0.2406618200050138,0.3923289044873402,0.367009275507646
411,013,1395,16,480,440,1379,1395,1.0,0.011469534050179211,0.9885304659498207,475,0.34408602150537637,0.3154121863799283,0.34050179211469533
412,013,3690,3,1487,1688,3687,3690,1.0,0.0008130081300813008,0.9991869918699187,515,0.4029810298102981,0.4574525745257453,0.13956639566395665
413,013,4018,71,1775,1085,3947,4018,1.0,0.01767048282727725,0.9823295171727228,1158,0.4417620706819313,0.2700348432055749,0.2882030861124938
414,013,8752,185,1840,1368,8567,8752,1.0,0.021138025594149908,0.9788619744058501,5544,0.21023765996343693,0.1563071297989031,0.6334552102376599
415,013,2221,18,704,1065,2203,2221,1.0,0.00810445745159838,0.9918955425484016,452,0.3169743358847366,0.4795137325529041,0.2035119315623593
416,013,2905,63,1243,762,2842,2905,1.0,0.021686746987951807,0.9783132530120482,900,0.4278829604130809,0.2623063683304647,0.3098106712564544
417,013,5764,67,1917,1796,5697,5764,1.0,0.011623872310895211,0.9883761276891048,2051,0.3325815405968078,0.31158917418459403,0.3558292852185982
418,013,5389,40,1638,2341,5349,5389,1.0,0.007422527370569679,0.9925774726294303,1410,0.30395249582482836,0.43440341436259045,0.2616440898125812
419,013,6498,46,1941,2981,6452,6498,1.0,0.007079101261926747,0.9929208987380732,1576,0.2987072945521699,0.458756540473992,0.2425361649738381
420,013,3373,3,992,1818,3370,3373,1.0,0.0008894159501927068,0.9991105840498073,563,0.2941002075303884,0.5389860658167803,0.1669137266528313
421,013,4440,22,917,2770,4418,4440,1.0,0.004954954954954955,0.9950450450450451,753,0.20653153153153153,0.6238738738738738,0.16959459459459458
422,013,3949,110,1200,1030,3839,3949,1.0,0.027855153203342618,0.9721448467966574,1719,0.30387439858191945,0.2608255254494809,0.43530007596859965
423,013,9857,116,2206,5300,9741,9857,1.0,0.011768286496905752,0.9882317135030942,2351,0.22380034493253526,0.5376889520137973,0.23851070305366745
424,013,7237,50,2263,3432,7187,7237,1.0,0.00690894016857814,0.9930910598314219,1542,0.3126986320298466,0.4742296531712035,0.21307171479894985
425,013,6968,256,1721,476,6712,6968,1.0,0.03673938002296211,0.9632606199770379,4771,0.24698622273249138,0.06831228473019518,0.6847014925373134
426,013,7596,104,2410,2226,7492,7596,1.0,0.01369141653501843,0.9863085834649815,2960,0.3172722485518694,0.2930489731437599,0.3896787783043707
427,013,2458,40,916,933,2418,2458,1.0,0.01627339300244101,0.983726606997559,609,0.3726606997558991,0.37957689178193654,0.24776240846216435
428,013,2385,56,838,797,2329,2385,1.0,0.02348008385744235,0.9765199161425576,750,0.35136268343815513,0.33417190775681344,0.31446540880503143
429,013,5483,138,1350,451,5345,5483,1.0,0.025168703264636147,0.9748312967353638,3682,0.24621557541491884,0.08225424037935437,0.6715301842057267
430,013,6712,97,2426,1884,6615,6712,1.0,0.014451728247914183,0.9855482717520858,2402,0.36144219308700837,0.2806912991656734,0.35786650774731826
431,013,2592,79,984,558,2513,2592,1.0,0.030478395061728395,0.9695216049382716,1050,0.37962962962962965,0.2152777777777778,0.4050925925925926
432,013,7074,15,2406,3576,7059,7074,1.0,0.0021204410517387615,0.9978795589482612,1092,0.34011874469889736,0.5055131467345207,0.15436810856658184
433,013,8731,212,3733,1616,8519,8731,1.0,0.024281296529607147,0.9757187034703928,3382,0.42755698087275223,0.18508761882945826,0.3873554002977895
434,013,2019,18,823,813,2001,2019,1.0,0.008915304606240713,0.9910846953937593,383,0.40762753838533927,0.4026745913818722,0.1896978702327885
435,013,5880,109,2478,1842,5771,5880,1.0,0.018537414965986394,0.9814625850340136,1560,0.42142857142857143,0.31326530612244896,0.2653061224489796
436,013,2830,5,1145,1484,2825,2830,1.0,0.0017667844522968198,0.9982332155477032,201,0.4045936395759717,0.5243816254416961,0.07102473498233215
437,013,3007,18,988,1528,2989,3007,1.0,0.005986032590621883,0.9940139674093781,491,0.32856667775191223,0.5081476554705687,0.16328566677751913
438,013,2118,34,836,423,2084,2118,1.0,0.016052880075542966,0.983947119924457,859,0.3947119924457035,0.19971671388101983,0.40557129367327666
439,013,7041,54,1903,2579,6987,7041,1.0,0.007669365146996165,0.9923306348530039,2559,0.2702741087913649,0.36628319840931683,0.3634426927993183
440,013,3411,111,1145,615,3300,3411,1.0,0.032541776605101144,0.9674582233948988,1651,0.33567868660216943,0.1802990325417766,0.4840222808560539
441,013,2952,3,1167,1221,2949,2952,1.0,0.0010162601626016261,0.9989837398373984,564,0.3953252032520325,0.4136178861788618,0.1910569105691057
442,013,5800,84,1783,2587,5716,5800,1.0,0.014482758620689656,0.9855172413793103,1430,0.3074137931034483,0.4460344827586207,0.24655172413793103
443,013,5000,161,1493,1092,4839,5000,1.0,0.0322,0.9678,2415,0.2986,0.2184,0.483
444,013,4756,171,1360,923,4585,4756,1.0,0.035954583683767874,0.9640454163162321,2473,0.28595458368376786,0.19407064760302775,0.5199747687132044
445,013,4964,184,1089,264,4780,4964,1.0,0.037066881547139406,0.9629331184528606,3611,0.21937953263497179,0.0531829170024174,0.7274375503626108
446,013,4879,93,1201,1313,4786,4879,1.0,0.019061283049805287,0.9809387169501947,2365,0.2461569993851199,0.2691125230580037,0.4847304775568764
447,013,10015,53,2401,5314,9962,10015,1.0,0.0052920619071392914,0.9947079380928607,2300,0.2397403894158762,0.5306040938592111,0.22965551672491263
448,013,5637,287,1686,655,5350,5637,1.0,0.05091360652829519,0.9490863934717048,3296,0.2990952634379989,0.11619655845307787,0.5847081781089232
449,013,4025,13,1475,1968,4012,4025,1.0,0.003229813664596273,0.9967701863354037,582,0.36645962732919257,0.488944099378882,0.14459627329192545
450,013,2257,45,482,625,2212,2257,1.0,0.01993797075764289,0.9800620292423571,1150,0.21355782011519717,0.2769162605228179,0.5095259193619849
451,013,2983,14,1059,1292,2969,2983,1.0,0.004693261816962789,0.9953067381830372,632,0.35501173315454243,0.43312101910828027,0.21186724773717733
452,013,3738,53,1131,1505,3685,3738,1.0,0.014178705189941144,0.9858212948100589,1102,0.3025682182985554,0.40262172284644193,0.29481005885500267
453,013,3102,133,825,531,2969,3102,1.0,0.042875564152159894,0.9571244358478401,1746,0.26595744680851063,0.17117988394584138,0.562862669245648
454,013,5165,266,1306,259,4899,5165,1.0,0.05150048402710552,0.9484995159728945,3600,0.25285575992255566,0.05014520813165537,0.6969990319457889
455,013,10049,494,2417,1195,9555,10049,1.0,0.04915912031047866,0.9508408796895214,6437,0.24052144491989252,0.11891730520449796,0.6405612498756095
456,013,3180,59,1325,730,3121,3180,1.0,0.018553459119496855,0.9814465408805031,1125,0.4166666666666667,0.22955974842767296,0.35377358490566035
457,013,7228,131,2019,1574,7097,7228,1.0,0.018123962368566685,0.9818760376314333,3635,0.27933038184836745,0.21776425013835085,0.5029053680132817
458,013,5336,176,821,757,5160,5336,1.0,0.03298350824587706,0.967016491754123,3758,0.15386056971514242,0.1418665667166417,0.704272863568216
459,013,6139,288,2217,665,5851,6139,1.0,0.04691317804202639,0.9530868219579736,3257,0.36113373513601565,0.10832383124287344,0.530542433621111
460,013,3023,2,906,1296,3021,3023,1.0,0.0006615944426066821,0.9993384055573933,821,0.299702282500827,0.42871319880913,0.271584518690043
461,013,5341,94,1947,1597,5247,5341,1.0,0.017599700430630968,0.982400299569369,1797,0.36453847594083505,0.2990076764650814,0.33645384759408353
462,013,3377,58,1997,573,3319,3377,1.0,0.017175007403020432,0.9828249925969795,807,0.5913532721350311,0.16967722830915014,0.23896949955581878
463,013,4713,44,1206,1840,4669,4713,1.0,0.009335879482283047,0.9906641205177169,1667,0.2558879694462126,0.3904095056227456,0.3537025249310418
464,013,3680,53,951,1847,3627,3680,1.0,0.014402173913043478,0.9855978260869566,882,0.2584239130434783,0.5019021739130435,0.23967391304347826
465,013,8885,298,2480,757,8587,8885,1.0,0.033539673607203155,0.9664603263927969,5648,0.2791221159257175,0.08519977490151942,0.6356781091727631
466,013,2249,39,698,543,2210,2249,1.0,0.017341040462427744,0.9826589595375722,1008,0.31036016007114275,0.2414406402845709,0.44819919964428634
467,013,10033,163,2235,3156,9870,10033,1.0,0.016246386923153593,0.9837536130768464,4642,0.22276487590949864,0.3145619455795874,0.462673178510914
468,013,8522,568,2291,1064,7954,8522,1.0,0.0666510208871157,0.9333489791128843,5167,0.26883360713447546,0.12485332081670969,0.6063130720488148
469,013,7895,65,2610,3259,7830,7895,1.0,0.008233058898036731,0.9917669411019633,2026,0.3305889803673211,0.4127929069031032,0.2566181127295757
470,013,4645,86,2341,918,4559,4645,1.0,0.018514531754574813,0.9814854682454252,1386,0.5039827771797631,0.19763186221743811,0.2983853606027987
471,013,1638,2,674,719,1636,1638,1.0,0.001221001221001221,0.9987789987789988,245,0.41147741147741146,0.43894993894993894,0.14957264957264957
472,013,4196,209,1147,907,3987,4196,1.0,0.0498093422306959,0.9501906577693041,2142,0.27335557673975214,0.2161582459485224,0.5104861773117254
473,013,7886,79,1923,3342,7807,7886,1.0,0.010017752979964495,0.9899822470200355,2621,0.2438498605123003,0.423788993152422,0.3323611463352777
474,013,6856,59,1589,3531,6797,6856,1.0,0.008605600933488914,0.9913943990665111,1736,0.23176779463243874,0.5150233372228705,0.2532088681446908
475,013,6349,38,1924,3194,6311,6349,1.0,0.0059851945188218614,0.9940148054811782,1231,0.30303984879508583,0.5030713498188691,0.19388880138604506
476,013,5095,60,1930,1721,5035,5095,1.0,0.011776251226692836,0.9882237487733072,1444,0.3788027477919529,0.33778213935230617,0.28341511285574095
477,013,9104,274,3219,2221,8830,9104,1.0,0.030096660808435854,0.9699033391915641,3664,0.3535808435852373,0.24395869947275922,0.4024604569420035
478,013,5446,33,2460,2170,5413,5446,1.0,0.006059493206022769,0.9939405067939773,816,0.45170767535806094,0.39845758354755784,0.1498347410943812
479,013,778,644,259,98,134,778,1.0,0.8277634961439588,0.17223650385604114,421,0.3329048843187661,0.12596401028277635,0.5411311053984575
480,013,3935,22,1121,1561,3913,3935,1.0,0.0055908513341804324,0.9944091486658195,1253,0.2848792884371029,0.3966963151207116,0.3184243964421855
481,013,5293,40,1531,2341,5253,5293,1.0,0.007557150954090308,0.9924428490459097,1421,0.2892499527678065,0.4422822595881353,0.2684677876440582
482,013,4975,47,1906,1544,4928,4975,1.0,0.009447236180904522,0.9905527638190955,1525,0.3831155778894472,0.31035175879396987,0.3065326633165829
483,013,2280,19,853,874,2261,2280,1.0,0.008333333333333333,0.9916666666666667,553,0.37412280701754386,0.38333333333333336,0.2425438596491228
484,013,3830,48,862,1470,3782,3830,1.0,0.012532637075718016,0.9874673629242819,1498,0.22506527415143604,0.3838120104438642,0.39112271540469973
485,013,6604,28,1959,3115,6576,6604,1.0,0.004239854633555421,0.9957601453664445,1530,0.29663840096910965,0.4716838279830406,0.23167777104784978
486,013,8903,33,3343,3582,8870,8903,1.0,0.0037066157475008424,0.9962933842524991,1978,0.37549140739076714,0.4023362911378187,0.22217230147141412
487,013,8641,244,3261,2118,8397,8641,1.0,0.028237472514755238,0.9717625274852447,3262,0.37738687651892144,0.2451105196157852,0.3775026038652934
488,013,5418,163,1924,882,5255,5418,1.0,0.030084902177925435,0.9699150978220745,2612,0.35511258767072723,0.16279069767441862,0.4820967146548542
489,013,2919,198,842,179,2721,2919,1.0,0.06783144912641316,0.9321685508735869,1898,0.28845495032545393,0.06132237067488866,0.6502226789996575
490,013,8284,280,1803,360,8004,8284,1.0,0.03380009657170449,0.9661999034282955,6121,0.21764847899565426,0.04345726702076291,0.7388942539835828
491,013,4860,26,1250,2126,4834,4860,1.0,0.005349794238683128,0.9946502057613169,1484,0.257201646090535,0.4374485596707819,0.30534979423868314
492,013,4147,64,1270,1351,4083,4147,1.0,0.015432843019049916,0.9845671569809501,1526,0.30624547865927176,0.3257776706052568,0.36797685073547143
493,013,3475,32,992,1585,3443,3475,1.0,0.00920863309352518,0.9907913669064748,898,0.2854676258992806,0.45611510791366905,0.25841726618705035
494,013,6282,114,2207,1771,6168,6282,1.0,0.018147086914995225,0.9818529130850048,2304,0.35132123527539,0.2819165870741802,0.3667621776504298
495,013,2349,46,812,604,2303,2349,1.0,0.019582801191996593,0.9804171988080034,933,0.345679012345679,0.2571306939123031,0.39719029374201786
496,013,6407,199,2126,1493,6208,6407,1.0,0.031059778367410643,0.9689402216325893,2788,0.331824566879975,0.23302637739971907,0.43514905572030593
497,013,5912,330,212,307,5582,5912,1.0,0.055818673883626525,0.9441813261163735,5393,0.03585926928281461,0.05192828146143437,0.9122124492557511
498,013,4174,55,1404,1599,4119,4174,1.0,0.01317680881648299,0.986823191183517,1171,0.33636799233349307,0.3830857690464782,0.28054623862002875
499,013,6373,82,2126,2195,6291,6373,1.0,0.012866781735446415,0.9871332182645536,2052,0.3335948532873058,0.3444217793817668,0.32198336733092736
500,013,5299,142,1233,989,5157,5299,1.0,0.02679750896395546,0.9732024910360445,3077,0.2326854123419513,0.18663898848839403,0.5806755991696546
501,013,2081,27,1150,747,2054,2081,1.0,0.012974531475252283,0.9870254685247477,184,0.5526189332051898,0.3589620374819798,0.08841902931283037
502,013,2925,55,1289,656,2870,2925,1.0,0.018803418803418803,0.9811965811965812,980,0.4406837606837607,0.2242735042735043,0.335042735042735
503,013,3806,44,1043,2123,3762,3806,1.0,0.011560693641618497,0.9884393063583815,640,0.2740409879138203,0.5578034682080925,0.16815554387808723
504,013,1655,6,724,685,1649,1655,1.0,0.0036253776435045317,0.9963746223564954,246,0.43746223564954684,0.41389728096676737,0.1486404833836858
505,013,4561,7,1446,2335,4554,4561,1.0,0.0015347511510633632,0.9984652488489366,780,0.31703573777680333,0.5119491339618505,0.17101512826134618
506,013,8436,147,1877,1983,8289,8436,1.0,0.017425320056899004,0.982574679943101,4576,0.22249881460407775,0.23506401137980085,0.5424371740161213
507,013,232,0,61,164,232,232,1.0,0.0,1.0,7,0.2629310344827586,0.7068965517241379,0.03017241379310345
508,013,2716,56,730,455,2660,2716,1.0,0.020618556701030927,0.979381443298969,1531,0.26877761413843887,0.16752577319587628,0.5636966126656848
509,013,7571,262,1678,535,7309,7571,1.0,0.034605732399947166,0.9653942676000529,5358,0.22163518689737155,0.07066437722889975,0.7077004358737287
510,013,6072,1,1974,2589,6071,6072,1.0,0.00016469038208168644,0.9998353096179183,1509,0.325098814229249,0.42638339920948615,0.24851778656126483
511,013,5665,27,1620,2310,5638,5665,1.0,0.004766107678729038,0.9952338923212709,1735,0.28596646072374227,0.4077669902912621,0.3062665489849956
512,013,5002,8,1298,2702,4994,5002,1.0,0.001599360255897641,0.9984006397441023,1002,0.25949620151939223,0.5401839264294283,0.20031987205117952
513,013,2636,1,929,1347,2635,2636,1.0,0.00037936267071320183,0.9996206373292867,360,0.3524279210925645,0.5110015174506829,0.13657056145675264
514,013,3179,18,845,1602,3161,3179,1.0,0.005662157911292859,0.9943378420887071,732,0.2658068575023592,0.5039320541050645,0.23026108839257628
515,013,4062,104,1526,365,3958,4062,1.0,0.025603151157065487,0.9743968488429345,2171,0.37567700640078777,0.08985721319547021,0.534465780403742
516,013,7229,85,2068,2666,7144,7229,1.0,0.0117581961543782,0.9882418038456218,2495,0.28606999585004844,0.3687923640890856,0.34513764006086595
517,013,4696,38,1547,1560,4658,4696,1.0,0.008091993185689948,0.99190800681431,1589,0.32942930153321975,0.3321976149914821,0.33837308347529815
518,013,1723,1,493,769,1722,1723,1.0,0.0005803830528148578,0.9994196169471852,461,0.2861288450377249,0.4463145676146257,0.2675565873476494
519,013,6281,173,1369,1247,6108,6281,1.0,0.027543384811335773,0.9724566151886642,3665,0.21795892373825823,0.19853526508517752,0.5835058111765642
520,013,5387,87,1601,2444,5300,5387,1.0,0.016149990718396137,0.9838500092816038,1342,0.29719695563393356,0.45368479673287543,0.24911824763319101
521,013,3781,1795,1629,222,1986,3781,1.0,0.4747421317111875,0.5252578682888125,1930,0.43083840253901085,0.058714625760380855,0.5104469717006083
522,013,7029,279,1540,790,6750,7029,1.0,0.03969270166453265,0.9603072983354674,4699,0.2190923317683881,0.11239152084222506,0.6685161473893868
523,013,3428,71,1208,521,3357,3428,1.0,0.020711785297549593,0.9792882147024504,1699,0.352392065344224,0.15198366394399065,0.4956242707117853
524,013,4006,95,2041,1022,3911,4006,1.0,0.023714428357463804,0.9762855716425362,943,0.5094857713429856,0.255117324013979,0.23539690464303545
525,013,2018,4,242,511,2014,2018,1.0,0.0019821605550049554,0.998017839444995,1265,0.1199207135777998,0.25322101090188304,0.6268582755203171
526,013,3142,5,889,1770,3137,3142,1.0,0.001591343093570974,0.998408656906429,483,0.2829408020369192,0.5633354551241248,0.15372374283895607
527,013,8171,253,1904,1248,7918,8171,1.0,0.03096316240362257,0.9690368375963775,5019,0.233019214294456,0.1527352833190552,0.6142455023864888
528,013,5824,125,1622,2139,5699,5824,1.0,0.021462912087912088,0.9785370879120879,2063,0.27850274725274726,0.3672733516483517,0.3542239010989011
529,013,295,11,45,69,284,295,1.0,0.03728813559322034,0.9627118644067797,181,0.15254237288135594,0.23389830508474577,0.6135593220338983
530,013,1892,61,502,424,1831,1892,1.0,0.03224101479915433,0.9677589852008457,966,0.2653276955602537,0.22410147991543342,0.5105708245243129
531,013,4944,166,851,174,4778,4944,1.0,0.03357605177993527,0.9664239482200647,3919,0.17212783171521034,0.03519417475728155,0.7926779935275081
532,013,477,6,64,87,471,477,1.0,0.012578616352201259,0.9874213836477987,326,0.13417190775681342,0.18238993710691823,0.6834381551362684
533,013,3911,16,1162,1926,3895,3911,1.0,0.004091025313219126,0.9959089746867809,823,0.29711071337253897,0.4924571720787522,0.21043211454870878
534,013,4665,148,1315,860,4517,4665,1.0,0.03172561629153269,0.9682743837084673,2490,0.28188638799571275,0.18435155412647375,0.5337620578778135
535,013,5400,97,900,1468,5303,5400,1.0,0.017962962962962962,0.982037037037037,3032,0.16666666666666666,0.27185185185185184,0.5614814814814815
536,013,5645,153,1120,204,5492,5645,1.0,0.027103631532329496,0.9728963684676705,4321,0.19840566873339238,0.036138175376439326,0.7654561558901682
537,013,6851,286,1688,1063,6565,6851,1.0,0.04174573055028463,0.9582542694497154,4100,0.24638738870237922,0.15515983068165232,0.5984527806159685
538,013,6652,169,2430,429,6483,6652,1.0,0.025405892964521948,0.974594107035478,3793,0.36530366806975345,0.06449188214070956,0.570204449789537
539,013,5966,54,1790,3231,5912,5966,1.0,0.009051290646999664,0.9909487093530004,945,0.3000335232986926,0.5415688903788133,0.15839758632249412
540,013,61,61,31,0,0,61,1.0,1.0,0.0,30,0.5081967213114754,0.0,0.4918032786885246
541,013,6072,242,2460,713,5830,6072,1.0,0.03985507246376811,0.9601449275362319,2899,0.4051383399209486,0.11742424242424243,0.47743741765480896
542,013,7471,46,2234,3402,7425,7471,1.0,0.006157140944987284,0.9938428590550127,1835,0.29902288850220854,0.4553607281488422,0.24561638334894928
543,013,7475,86,2358,3272,7389,7475,1.0,0.011505016722408027,0.988494983277592,1845,0.3154515050167224,0.4377257525083612,0.2468227424749164
544,013,3156,6,932,1296,3150,3156,1.0,0.0019011406844106464,0.9980988593155894,928,0.2953105196451204,0.41064638783269963,0.29404309252217997
545,013,2656,7,998,1292,2649,2656,1.0,0.0026355421686746986,0.9973644578313253,366,0.3757530120481928,0.4864457831325301,0.1378012048192771
546,013,3503,27,1377,1588,3476,3503,1.0,0.0077076791321724234,0.9922923208678276,538,0.3930916357407936,0.45332572081073363,0.15358264344847275
547,013,1656,61,502,148,1595,1656,1.0,0.03683574879227053,0.9631642512077294,1006,0.3031400966183575,0.0893719806763285,0.607487922705314
548,013,5086,366,1347,995,4720,5086,1.0,0.07196224931183641,0.9280377506881636,2744,0.26484467164766023,0.19563507668108535,0.5395202516712544
549,013,2761,74,699,206,2687,2761,1.0,0.026801883375588555,0.9731981166244115,1856,0.25316914161535675,0.0746106483158276,0.6722202100688156
550,013,7111,194,2019,620,6917,7111,1.0,0.027281676276191817,0.9727183237238082,4472,0.28392631134861485,0.08718886232597384,0.6288848263254113
551,013,4354,113,1764,791,4241,4354,1.0,0.025953146531924667,0.9740468534680753,1799,0.40514469453376206,0.18167202572347266,0.41318327974276525
552,013,3184,132,995,307,3052,3184,1.0,0.0414572864321608,0.9585427135678392,1882,0.3125,0.09641959798994974,0.5910804020100503
553,013,7885,224,1675,424,7661,7885,1.0,0.02840837032339886,0.9715916296766012,5786,0.212428662016487,0.05377298668357641,0.7337983512999365
554,013,7742,195,1939,519,7547,7742,1.0,0.025187290105915784,0.9748127098940842,5284,0.2504520795660036,0.06703694135882202,0.6825109790751743
555,013,4387,3148,1621,486,1239,4387,1.0,0.7175746523820379,0.2824253476179622,2280,0.3695007978117164,0.11078185548210623,0.5197173467061773
556,013,5954,186,2219,497,5768,5954,1.0,0.03123950285522338,0.9687604971447766,3238,0.37269062814914344,0.08347329526368828,0.5438360765871683
557,013,6757,144,1477,1881,6613,6757,1.0,0.021311232795619358,0.9786887672043807,3399,0.21858813082729023,0.27837797839277784,0.5030338907799319
558,013,2937,11,1240,1304,2926,2937,1.0,0.003745318352059925,0.9962546816479401,393,0.42219952332311883,0.44399046646237655,0.1338100102145046
559,013,5530,24,2086,2309,5506,5530,1.0,0.00433996383363472,0.9956600361663652,1135,0.37721518987341773,0.41754068716094034,0.20524412296564196
560,013,6816,19,2005,2441,6797,6816,1.0,0.0027875586854460093,0.997212441314554,2370,0.29416079812206575,0.3581279342723005,0.3477112676056338
561,013,2652,45,954,724,2607,2652,1.0,0.016968325791855202,0.9830316742081447,974,0.3597285067873303,0.2730015082956259,0.36726998491704377
562,013,17333,284,2055,648,17049,17333,1.0,0.0163849304794323,0.9836150695205677,14630,0.11855997230715976,0.03738533433335257,0.8440546933594877
563,013,5962,119,1769,1075,5843,5962,1.0,0.019959745051995974,0.9800402549480041,3118,0.29671251257967124,0.18030862126803085,0.5229788661522979
564,013,3901,57,1286,1137,3844,3901,1.0,0.014611638041527814,0.9853883619584722,1478,0.32965906177903104,0.2914637272494232,0.37887721097154575
565,013,8877,758,2417,1016,8119,8877,1.0,0.085389208065788,0.914610791934212,5444,0.2722766700461868,0.11445308099583193,0.6132702489579813
566,013,3644,21,1033,1854,3623,3644,1.0,0.005762897914379802,0.9942371020856202,757,0.2834796926454446,0.508781558726674,0.20773874862788144
567,013,2987,83,702,192,2904,2987,1.0,0.02778707733511885,0.9722129226648811,2093,0.23501841312353533,0.06427854034147974,0.7007030465349849
568,013,8768,67,3038,3420,8701,8768,1.0,0.007641423357664234,0.9923585766423357,2310,0.3464872262773723,0.39005474452554745,0.2634580291970803
569,013,4501,28,1500,1631,4473,4501,1.0,0.006220839813374806,0.9937791601866252,1370,0.33325927571650743,0.36236391912908245,0.3043768051544101
570,013,3473,75,1125,917,3398,3473,1.0,0.021595162683558884,0.9784048373164411,1431,0.32392744025338327,0.2640368557443133,0.4120357040023035
571,013,1614,3,444,797,1611,1614,1.0,0.0018587360594795538,0.9981412639405205,373,0.275092936802974,0.49380421313506817,0.23110285006195788
572,013,4654,96,1553,1152,4558,4654,1.0,0.020627417275461968,0.979372582724538,1949,0.33369144821658786,0.2475290073055436,0.4187795444778685
573,013,6830,115,1986,788,6715,6830,1.0,0.01683748169838946,0.9831625183016105,4056,0.29077598828696927,0.11537335285505125,0.5938506588579795
574,013,4740,38,1253,1838,4702,4740,1.0,0.008016877637130802,0.9919831223628692,1649,0.26434599156118144,0.38776371308016877,0.3478902953586498
575,013,5694,52,1622,1937,5642,5694,1.0,0.0091324200913242,0.9908675799086758,2135,0.2848612574639972,0.3401826484018265,0.3749560941341763
576,013,2099,56,522,795,2043,2099,1.0,0.0266793711291091,0.9733206288708909,782,0.2486898523106241,0.37875178656503095,0.37255836112434493
577,013,4539,77,1976,1297,4462,4539,1.0,0.01696408900638907,0.9830359109936109,1266,0.4353381802159066,0.2857457589777484,0.278916060806345
578,013,3203,13,1251,1420,3190,3203,1.0,0.004058694973462379,0.9959413050265377,532,0.39057133936934124,0.44333437402435216,0.1660942866063066
579,013,4095,48,1914,1139,4047,4095,1.0,0.011721611721611722,0.9882783882783883,1042,0.4673992673992674,0.27814407814407816,0.25445665445665444
580,013,2186,9,997,1049,2177,2186,1.0,0.004117108874656907,0.9958828911253431,140,0.45608417200365964,0.479871912168344,0.06404391582799634
581,013,8068,199,2036,1495,7869,8068,1.0,0.024665344571145265,0.9753346554288548,4537,0.2523549826474963,0.18529995042141795,0.5623450669310858
582,013,6129,160,1577,841,5969,6129,1.0,0.026105400554739762,0.9738945994452602,3711,0.25730135421765377,0.13721651166585086,0.6054821341164953
583,013,7523,73,2249,3172,7450,7523,1.0,0.00970357570118304,0.9902964242988169,2102,0.29894988701315967,0.42164030307058353,0.2794098099162568
584,013,2102,11,529,882,2091,2102,1.0,0.005233111322549952,0.99476688867745,691,0.25166508087535683,0.4196003805899144,0.32873453853472884
585,013,4947,77,1295,1583,4870,4947,1.0,0.015564988882150799,0.9844350111178493,2069,0.2617748130179907,0.31999191429148977,0.4182332726905195
586,013,1038,2,429,566,1036,1038,1.0,0.0019267822736030828,0.9980732177263969,43,0.41329479768786126,0.5452793834296724,0.041425818882466284
587,013,10722,549,2381,1272,10173,10722,1.0,0.05120313374370453,0.9487968662562954,7069,0.22206677858608467,0.11863458310016788,0.6592986383137475
588,013,1631,2,463,698,1629,1631,1.0,0.001226241569589209,0.9987737584304108,470,0.2838749233599019,0.42795830778663396,0.28816676885346415
589,013,7308,416,2863,1590,6892,7308,1.0,0.05692391899288451,0.9430760810071155,2855,0.39176245210727967,0.2175697865353038,0.39066776135741654
590,013,1465,1353,392,37,112,1465,1.0,0.9235494880546075,0.07645051194539249,1036,0.2675767918088737,0.025255972696245733,0.7071672354948806
591,013,2722,56,935,793,2666,2722,1.0,0.020573108008817047,0.9794268919911829,994,0.3434974283614989,0.2913299044819985,0.3651726671565026
592,013,5458,10,1678,2473,5448,5458,1.0,0.001832172957127153,0.9981678270428729,1307,0.30743862220593626,0.4530963722975449,0.23946500549651886
593,013,7663,52,2033,3966,7611,7663,1.0,0.006785854104136761,0.9932141458958632,1664,0.2653007960328853,0.5175518726347383,0.21714733133237635
594,013,1748,0,515,760,1748,1748,1.0,0.0,1.0,473,0.29462242562929064,0.43478260869565216,0.2705949656750572
595,013,4583,81,2241,1591,4502,4583,1.0,0.01767401265546585,0.9823259873445341,751,0.4889810168012219,0.3471525201832861,0.16386646301549204
596,013,2020,26,878,678,1994,2020,1.0,0.01287128712871287,0.9871287128712871,464,0.43465346534653465,0.33564356435643566,0.2297029702970297
597,013,7290,40,2696,2588,7250,7290,1.0,0.0054869684499314125,0.9945130315500685,2006,0.3698216735253772,0.3550068587105624,0.2751714677640604
598,013,4386,66,1689,1611,4320,4386,1.0,0.015047879616963064,0.9849521203830369,1086,0.3850889192886457,0.36730506155950754,0.2476060191518468
599,013,5990,69,1579,2350,5921,5990,1.0,0.011519198664440735,0.9884808013355593,2061,0.2636060100166945,0.39232053422370616,0.34407345575959936
600,013,5639,24,1833,2857,5615,5639,1.0,0.00425607377194538,0.9957439262280546,949,0.3250576343323284,0.5066501152686647,0.16829225039900692
601,013,5768,201,1894,589,5567,5768,1.0,0.03484743411927878,0.9651525658807212,3285,0.32836338418862693,0.10211511789181692,0.5695214979195562
602,013,1901,5,712,871,1896,1901,1.0,0.0026301946344029457,0.997369805365597,318,0.3745397159389795,0.4581799053129932,0.16728037874802734
603,013,4483,135,1564,449,4348,4483,1.0,0.030113763105063574,0.9698862368949365,2470,0.3488735221949587,0.10015614543832255,0.5509703323667187
604,013,9006,236,3632,1339,8770,9006,1.0,0.02620475238729736,0.9737952476127026,4035,0.40328669775705084,0.14867865867199645,0.4480346435709527
605,013,591,5,253,253,586,591,1.0,0.008460236886632826,0.9915397631133672,85,0.428087986463621,0.428087986463621,0.14382402707275804
606,013,4142,261,719,1235,3881,4142,1.0,0.06301303718010623,0.9369869628198938,2188,0.1735876388218252,0.2981651376146789,0.5282472235634958
607,013,3075,8,874,1328,3067,3075,1.0,0.0026016260162601626,0.9973983739837399,873,0.2842276422764228,0.431869918699187,0.2839024390243902
608,013,2579,111,799,211,2468,2579,1.0,0.04303993796044979,0.9569600620395502,1569,0.3098100038774719,0.08181465684373788,0.6083753392787903
609,013,2850,31,759,1114,2819,2850,1.0,0.01087719298245614,0.9891228070175438,977,0.26631578947368423,0.39087719298245616,0.34280701754385967
610,013,3579,57,973,1409,3522,3579,1.0,0.01592623637887678,0.9840737636211232,1197,0.27186364906398436,0.39368538697960326,0.3344509639564124
611,013,3403,30,1018,1462,3373,3403,1.0,0.00881575080811049,0.9911842491918895,923,0.29914781075521596,0.42962092271525126,0.2712312665295328
612,013,2457,46,856,870,2411,2457,1.0,0.018722018722018723,0.9812779812779813,731,0.3483923483923484,0.3540903540903541,0.2975172975172975
613,013,3563,25,1156,1685,3538,3563,1.0,0.0070165590794274485,0.9929834409205726,722,0.32444569183272526,0.47291608195341006,0.2026382262138647
614,013,4060,43,1339,1275,4017,4060,1.0,0.010591133004926109,0.9894088669950739,1446,0.32980295566502466,0.31403940886699505,0.3561576354679803
615,013,5551,196,2190,866,5355,5551,1.0,0.03530895334174023,0.9646910466582598,2495,0.39452350927760765,0.15600792649972978,0.44946856422266257
616,013,2266,7,690,1244,2259,2266,1.0,0.003089143865842895,0.9969108561341571,332,0.30450132391879964,0.5489849955869374,0.14651368049426303
617,013,97,79,13,5,18,97,1.0,0.8144329896907216,0.18556701030927836,79,0.13402061855670103,0.05154639175257732,0.8144329896907216
618,013,7444,37,2469,4154,7407,7444,1.0,0.004970445996775927,0.9950295540032241,821,0.33167651800107467,0.5580333154218162,0.11029016657710908
619,013,5359,115,1601,476,5244,5359,1.0,0.02145922746781116,0.9785407725321889,3282,0.2987497667475275,0.0888225415189401,0.6124276917335324
620,013,2915,35,783,1646,2880,2915,1.0,0.012006861063464836,0.9879931389365352,486,0.2686106346483705,0.5646655231560892,0.16672384219554032
621,013,5171,66,2127,1659,5105,5171,1.0,0.012763488686907755,0.9872365113130922,1385,0.41133243086443627,0.3208276929027267,0.26783987623283695
622,013,3163,191,825,407,2972,3163,1.0,0.06038570976920645,0.9396142902307936,1931,0.2608283275371483,0.12867530825165982,0.6104963642111919
623,013,3099,7,1366,1213,3092,3099,1.0,0.002258793159083575,0.9977412068409164,520,0.4407873507583091,0.3914165859954824,0.16779606324620847
624,013,3685,64,901,1673,3621,3685,1.0,0.017367706919945727,0.9826322930800543,1111,0.2445047489823609,0.45400271370420625,0.30149253731343284
625,013,4507,40,1507,2248,4467,4507,1.0,0.008875083203905036,0.9911249167960949,752,0.33436875970712227,0.49877967605946305,0.16685156423341468
626,013,4767,247,777,217,4520,4767,1.0,0.05181455842248794,0.9481854415775121,3773,0.16299559471365638,0.04552129221732746,0.7914831130690162
627,013,9726,100,2489,3389,9626,9726,1.0,0.010281719103434095,0.9897182808965659,3848,0.2559119884844746,0.34844746041538144,0.39564055110014396
628,013,7035,260,1731,751,6775,7035,1.0,0.03695806680881308,0.9630419331911869,4553,0.24605543710021321,0.10675195451314855,0.6471926083866383
629,013,4271,56,1174,1010,4215,4271,1.0,0.013111683446499649,0.9868883165535004,2087,0.27487707796768907,0.23647857644579723,0.4886443455865137
630,013,5750,169,1278,260,5581,5750,1.0,0.029391304347826087,0.9706086956521739,4212,0.2222608695652174,0.04521739130434783,0.7325217391304348
631,013,1991,4,1009,787,1987,1991,1.0,0.0020090406830738324,0.9979909593169262,195,0.5067805123053741,0.3952787543947765,0.09794073329984933
632,013,6588,329,2695,845,6259,6588,1.0,0.04993928354584092,0.9500607164541591,3048,0.40907710989678203,0.12826350941105039,0.46265938069216755
633,013,7988,282,1413,355,7706,7988,1.0,0.03530295443164747,0.9646970455683526,6220,0.1768903355032549,0.04444166249374061,0.7786680020030045
634,013,2697,36,752,997,2661,2697,1.0,0.013348164627363738,0.9866518353726362,948,0.27882832777159805,0.3696700037078235,0.3515016685205784
635,013,7159,171,3003,1967,6988,7159,1.0,0.023886017600223495,0.9761139823997765,2189,0.41947199329515295,0.274759044559296,0.30576896214555105
636,013,4048,29,1259,2078,4019,4048,1.0,0.00716403162055336,0.9928359683794467,711,0.31101778656126483,0.5133399209486166,0.1756422924901186
637,013,4760,87,1214,1306,4673,4760,1.0,0.01827731092436975,0.9817226890756302,2240,0.25504201680672267,0.2743697478991597,0.47058823529411764
638,013,4679,103,1130,590,4576,4679,1.0,0.02201325069459286,0.9779867493054072,2959,0.2415045949989314,0.12609531951271638,0.6324000854883522
639,013,2679,75,765,590,2604,2679,1.0,0.027995520716685332,0.9720044792833147,1324,0.2855543113101904,0.2202314296379246,0.49421425905188504
640,013,3663,45,1420,1087,3618,3663,1.0,0.012285012285012284,0.9877149877149877,1156,0.3876603876603877,0.29675129675129674,0.31558831558831557
641,013,3268,91,885,765,3177,3268,1.0,0.02784577723378213,0.9721542227662179,1618,0.2708078335373317,0.23408812729498163,0.49510403916768664
642,013,4704,92,1393,796,4612,4704,1.0,0.0195578231292517,0.9804421768707483,2515,0.2961309523809524,0.16921768707482993,0.5346513605442177
643,013,8121,189,1990,537,7932,8121,1.0,0.023272995936461028,0.976727004063539,5594,0.24504371382834625,0.06612486147026228,0.6888314247013915
644,013,6306,264,2372,1067,6042,6306,1.0,0.04186489058039962,0.9581351094196003,2867,0.37614969869965115,0.16920393276244847,0.4546463685379004
645,013,4281,39,1369,1654,4242,4281,1.0,0.009110021023125438,0.9908899789768746,1258,0.3197850969399673,0.3863583274935763,0.29385657556645645
646,013,1775,34,262,501,1741,1775,1.0,0.01915492957746479,0.9808450704225352,1012,0.1476056338028169,0.28225352112676055,0.5701408450704225
647,013,2791,123,1014,411,2668,2791,1.0,0.0440702257255464,0.9559297742744536,1366,0.3633106413471874,0.14725904693658187,0.48943031171623075
648,013,6634,219,1524,494,6415,6634,1.0,0.03301175761230027,0.9669882423876998,4616,0.22972565571299366,0.07446487790171842,0.695809466385288
649,013,6076,158,2332,1179,5918,6076,1.0,0.026003949967083606,0.9739960500329163,2565,0.3838051349572087,0.19404213298222514,0.42215273206056614
650,013,2272,67,583,362,2205,2272,1.0,0.02948943661971831,0.9705105633802817,1327,0.2566021126760563,0.15933098591549297,0.5840669014084507
651,013,7051,31,2788,2638,7020,7051,1.0,0.004396539497943554,0.9956034605020564,1625,0.3954049071053751,0.3741313288895192,0.23046376400510565
652,013,1132,4,484,382,1128,1132,1.0,0.0035335689045936395,0.9964664310954063,266,0.4275618374558304,0.3374558303886926,0.23498233215547704
653,013,3028,98,1563,295,2930,3028,1.0,0.03236459709379128,0.9676354029062088,1170,0.5161822985468957,0.09742404227212681,0.38639365918097757
654,013,5195,114,1790,1281,5081,5195,1.0,0.021944177093359,0.978055822906641,2124,0.34456207892204044,0.2465832531280077,0.4088546679499519
655,013,4381,112,1861,1327,4269,4381,1.0,0.025564939511527048,0.974435060488473,1193,0.4247888609906414,0.3028988815338964,0.2723122574754622
656,013,9182,98,3215,3727,9084,9182,1.0,0.010673055979089524,0.9893269440209105,2240,0.35014158135482465,0.4059028534088434,0.24395556523633197
657,013,8508,103,2654,3217,8405,8508,1.0,0.012106252938410908,0.9878937470615891,2637,0.31194170192759757,0.3781147155618242,0.3099435825105783
658,013,1892,46,466,682,1846,1892,1.0,0.024312896405919663,0.9756871035940803,744,0.2463002114164905,0.36046511627906974,0.39323467230443976
659,013,5373,181,1092,872,5192,5373,1.0,0.033686953284943234,0.9663130467150568,3409,0.2032384142936907,0.1622929462125442,0.6344686394937651
660,013,5038,179,1416,1514,4859,5038,1.0,0.035529972211194916,0.9644700277888051,2108,0.2810639142516872,0.30051607780865425,0.4184200079396586
661,013,9345,98,2461,4098,9247,9345,1.0,0.010486891385767791,0.9895131086142323,2786,0.2633493846976993,0.43852327447833067,0.29812734082397
662,013,3667,174,927,567,3493,3667,1.0,0.04745023179710935,0.9525497682028906,2173,0.252795200436324,0.15462230706299426,0.5925824925006817
663,013,2182,29,568,686,2153,2182,1.0,0.013290559120073327,0.9867094408799266,928,0.2603116406966086,0.31439046746104493,0.42529789184234645
664,013,4584,8,1242,1976,4576,4584,1.0,0.0017452006980802793,0.9982547993019197,1366,0.2709424083769634,0.43106457242582896,0.29799301919720766
665,013,4228,103,865,273,4125,4228,1.0,0.02436140018921476,0.9756385998107853,3090,0.20458845789971616,0.06456953642384106,0.7308420056764428
666,013,6744,45,2288,2196,6699,6744,1.0,0.0066725978647686835,0.9933274021352313,2260,0.33926453143534996,0.32562277580071175,0.3351126927639383
667,013,4282,67,1650,1397,4215,4282,1.0,0.015646893974778142,0.9843531060252219,1235,0.3853339560952826,0.3262494161606726,0.28841662774404486
668,013,2966,54,1468,372,2912,2966,1.0,0.01820633850303439,0.9817936614969656,1126,0.4949426837491571,0.12542144302090358,0.3796358732299393
669,013,65,3,13,33,62,65,1.0,0.046153846153846156,0.9538461538461539,19,0.2,0.5076923076923077,0.2923076923076923
670,013,4040,27,1688,1432,4013,4040,1.0,0.006683168316831683,0.9933168316831683,920,0.4178217821782178,0.35445544554455444,0.22772277227722773
671,013,3154,32,749,1090,3122,3154,1.0,0.010145846544071021,0.989854153455929,1315,0.23747622067216234,0.34559289790741915,0.4169308814204185
672,013,5609,176,1869,581,5433,5609,1.0,0.031378142271349614,0.9686218577286504,3159,0.33321447673382065,0.10358352647530754,0.5632019967908718
673,013,5113,48,2119,1904,5065,5113,1.0,0.009387834930569137,0.9906121650694308,1090,0.41443379620575005,0.3723841189125758,0.21318208488167417
674,013,3446,113,924,230,3333,3446,1.0,0.032791642484039464,0.9672083575159606,2292,0.2681369704004643,0.06674405107370865,0.665118978525827
675,013,4699,135,964,391,4564,4699,1.0,0.028729516918493295,0.9712704830815067,3344,0.20515003192168546,0.08320919344541391,0.7116407746329007
676,013,4880,23,1410,2551,4857,4880,1.0,0.004713114754098361,0.9952868852459016,919,0.2889344262295082,0.5227459016393443,0.18831967213114753
677,013,2886,13,1158,1307,2873,2886,1.0,0.0045045045045045045,0.9954954954954955,421,0.40124740124740127,0.4528759528759529,0.14587664587664587
678,013,1189,16,175,574,1173,1189,1.0,0.01345668629100084,0.9865433137089992,440,0.1471825063078217,0.4827586206896552,0.3700588730025231
679,013,5529,83,1960,1615,5446,5529,1.0,0.015011756194610237,0.9849882438053897,1954,0.35449448363175984,0.2920962199312715,0.3534092964369687
680,013,6087,18,1589,3383,6069,6087,1.0,0.002957121734844751,0.9970428782651553,1115,0.2610481353704616,0.5557746016099885,0.18317726301954987
681,013,4922,47,1941,1550,4875,4922,1.0,0.00954896383583909,0.9904510361641609,1431,0.39435188947582284,0.31491263713937423,0.29073547338480293
682,013,8933,179,3123,2296,8754,8933,1.0,0.020038061121683645,0.9799619388783164,3514,0.34960259711183256,0.2570245158401433,0.3933728870480242
683,013,4553,13,1835,1917,4540,4553,1.0,0.0028552602679551946,0.9971447397320448,801,0.40303096859213705,0.4210410718207775,0.17592795958708543
684,013,5105,46,1827,1937,5059,5105,1.0,0.009010773751224289,0.9909892262487757,1341,0.35788442703232126,0.3794319294809011,0.2626836434867777
685,013,5171,36,1073,2991,5135,5171,1.0,0.006961902920131503,0.9930380970798685,1107,0.20750338425836395,0.5784181009475924,0.21407851479404372
686,013,4233,126,1128,786,4107,4233,1.0,0.029766123316796598,0.9702338766832034,2319,0.2664776754075124,0.1856839121190645,0.5478384124734231
687,013,3501,10,1422,1429,3491,3501,1.0,0.0028563267637817767,0.9971436732362182,650,0.40616966580976865,0.40816909454441586,0.1856612396458155
688,013,9753,51,3192,4076,9702,9753,1.0,0.005229160258382036,0.994770839741618,2485,0.3272839126422639,0.4179226904542192,0.2547933969035169
689,013,3606,102,1995,508,3504,3606,1.0,0.028286189683860232,0.9717138103161398,1103,0.5532445923460898,0.1408763172490294,0.30587909040488076
690,013,525,8,269,187,517,525,1.0,0.015238095238095238,0.9847619047619047,69,0.5123809523809524,0.35619047619047617,0.13142857142857142
691,013,2668,92,554,299,2576,2668,1.0,0.034482758620689655,0.9655172413793104,1815,0.20764617691154422,0.11206896551724138,0.6802848575712144
692,013,2285,43,930,654,2242,2285,1.0,0.018818380743982493,0.9811816192560175,701,0.40700218818380746,0.2862144420131291,0.3067833698030635
693,013,1088,1,417,540,1087,1088,1.0,0.0009191176470588235,0.9990808823529411,131,0.38327205882352944,0.4963235294117647,0.12040441176470588
694,013,4798,39,2252,1691,4759,4798,1.0,0.008128386827844935,0.9918716131721551,855,0.46936223426427676,0.35243851604835347,0.17819924968736975
695,013,5546,4,1753,2669,5542,5546,1.0,0.000721240533717995,0.999278759466282,1124,0.3160836639019113,0.48124774612333215,0.2026685899747566
696,013,8660,106,2196,3526,8554,8660,1.0,0.012240184757505773,0.9877598152424942,2938,0.2535796766743649,0.40715935334872977,0.3392609699769053
697,013,2931,99,795,401,2832,2931,1.0,0.033776867963152504,0.9662231320368475,1735,0.2712384851586489,0.13681337427499146,0.5919481405663596
698,013,5071,143,1362,1318,4928,5071,1.0,0.028199566160520606,0.9718004338394793,2391,0.2685860776967068,0.2599092881088543,0.47150463419443894
699,013,3176,9,907,1317,3167,3176,1.0,0.0028337531486146094,0.9971662468513854,952,0.2855793450881612,0.41467254408060455,0.29974811083123426
700,013,4106,119,1787,904,3987,4106,1.0,0.02898197759376522,0.9710180224062348,1415,0.43521675596687776,0.2201656113005358,0.34461763273258644
701,013,2311,15,1242,854,2296,2311,1.0,0.006490696668109044,0.9935093033318909,215,0.5374296841194288,0.3695369969710082,0.09303331890956296
702,013,4057,64,2002,1196,3993,4057,1.0,0.01577520335223071,0.9842247966477693,859,0.49346807986196695,0.29479911264481146,0.2117328074932216
703,013,1358,6,527,697,1352,1358,1.0,0.004418262150220913,0.9955817378497791,134,0.38807069219440354,0.5132547864506627,0.09867452135493372
704,013,2940,93,1183,614,2847,2940,1.0,0.03163265306122449,0.9683673469387755,1143,0.4023809523809524,0.20884353741496597,0.38877551020408163
705,013,10599,187,2955,3269,10412,10599,1.0,0.01764317388432871,0.9823568261156713,4375,0.27879988678177187,0.3084253231436928,0.4127747900745353
706,013,6689,142,2339,1209,6547,6689,1.0,0.021228883241142173,0.9787711167588579,3141,0.34967857676782776,0.1807445059052175,0.4695769173269547
707,013,5645,103,1620,1322,5542,5645,1.0,0.01824623560673162,0.9817537643932683,2703,0.2869796279893711,0.2341895482728078,0.4788308237378211
708,013,4803,28,1627,2379,4775,4803,1.0,0.005829689777222569,0.9941703102227775,797,0.33874661669789713,0.49531542785758903,0.16593795544451384
709,013,3102,38,904,1337,3064,3102,1.0,0.012250161186331399,0.9877498388136686,861,0.29142488716956805,0.4310122501611863,0.2775628626692456
710,013,7964,192,2312,1454,7772,7964,1.0,0.024108488196885988,0.9758915118031141,4198,0.29030637870416875,0.1825715720743345,0.5271220492214967
711,013,3301,3,1113,1629,3298,3301,1.0,0.0009088155104513784,0.9990911844895486,559,0.33717055437746135,0.4934868221750984,0.16934262344744017
712,013,971,29,178,138,942,971,1.0,0.029866117404737384,0.9701338825952626,655,0.18331616889804325,0.14212152420185376,0.674562306900103
713,013,3192,48,996,1107,3144,3192,1.0,0.015037593984962405,0.9849624060150376,1089,0.31203007518796994,0.3468045112781955,0.34116541353383456
714,013,1827,9,814,492,1818,1827,1.0,0.0049261083743842365,0.9950738916256158,521,0.4455391351943076,0.26929392446633826,0.28516694033935414
715,013,6438,122,1981,1459,6316,6438,1.0,0.018949984467225848,0.9810500155327742,2998,0.307704255980118,0.22662317489903697,0.465672569120845
716,013,5984,241,1581,369,5743,5984,1.0,0.040274064171122996,0.959725935828877,4034,0.26420454545454547,0.06166443850267379,0.6741310160427807
717,013,5559,201,1940,843,5358,5559,1.0,0.03615758229897464,0.9638424177010254,2776,0.34898363014930744,0.15164597949271452,0.49937039035797803
718,013,3591,37,1311,1505,3554,3591,1.0,0.010303536619326092,0.9896964633806739,775,0.36507936507936506,0.4191033138401559,0.21581732108047896
719,013,2297,8,980,1227,2289,2297,1.0,0.0034828036569438396,0.9965171963430561,90,0.42664344797562037,0.5341750108837614,0.0391815411406182
720,013,7782,149,2224,1982,7633,7782,1.0,0.0191467489077358,0.9808532510922642,3576,0.2857877152402981,0.25469031097404266,0.45952197378565923
721,013,10931,241,1816,1285,10690,10931,1.0,0.022047388162107766,0.9779526118378923,7830,0.1661330161924801,0.11755557588509744,0.7163114079224224
722,013,3522,179,1154,419,3343,3522,1.0,0.05082339579784213,0.9491766042021579,1949,0.3276547416240772,0.11896649630891538,0.5533787620670074
723,013,4212,224,1712,451,3988,4212,1.0,0.05318138651471985,0.9468186134852802,2049,0.40645773979107314,0.10707502374169041,0.48646723646723644
724,013,2454,25,527,722,2429,2454,1.0,0.010187449062754686,0.9898125509372453,1205,0.21475142624286878,0.29421352893235536,0.4910350448247759
725,013,3603,50,1091,1116,3553,3603,1.0,0.013877324451845684,0.9861226755481544,1396,0.3028032195392728,0.3097418817651957,0.3874548986955315
726,013,8543,324,3776,1024,8219,8543,1.0,0.03792578719419408,0.962074212805806,3743,0.4419992976706075,0.11986421631745288,0.4381364860119396
727,013,1538,9,567,735,1529,1538,1.0,0.005851755526657998,0.994148244473342,236,0.36866059817945385,0.4778933680104031,0.15344603381014305
728,013,5598,28,1634,2484,5570,5598,1.0,0.005001786352268668,0.9949982136477313,1480,0.2918899607002501,0.4437299035369775,0.2643801357627724
729,013,4881,61,1363,2581,4820,4881,1.0,0.012497439049375128,0.9875025609506248,937,0.2792460561360377,0.5287850850235607,0.19196885884040155
730,013,2982,2,891,1607,2980,2982,1.0,0.0006706908115358819,0.9993293091884641,484,0.2987927565392354,0.5389000670690811,0.16230717639168343
731,013,9960,36,3168,4391,9924,9960,1.0,0.0036144578313253013,0.9963855421686747,2401,0.3180722891566265,0.44086345381526104,0.24106425702811246
732,013,4486,102,818,328,4384,4486,1.0,0.022737405260811413,0.9772625947391886,3340,0.18234507356219348,0.07311636201515827,0.7445385644226482
733,013,5834,27,2425,2065,5807,5834,1.0,0.004628042509427494,0.9953719574905725,1344,0.41566678093932125,0.35395954748028796,0.23037367158039082
734,013,751,672,196,30,79,751,1.0,0.8948069241011984,0.1051930758988016,525,0.2609853528628495,0.03994673768308921,0.6990679094540613
735,013,2667,36,847,1250,2631,2667,1.0,0.013498312710911136,0.9865016872890888,570,0.31758530183727035,0.46869141357330335,0.21372328458942633
736,013,4868,127,1458,460,4741,4868,1.0,0.02608874281018899,0.973911257189811,2950,0.29950698438783896,0.09449465899753492,0.6059983566146261
737,013,2813,89,628,311,2724,2813,1.0,0.03163881976537505,0.9683611802346249,1874,0.22324920014219693,0.11055812300035549,0.6661926768574475
738,013,4836,86,1193,847,4750,4836,1.0,0.017783291976840365,0.9822167080231596,2796,0.2466914805624483,0.17514474772539287,0.5781637717121588
739,013,5375,307,1987,762,5068,5375,1.0,0.05711627906976744,0.9428837209302325,2626,0.36967441860465117,0.1417674418604651,0.4885581395348837
740,013,4444,157,1287,480,4287,4444,1.0,0.03532853285328533,0.9646714671467147,2677,0.2896039603960396,0.10801080108010801,0.6023852385238524
741,013,3004,45,764,1285,2959,3004,1.0,0.014980026631158456,0.9850199733688415,955,0.25432756324900135,0.427762982689747,0.31790945406125165
742,013,2727,47,1205,875,2680,2727,1.0,0.017235056839017236,0.9827649431609827,647,0.44187752108544187,0.32086541987532086,0.23725705903923724
743,013,3357,133,1164,540,3224,3357,1.0,0.03961870717902889,0.9603812928209711,1653,0.34673815907059874,0.16085790884718498,0.4924039320822163
744,013,9717,245,2235,2365,9472,9717,1.0,0.025213543274673254,0.9747864567253267,5117,0.23000926211793762,0.24338787691674385,0.5266028609653185
745,013,3253,16,1357,1184,3237,3253,1.0,0.004918536735321242,0.9950814632646787,712,0.4171533968644328,0.3639717184137719,0.21887488472179525
746,013,4093,8,1444,1740,4085,4093,1.0,0.0019545565599804545,0.9980454434400196,909,0.35279745907647203,0.42511605179574885,0.22208648912777915
747,013,7794,10,2356,4184,7784,7794,1.0,0.0012830382345393892,0.9987169617654607,1254,0.3022838080574801,0.5368231973312805,0.1608929946112394
748,013,3645,2,1291,1773,3643,3645,1.0,0.0005486968449931413,0.9994513031550069,581,0.3541838134430727,0.48641975308641977,0.15939643347050755
749,013,5940,99,2013,1913,5841,5940,1.0,0.016666666666666666,0.9833333333333333,2014,0.3388888888888889,0.32205387205387204,0.33905723905723906
750,013,3297,26,1574,1440,3271,3297,1.0,0.007885956930542918,0.992114043069457,283,0.47740370033363666,0.4367606915377616,0.08583560812860176
751,013,1849,12,601,931,1837,1849,1.0,0.006489994591671174,0.9935100054083288,317,0.32504056246619795,0.5035154137371552,0.17144402379664683
752,013,5295,65,1698,2006,5230,5295,1.0,0.012275731822474031,0.987724268177526,1591,0.3206798866855524,0.378847969782814,0.3004721435316336
753,013,2755,22,847,1526,2733,2755,1.0,0.007985480943738656,0.9920145190562614,382,0.3074410163339383,0.553901996370236,0.13865698729582576
754,013,1173,9,426,461,1164,1173,1.0,0.0076726342710997444,0.9923273657289002,286,0.3631713554987212,0.39300937766410915,0.24381926683716965
755,013,3235,52,872,810,3183,3235,1.0,0.0160741885625966,0.9839258114374034,1553,0.2695517774343122,0.250386398763524,0.48006182380216383
756,013,4565,127,1179,923,4438,4565,1.0,0.027820372398685653,0.9721796276013144,2463,0.2582694414019715,0.2021905805038335,0.539539978094195
757,013,3937,196,985,1181,3741,3937,1.0,0.04978409956819914,0.9502159004318008,1771,0.25019050038100077,0.2999745999491999,0.44983489966979934
758,013,6327,62,1720,2409,6265,6327,1.0,0.009799272957167694,0.9902007270428324,2198,0.27185079816658764,0.3807491702228544,0.34740003161055794
759,013,6876,69,2236,2674,6807,6876,1.0,0.010034904013961605,0.9899650959860384,1966,0.3251890634089587,0.3888888888888889,0.2859220477021524
760,013,6826,87,2379,1677,6739,6826,1.0,0.012745385291532376,0.9872546147084676,2770,0.34852036331673014,0.24567828889539994,0.4058013477878699
761,013,6571,120,1935,1556,6451,6571,1.0,0.018262060569167553,0.9817379394308324,3080,0.2944757266778268,0.23679805204687263,0.46872622127530056
762,013,9826,44,3111,4625,9782,9826,1.0,0.004477915733767555,0.9955220842662325,2090,0.3166089965397924,0.4706900061062487,0.2127009973539589
763,013,6255,32,2330,2329,6223,6255,1.0,0.005115907274180656,0.9948840927258193,1596,0.37250199840127896,0.37234212629896085,0.2551558752997602
764,013,5358,40,1199,3157,5318,5358,1.0,0.007465472191116088,0.992534527808884,1002,0.22377752892870473,0.5892123926838373,0.187010078387458
765,013,3503,53,619,1143,3450,3503,1.0,0.01512988866685698,0.9848701113331431,1741,0.17670568084499,0.3262917499286326,0.49700256922637737
766,013,5065,152,2385,1034,4913,5065,1.0,0.030009871668311944,0.9699901283316881,1646,0.47087857847976305,0.20414610069101677,0.32497532082922015
767,013,8038,179,2183,1893,7859,8038,1.0,0.02226922119930331,0.9777307788006967,3962,0.2715849713859169,0.23550634486190594,0.49290868375217717
768,013,3345,7,1095,1812,3338,3345,1.0,0.0020926756352765323,0.9979073243647235,438,0.3273542600896861,0.5417040358744395,0.13094170403587443
769,013,3332,49,897,377,3283,3332,1.0,0.014705882352941176,0.9852941176470589,2058,0.2692076830732293,0.1131452581032413,0.6176470588235294
770,013,4163,39,1420,1970,4124,4163,1.0,0.009368244054768196,0.9906317559452318,773,0.34110016814797023,0.47321643045880374,0.18568340139322603
771,013,2229,45,1006,584,2184,2229,1.0,0.020188425302826378,0.9798115746971736,639,0.45132346343651863,0.2620008972633468,0.28667563930013457
772,013,3887,30,1616,1282,3857,3887,1.0,0.007718034473887317,0.9922819655261127,989,0.4157447903267301,0.32981733985078465,0.25443786982248523
773,013,2918,97,700,483,2821,2918,1.0,0.033241946538725156,0.9667580534612749,1735,0.23989033584647018,0.16552433173406442,0.5945853324194654
774,013,9161,94,2602,3593,9067,9161,1.0,0.010260888549285013,0.989739111450715,2966,0.28403012771531494,0.3922060910380963,0.3237637812465888
775,013,2463,24,777,678,2439,2463,1.0,0.0097442143727162,0.9902557856272838,1008,0.315468940316687,0.27527405602923266,0.4092570036540804
776,013,3152,60,914,1154,3092,3152,1.0,0.01903553299492386,0.9809644670050761,1084,0.2899746192893401,0.36611675126903553,0.34390862944162437
777,013,2963,4,930,1286,2959,2963,1.0,0.0013499831252109348,0.998650016874789,747,0.31387107661154234,0.43401957475531555,0.2521093486331421
778,013,2547,10,1056,1301,2537,2547,1.0,0.0039261876717707105,0.9960738123282293,190,0.41460541813898705,0.5107970160973695,0.0745975657636435
779,013,4721,42,1520,1486,4679,4721,1.0,0.008896420249947044,0.9911035797500529,1715,0.3219656852361788,0.3147638212243169,0.36327049353950436
780,013,8925,297,2463,867,8628,8925,1.0,0.033277310924369745,0.9667226890756303,5595,0.27596638655462186,0.09714285714285714,0.626890756302521
781,013,6195,26,1490,3519,6169,6195,1.0,0.004196933010492333,0.9958030669895077,1186,0.24051654560129138,0.5680387409200969,0.19144471347861178
782,013,9938,103,2730,5805,9835,9938,1.0,0.010364258402092976,0.989635741597907,1403,0.2747031595894546,0.5841215536325216,0.14117528677802374
783,013,9812,253,2165,573,9559,9812,1.0,0.0257847533632287,0.9742152466367713,7074,0.22064818589482266,0.05839788014675907,0.7209539339584182
784,013,5465,236,1738,1099,5229,5465,1.0,0.04318389752973468,0.9568161024702653,2628,0.3180237877401647,0.20109789569990852,0.4808783165599268
785,013,2203,40,672,853,2163,2203,1.0,0.018157058556513846,0.9818429414434862,678,0.3050385837494326,0.3871992737176577,0.3077621425329097
786,013,3273,90,822,224,3183,3273,1.0,0.027497708524289642,0.9725022914757103,2227,0.25114573785517874,0.06843874121600978,0.6804155209288115
787,013,4270,50,2002,1662,4220,4270,1.0,0.0117096018735363,0.9882903981264637,606,0.46885245901639344,0.3892271662763466,0.14192037470725996
788,013,2054,29,637,547,2025,2054,1.0,0.014118792599805257,0.9858812074001947,870,0.310126582278481,0.26630963972736127,0.42356377799415773
789,013,6809,248,2595,681,6561,6809,1.0,0.03642238214128359,0.9635776178587164,3533,0.38111323248641504,0.1000146864444118,0.5188720810691732
790,013,5771,158,1998,949,5613,5771,1.0,0.027378270663663145,0.9726217293363368,2824,0.3462138277594871,0.16444290417605267,0.4893432680644602
791,013,9008,187,2714,1100,8821,9008,1.0,0.020759325044404975,0.9792406749555951,5194,0.30128774422735344,0.12211367673179396,0.5765985790408525
792,013,7491,163,2069,2060,7328,7491,1.0,0.021759444666933653,0.9782405553330663,3362,0.276198104391937,0.2749966626618609,0.4488052329462021
793,013,4959,89,1057,1058,4870,4959,1.0,0.017947166767493448,0.9820528332325066,2844,0.21314781205888284,0.21334946561806817,0.573502722323049
794,013,4343,62,1994,1230,4281,4343,1.0,0.01427584618927009,0.9857241538107299,1119,0.45912963389362194,0.28321436794842275,0.2576559981579553
795,013,3329,65,1567,901,3264,3329,1.0,0.019525382997897266,0.9804746170021027,861,0.4707119255031541,0.2706518474016221,0.25863622709522377
796,013,3360,9,1098,1256,3351,3360,1.0,0.0026785714285714286,0.9973214285714286,1006,0.3267857142857143,0.3738095238095238,0.2994047619047619
797,013,7380,257,2930,1211,7123,7380,1.0,0.034823848238482384,0.9651761517615176,3239,0.3970189701897019,0.16409214092140922,0.4388888888888889
798,013,4707,19,1228,2066,4688,4707,1.0,0.004036541321436159,0.9959634586785638,1413,0.26088803909071595,0.4389207563203739,0.30019120458891013
799,013,7199,47,2264,3419,7152,7199,1.0,0.006528684539519378,0.9934713154604806,1516,0.31448812335046533,0.47492707320461175,0.21058480344492292
800,013,4386,22,1301,2183,4364,4386,1.0,0.005015959872321021,0.9949840401276789,902,0.296625626994984,0.49772001823985407,0.2056543547651619
801,013,3196,51,867,874,3145,3196,1.0,0.015957446808510637,0.9840425531914894,1455,0.2712765957446808,0.2734668335419274,0.45525657071339176
802,013,948,11,104,365,937,948,1.0,0.011603375527426161,0.9883966244725738,479,0.10970464135021098,0.3850210970464135,0.5052742616033755
803,013,4140,70,1401,1056,4070,4140,1.0,0.016908212560386472,0.9830917874396136,1683,0.3384057971014493,0.25507246376811593,0.40652173913043477
804,013,3174,47,950,1330,3127,3174,1.0,0.014807813484562067,0.9851921865154379,894,0.29930686830497794,0.4190296156269691,0.28166351606805295
805,013,201,192,74,7,9,201,1.0,0.9552238805970149,0.04477611940298507,120,0.3681592039800995,0.03482587064676617,0.5970149253731343
806,013,4904,163,1406,830,4741,4904,1.0,0.03323817292006525,0.9667618270799347,2668,0.2867047308319739,0.16924959216965743,0.5440456769983687
807,013,7590,98,2007,2603,7492,7590,1.0,0.012911725955204217,0.9870882740447958,2980,0.26442687747035576,0.3429512516469038,0.3926218708827404
808,013,2404,93,703,436,2311,2404,1.0,0.03868552412645591,0.9613144758735441,1265,0.29242928452579037,0.18136439267886856,0.5262063227953411
809,013,514,2,124,132,512,514,1.0,0.0038910505836575876,0.9961089494163424,258,0.24124513618677043,0.25680933852140075,0.5019455252918288
810,013,2654,62,892,750,2592,2654,1.0,0.023360964581763375,0.9766390354182366,1012,0.3360964581763376,0.2825923134890731,0.3813112283345893
811,013,1498,1,675,625,1497,1498,1.0,0.0006675567423230974,0.9993324432576769,198,0.4506008010680908,0.4172229639519359,0.1321762349799733
812,013,3488,5,1128,1113,3483,3488,1.0,0.0014334862385321102,0.9985665137614679,1247,0.32339449541284404,0.31909403669724773,0.35751146788990823
813,013,3432,107,1621,1042,3325,3432,1.0,0.031177156177156176,0.9688228438228438,769,0.4723193473193473,0.30361305361305363,0.22406759906759907
814,013,2863,20,1050,1376,2843,2863,1.0,0.006985679357317499,0.9930143206426825,437,0.36674816625916873,0.48061473978344393,0.15263709395738737
815,013,3069,63,964,882,3006,3069,1.0,0.020527859237536656,0.9794721407624634,1223,0.3141088302378625,0.2873900293255132,0.3985011404366243
816,013,3035,106,974,351,2929,3035,1.0,0.034925864909390446,0.9650741350906096,1710,0.32092257001647445,0.1156507413509061,0.5634266886326195
817,013,2721,15,572,1607,2706,2721,1.0,0.005512679162072767,0.9944873208379272,542,0.21021683204704153,0.5905916942300625,0.199191473722896
818,013,3224,17,1249,1424,3207,3224,1.0,0.005272952853598015,0.994727047146402,551,0.38740694789081886,0.44168734491315137,0.17090570719602977
819,013,2652,13,877,1043,2639,2652,1.0,0.004901960784313725,0.9950980392156863,732,0.3306938159879336,0.39328808446455504,0.27601809954751133
820,013,4166,47,1055,1631,4119,4166,1.0,0.01128180508881421,0.9887181949111858,1480,0.25324051848295726,0.3915026404224676,0.3552568410945751
821,013,6751,38,2298,2220,6713,6751,1.0,0.005628795733965339,0.9943712042660346,2233,0.34039401570137756,0.3288401718263961,0.33076581247222636
822,013,4736,117,2140,1270,4619,4736,1.0,0.024704391891891893,0.9752956081081081,1326,0.4518581081081081,0.26815878378378377,0.2799831081081081
823,013,6646,140,2162,731,6506,6646,1.0,0.021065302437556426,0.9789346975624436,3753,0.32530845621426424,0.10999097201324105,0.5647005717724948
824,013,162,6,23,32,156,162,1.0,0.037037037037037035,0.9629629629629629,107,0.1419753086419753,0.19753086419753085,0.6604938271604939
825,013,4515,5,1528,1518,4510,4515,1.0,0.0011074197120708748,0.9988925802879292,1469,0.33842746400885937,0.3362126245847176,0.325359911406423
826,013,10536,327,2455,1062,10209,10536,1.0,0.031036446469248292,0.9689635535307517,7019,0.2330106302201974,0.10079726651480637,0.6661921032649962
827,013,7182,52,2198,3457,7130,7182,1.0,0.007240323029796714,0.9927596769702033,1527,0.3060428849902534,0.48134224450013924,0.21261487050960734
828,013,2603,6,1262,1079,2597,2603,1.0,0.002305032654629274,0.9976949673453708,262,0.48482520169035725,0.4145217057241644,0.10065309258547829
829,013,3804,54,840,951,3750,3804,1.0,0.014195583596214511,0.9858044164037855,2013,0.22082018927444794,0.25,0.5291798107255521
830,013,2917,81,1336,793,2836,2917,1.0,0.027768255056564963,0.972231744943435,788,0.45800479945149125,0.27185464518340763,0.2701405553651011
831,013,3635,12,1101,1660,3623,3635,1.0,0.003301237964236589,0.9966987620357635,874,0.30288858321870704,0.45667125171939477,0.24044016506189822
832,013,4772,174,1352,1130,4598,4772,1.0,0.036462699077954734,0.9635373009220453,2290,0.28331936295054483,0.23679798826487847,0.4798826487845767
833,013,2264,26,866,781,2238,2264,1.0,0.011484098939929329,0.9885159010600707,617,0.3825088339222615,0.34496466431095407,0.27252650176678445
834,013,3729,47,1464,1305,3682,3729,1.0,0.012603915258782515,0.9873960847412175,960,0.3925985518905873,0.3499597747385358,0.2574416733708769
835,013,3711,4,1447,1832,3707,3711,1.0,0.0010778765831312314,0.9989221234168688,432,0.389921853947723,0.493667475074104,0.116410670978173
836,013,4085,50,1394,1589,4035,4085,1.0,0.012239902080783354,0.9877600979192166,1102,0.3412484700122399,0.38898408812729496,0.26976744186046514
837,013,5462,11,2191,2070,5451,5462,1.0,0.0020139143170999634,0.9979860856829,1201,0.40113511534236546,0.37898205785426586,0.21988282680336874
838,013,2745,13,817,1017,2732,2745,1.0,0.004735883424408015,0.995264116575592,911,0.297632058287796,0.3704918032786885,0.3318761384335155
839,013,4173,143,1760,416,4030,4173,1.0,0.03426791277258567,0.9657320872274143,1997,0.4217589264318236,0.09968847352024922,0.47855260004792716
840,013,1932,17,565,723,1915,1932,1.0,0.008799171842650104,0.9912008281573499,644,0.2924430641821946,0.37422360248447206,0.3333333333333333
841,013,5293,9,2027,2323,5284,5293,1.0,0.0017003589646703192,0.9982996410353296,943,0.38295862459852636,0.4388815416587946,0.17815983374267902
842,013,11180,441,2652,925,10739,11180,1.0,0.039445438282647585,0.9605545617173524,7603,0.2372093023255814,0.08273703041144902,0.6800536672629696
843,013,3713,105,1735,927,3608,3713,1.0,0.028279019660651765,0.9717209803393483,1051,0.4672771343926744,0.24966334500403986,0.28305952060328576
844,013,1632,4,446,827,1628,1632,1.0,0.0024509803921568627,0.9975490196078431,359,0.27328431372549017,0.5067401960784313,0.21997549019607843
845,013,2773,18,810,1033,2755,2773,1.0,0.006491164803461955,0.9935088351965381,930,0.29210241615578797,0.3725207356653444,0.33537684817886765
846,013,14,0,1,1,14,14,1.0,0.0,1.0,12,0.07142857142857142,0.07142857142857142,0.8571428571428571
847,013,8,0,3,2,8,8,1.0,0.0,1.0,3,0.375,0.25,0.375
848,013,24,0,11,12,24,24,1.0,0.0,1.0,1,0.4583333333333333,0.5,0.041666666666666664
849,013,5821,241,2199,800,5580,5821,1.0,0.041401820992956535,0.9585981790070435,2822,0.37777014258718433,0.1374334306820134,0.48479642673080225
850,013,1566,37,770,493,1529,1566,1.0,0.02362707535121328,0.9763729246487867,303,0.49169859514687103,0.3148148148148148,0.19348659003831417
851,013,7111,127,1760,998,6984,7111,1.0,0.01785965405709464,0.9821403459429053,4353,0.24750386724792575,0.1403459429053579,0.6121501898467163
852,013,6179,47,1351,3689,6132,6179,1.0,0.007606408804013595,0.9923935911959864,1139,0.2186437934940929,0.5970221718724713,0.18433403463343584
853,013,8781,69,2309,4846,8712,8781,1.0,0.007857874957294158,0.9921421250427058,1626,0.26295410545495956,0.5518733629427173,0.1851725316023232
854,013,4813,142,1478,356,4671,4813,1.0,0.029503428215250364,0.9704965717847497,2979,0.30708497818408476,0.07396634115936007,0.6189486806565552
855,013,338,4,161,92,334,338,1.0,0.011834319526627219,0.9881656804733728,85,0.47633136094674555,0.27218934911242604,0.2514792899408284
861,013,5990,188,2084,414,5802,5990,1.0,0.03138564273789649,0.9686143572621035,3492,0.34791318864774623,0.06911519198664441,0.5829716193656094
862,013,3444,25,796,1210,3419,3444,1.0,0.007259001161440186,0.9927409988385598,1438,0.2311265969802555,0.351335656213705,0.4175377468060395
863,013,2257,40,844,654,2217,2257,1.0,0.017722640673460344,0.9822773593265397,759,0.37394771821001327,0.2897651750110766,0.33628710677891005
864,013,2886,118,488,274,2768,2886,1.0,0.040887040887040885,0.9591129591129591,2124,0.1690921690921691,0.09494109494109494,0.735966735966736
865,013,6165,68,2205,2555,6097,6165,1.0,0.01103000811030008,0.9889699918896999,1405,0.35766423357664234,0.4144363341443633,0.2278994322789943
866,013,95,0,27,68,95,95,1.130952380952381,0.0,1.0,0,0.28421052631578947,0.7157894736842105,0.0
867,013,1712,12,501,688,1700,1712,1.0,0.007009345794392523,0.9929906542056075,523,0.29264018691588783,0.40186915887850466,0.3054906542056075
868,013,3117,79,1070,556,3038,3117,1.0,0.025344882900224575,0.9746551170997754,1491,0.34327879371190245,0.17837664420917548,0.47834456207892206
869,013,3525,55,901,1111,3470,3525,1.0,0.015602836879432624,0.9843971631205674,1513,0.25560283687943264,0.315177304964539,0.42921985815602837
870,013,1706,2,486,764,1704,1706,1.0,0.0011723329425556857,0.9988276670574443,456,0.28487690504103164,0.447831184056272,0.2672919109026964
871,013,3926,98,1032,368,3828,3926,1.0,0.024961793173713703,0.9750382068262863,2526,0.2628629648497198,0.09373408048904738,0.6434029546612328
872,013,5856,220,1174,554,5636,5856,1.0,0.03756830601092896,0.962431693989071,4128,0.20047814207650272,0.09460382513661202,0.7049180327868853
873,013,5453,107,2306,1782,5346,5453,1.0,0.019622226297450945,0.9803777737025491,1365,0.4228864845039428,0.326792591234183,0.2503209242618742
874,013,2142,6,789,1025,2136,2142,1.0,0.0028011204481792717,0.9971988795518207,328,0.36834733893557425,0.4785247432306256,0.1531279178338002
875,013,118,1,40,28,117,118,1.0,0.00847457627118644,0.9915254237288136,50,0.3389830508474576,0.23728813559322035,0.423728813559322
876,013,11641,341,3977,1330,11300,11641,1.0,0.029293016063912033,0.970706983936088,6334,0.34163731638175415,0.11425135297654841,0.5441113306416975
877,013,1754,4,527,698,1750,1754,1.0,0.002280501710376283,0.9977194982896237,529,0.30045610034207526,0.3979475484606613,0.3015963511972634
878,013,6260,94,1667,1938,6166,6260,1.0,0.015015974440894569,0.9849840255591055,2655,0.2662939297124601,0.3095846645367412,0.4241214057507987
879,013,3656,16,1019,1500,3640,3656,1.0,0.00437636761487965,0.9956236323851203,1137,0.2787199124726477,0.4102844638949672,0.31099562363238514
880,013,5992,102,952,419,5890,5992,1.0,0.017022696929238985,0.982977303070761,4621,0.1588785046728972,0.06992656875834447,0.7711949265687583
881,013,4211,32,1545,1706,4179,4211,1.0,0.00759914509617668,0.9924008549038233,960,0.36689622417478035,0.40512942293991927,0.2279743528853004
882,013,3049,17,866,1264,3032,3049,1.0,0.0055755985569039025,0.9944244014430961,919,0.28402755001639884,0.4145621515250902,0.301410298458511
883,013,6023,96,1635,2343,5927,6023,1.0,0.015938900879960152,0.9840610991200398,2045,0.27145940561182136,0.38900879960152746,0.3395317947866512
884,013,3219,76,824,895,3143,3219,1.0,0.023609816713264987,0.976390183286735,1500,0.25598011804908355,0.27803665734700217,0.4659832246039143
885,013,6932,119,1844,1855,6813,6932,1.0,0.0171667628390075,0.9828332371609925,3233,0.2660126947489902,0.267599538372764,0.4663877668782458
886,013,3203,90,795,846,3113,3203,1.0,0.0280986575085857,0.9719013424914142,1562,0.24820480799250702,0.26412738058070556,0.4876678114267874
887,013,6992,125,1900,2036,6867,6992,1.0,0.017877574370709384,0.9821224256292906,3056,0.2717391304347826,0.2911899313501144,0.43707093821510296
888,013,3022,5,1096,1157,3017,3022,1.0,0.0016545334215751159,0.9983454665784249,769,0.3626737260092654,0.3828590337524818,0.2544672402382528
889,013,8,0,0,7,8,8,1.0,0.0,1.0,1,0.0,0.875,0.125
890,013,5555,157,1477,362,5398,5555,1.0,0.028262826282628262,0.9717371737173718,3716,0.2658865886588659,0.06516651665166516,0.668946894689469
891,013,7514,58,2056,3088,7456,7514,1.0,0.0077189246739419745,0.992281075326058,2370,0.2736225712004259,0.41096619643332444,0.3154112323662497
892,013,5256,77,2473,1572,5179,5256,1.0,0.014649923896499238,0.9853500761035008,1211,0.4705098934550989,0.2990867579908676,0.2304033485540335
893,013,1305,17,495,574,1288,1305,1.0,0.013026819923371647,0.9869731800766284,236,0.3793103448275862,0.43984674329501916,0.18084291187739462
894,013,3229,101,946,510,3128,3229,1.0,0.03127903375658098,0.968720966243419,1773,0.29296995973985757,0.15794363580055745,0.549086404459585
895,013,5678,68,1622,2812,5610,5678,1.0,0.011976047904191617,0.9880239520958084,1244,0.2856639661852765,0.4952448045086298,0.2190912293060937
896,013,6216,127,1490,1693,6089,6216,1.0,0.02043114543114543,0.9795688545688546,3033,0.2397039897039897,0.27236164736164736,0.48793436293436293
897,013,3673,72,978,923,3601,3673,1.0,0.019602504764497687,0.9803974952355023,1772,0.2662673563844269,0.2512932208004356,0.48243942281513746
898,013,2358,136,826,459,2222,2358,1.0,0.05767599660729432,0.9423240033927057,1073,0.35029686174724345,0.1946564885496183,0.45504664970313824
899,013,3904,61,979,525,3843,3904,1.0,0.015625,0.984375,2400,0.25076844262295084,0.13447745901639344,0.6147540983606558
900,013,8611,74,2225,3563,8537,8611,1.0,0.008593659273022877,0.9914063407269771,2823,0.25839043084426894,0.41377308094297993,0.32783648821275113
901,013,2144,8,885,798,2136,2144,1.0,0.0037313432835820895,0.996268656716418,461,0.41277985074626866,0.37220149253731344,0.2150186567164179
902,013,3843,40,1168,1300,3803,3843,1.0,0.010408534998698933,0.989591465001301,1375,0.30392922196200883,0.33827738745771535,0.3577933905802758
903,013,65,1,7,35,64,65,1.0,0.015384615384615385,0.9846153846153847,23,0.1076923076923077,0.5384615384615384,0.35384615384615387
904,013,6519,107,1285,1548,6412,6519,1.0,0.016413560362018714,0.9835864396379813,3686,0.19711612210461726,0.23745973308789692,0.5654241448074858
905,013,5679,88,1216,2079,5591,5679,1.0,0.015495685860186653,0.9845043141398133,2384,0.2141222046134883,0.36608557844690964,0.41979221693960206
906,013,11918,56,3889,3905,11862,11918,1.0,0.004698774962241987,0.995301225037758,4124,0.32631313978855514,0.32765564692062427,0.3460312132908206
907,013,5358,10,1675,2764,5348,5358,1.0,0.001866368047779022,0.9981336319522209,919,0.31261664800298616,0.5158641284061217,0.1715192235908921
908,013,1034,29,445,248,1005,1034,1.0,0.02804642166344294,0.971953578336557,341,0.43036750483558994,0.23984526112185686,0.32978723404255317
909,013,2818,68,728,1120,2750,2818,1.0,0.0241305890702626,0.9758694109297374,970,0.25833924769339955,0.397444996451384,0.34421575585521647
910,013,3644,19,1207,1894,3625,3644,1.0,0.0052140504939626785,0.9947859495060373,543,0.33122941822173435,0.5197585071350165,0.14901207464324917
911,013,4972,124,1684,518,4848,4972,1.0,0.0249396621078037,0.9750603378921963,2770,0.33869670152855996,0.10418342719227675,0.5571198712791633
912,013,2388,47,367,931,2341,2388,1.0,0.01968174204355109,0.9803182579564489,1090,0.1536850921273032,0.3898659966499162,0.4564489112227806
913,013,5564,69,1610,2247,5495,5564,1.0,0.01240115025161754,0.9875988497483824,1707,0.28936017253774265,0.40384615384615385,0.30679367361610355
914,013,22,0,2,6,22,22,1.0,0.0,1.0,14,0.09090909090909091,0.2727272727272727,0.6363636363636364
915,013,3478,39,1150,1543,3439,3478,1.0,0.011213341000575043,0.988786658999425,785,0.33064979873490513,0.4436457734330075,0.2257044278320874
916,013,2341,158,609,265,2183,2341,1.0,0.06749252456215292,0.9325074754378471,1467,0.2601452370781717,0.11319948739854763,0.6266552755232806
917,013,3511,10,946,1549,3501,3511,1.0,0.0028481913984619764,0.9971518086015381,1016,0.269438906294503,0.4411848476217602,0.28937624608373685
918,013,8879,90,2468,3447,8789,8879,1.0,0.010136276607726095,0.9898637233922739,2964,0.2779592296429778,0.38821939407590944,0.33382137628111275
919,013,4393,112,1008,292,4281,4393,1.0,0.025495105850216252,0.9745048941497837,3093,0.22945595265194627,0.06646938310949238,0.7040746642385614
920,013,10791,77,3386,4904,10714,10791,1.0,0.007135575942915392,0.9928644240570846,2501,0.31378000185339633,0.4544527847280141,0.23176721341858955
921,013,4941,120,701,275,4821,4941,1.0,0.024286581663630843,0.9757134183363692,3965,0.14187411455171017,0.05565674964582069,0.8024691358024691
922,013,4086,160,1864,886,3926,4086,1.0,0.03915810083210964,0.9608418991678903,1336,0.45619187469407735,0.21683798335780716,0.3269701419481155
923,013,8029,164,1927,519,7865,8029,1.0,0.020425955909826876,0.9795740440901731,5583,0.24000498194046582,0.06464067754390335,0.6953543405156308
924,013,1966,27,574,490,1939,1966,1.0,0.013733468972533061,0.986266531027467,902,0.29196337741607326,0.24923702950152593,0.4587995930824008
925,013,5858,243,2912,766,5615,5858,1.0,0.04148173438033458,0.9585182656196655,2180,0.497097985660635,0.13076135199726868,0.37214066234209625
926,013,14611,140,4229,6937,14471,14611,1.0,0.00958182191499555,0.9904181780850044,3445,0.2894394634179728,0.47477927588802954,0.23578126069399769
927,013,4408,169,1705,600,4239,4408,1.0,0.03833938294010889,0.9616606170598911,2103,0.3867967332123412,0.13611615245009073,0.47708711433756806
928,013,998,26,220,181,972,998,1.0,0.026052104208416832,0.9739478957915831,597,0.22044088176352705,0.1813627254509018,0.5981963927855711
929,013,4064,71,1080,1647,3993,4064,1.0,0.017470472440944882,0.9825295275590551,1337,0.265748031496063,0.40526574803149606,0.32898622047244097
930,013,2766,84,1027,609,2682,2766,1.0,0.03036876355748373,0.9696312364425163,1130,0.37129428778018797,0.22017353579175705,0.40853217642805495
931,013,6299,104,1650,1650,6195,6299,1.0,0.016510557231306556,0.9834894427686934,2999,0.26194634068899825,0.26194634068899825,0.4761073186220035
932,013,1992,27,737,604,1965,1992,1.0,0.01355421686746988,0.9864457831325302,651,0.36997991967871485,0.3032128514056225,0.32680722891566266
933,013,3940,70,1543,1174,3870,3940,1.0,0.017766497461928935,0.9822335025380711,1223,0.3916243654822335,0.29796954314720814,0.31040609137055836
934,013,4600,177,1389,910,4423,4600,1.0,0.03847826086956522,0.9615217391304348,2301,0.30195652173913046,0.19782608695652174,0.5002173913043478
935,013,4183,151,1337,684,4032,4183,1.0,0.036098493903896724,0.9639015060961033,2162,0.31962706191728424,0.16351900549844609,0.5168539325842697
936,013,3630,112,1187,769,3518,3630,1.0,0.03085399449035813,0.9691460055096419,1674,0.32699724517906337,0.2118457300275482,0.46115702479338844
937,013,3346,15,1041,972,3331,3346,1.0,0.004482964734010759,0.9955170352659892,1333,0.3111177525403467,0.2904961147638972,0.3983861326957561
938,013,5536,176,2152,914,5360,5536,1.0,0.031791907514450865,0.9682080924855492,2470,0.38872832369942195,0.16510115606936415,0.4461705202312139
939,013,3640,90,1457,938,3550,3640,1.0,0.024725274725274724,0.9752747252747253,1245,0.4002747252747253,0.25769230769230766,0.34203296703296704
940,013,4364,63,1411,1367,4301,4364,1.0,0.014436296975252063,0.9855637030247479,1586,0.32332722273143905,0.3132447296058662,0.36342804766269476
941,013,494,8,102,289,486,494,1.0,0.016194331983805668,0.9838056680161943,103,0.20647773279352227,0.5850202429149798,0.20850202429149797
942,013,7415,19,2565,3539,7396,7415,1.0,0.002562373567093729,0.9974376264329062,1311,0.3459204315576534,0.4772757923128793,0.1768037761294673
943,013,6465,180,1765,1692,6285,6465,1.0,0.027842227378190254,0.9721577726218097,3008,0.27300850734725446,0.2617169373549884,0.46527455529775713
944,013,3412,46,969,1503,3366,3412,1.0,0.013481828839390387,0.9865181711606096,940,0.28399765533411486,0.4405041031652989,0.27549824150058616
945,013,10814,94,2684,5872,10720,10814,1.0,0.00869243573145922,0.9913075642685408,2258,0.24819678194932496,0.5429998150545589,0.20880340299611613
946,013,3622,34,1943,1333,3588,3622,1.0,0.009387078961899503,0.9906129210381005,346,0.5364439536167863,0.3680287134180011,0.09552733296521258
947,013,4427,27,1415,1715,4400,4427,1.0,0.006098938332956856,0.9939010616670432,1297,0.3196295459679241,0.3873955274452225,0.2929749265868534
948,013,8367,186,2460,1160,8181,8367,1.0,0.022230190032269632,0.9777698099677303,4747,0.2940121907493725,0.13863989482490738,0.5673479144257201
949,013,4220,75,1664,1253,4145,4220,1.0,0.017772511848341232,0.9822274881516587,1303,0.3943127962085308,0.29691943127962084,0.30876777251184834
950,013,1245,23,232,602,1222,1245,1.0,0.018473895582329317,0.9815261044176706,411,0.18634538152610441,0.4835341365461847,0.3301204819277108
951,013,3775,115,863,329,3660,3775,1.0,0.030463576158940398,0.9695364238410596,2583,0.2286092715231788,0.08715231788079471,0.6842384105960265
952,013,2322,50,840,665,2272,2322,1.0,0.02153316106804479,0.9784668389319552,817,0.36175710594315247,0.28639104220499567,0.35185185185185186
953,013,7209,207,1530,685,7002,7209,1.0,0.02871410736579276,0.9712858926342073,4994,0.21223470661672908,0.0950201137467055,0.6927451796365655
954,013,9512,92,2530,3258,9420,9512,1.0,0.009671993271656855,0.9903280067283431,3724,0.2659798149705635,0.3425147182506308,0.3915054667788057
955,013,9677,62,2909,5084,9615,9677,1.0,0.006406944300919706,0.9935930556990803,1684,0.30060969308670044,0.5253694326754159,0.17402087423788365
956,013,4229,35,1226,1884,4194,4229,1.0,0.00827618822416647,0.9917238117758336,1119,0.2899030503665169,0.44549538898084656,0.26460156065263657
957,013,4108,12,1199,2051,4096,4108,1.0,0.0029211295034079843,0.997078870496592,858,0.2918695228821811,0.499269717624148,0.2088607594936709
958,013,4112,126,1796,1025,3986,4112,1.0,0.0306420233463035,0.9693579766536965,1291,0.4367704280155642,0.2492704280155642,0.3139591439688716
959,013,4138,70,1251,1213,4068,4138,1.0,0.016916384726921217,0.9830836152730787,1674,0.30231996133397776,0.2931367810536491,0.40454325761237314
960,013,7605,244,1475,495,7361,7605,1.0,0.03208415516107824,0.9679158448389218,5635,0.19395134779750164,0.0650887573964497,0.7409598948060486
961,013,8163,247,3009,666,7916,8163,1.0,0.030258483400710523,0.9697415165992894,4488,0.36861447997059904,0.08158765159867695,0.549797868430724
962,013,4310,258,995,1226,4052,4310,1.0,0.05986078886310905,0.9401392111368909,2089,0.2308584686774942,0.28445475638051043,0.48468677494199536
963,013,6499,15,2773,3009,6484,6499,1.0,0.002308047391906447,0.9976919526080935,717,0.42668102785043854,0.4629943068164333,0.11032466533312818
964,013,1120,15,269,446,1105,1120,1.0,0.013392857142857142,0.9866071428571429,405,0.24017857142857144,0.3982142857142857,0.36160714285714285
965,013,5130,24,1697,2346,5106,5130,1.0,0.004678362573099415,0.9953216374269006,1087,0.3307992202729045,0.45730994152046783,0.21189083820662769
966,013,2587,68,1178,178,2519,2587,1.0,0.026285272516428294,0.9737147274835717,1231,0.45535369153459604,0.06880556629300348,0.47584074217240047
967,013,405,1,184,157,404,405,1.0,0.0024691358024691358,0.9975308641975309,64,0.454320987654321,0.38765432098765434,0.1580246913580247
968,013,7778,106,1973,2024,7672,7778,1.0,0.013628182051941374,0.9863718179480586,3781,0.2536641810233993,0.260221136538956,0.48611468243764466
969,013,6725,85,1104,3237,6640,6725,1.0,0.012639405204460967,0.9873605947955391,2384,0.1641635687732342,0.4813382899628253,0.3544981412639405
970,013,2857,35,801,923,2822,2857,1.0,0.012250612530626532,0.9877493874693735,1133,0.28036401820091006,0.32306615330766536,0.3965698284914246
971,013,10293,91,3572,3998,10202,10293,1.0,0.008840959875643642,0.9911590401243564,2723,0.3470319634703196,0.3884193140969591,0.26454872243272126
972,013,4172,58,1364,1455,4114,4172,1.0,0.013902205177372963,0.986097794822627,1353,0.32694151486097794,0.3487535953978907,0.32430488974113136
973,013,2254,27,671,832,2227,2254,1.0,0.011978704525288377,0.9880212954747116,751,0.2976929902395741,0.3691215616681455,0.3331854480922804
974,013,3183,5,1753,1223,3178,3183,1.0,0.0015708451146716933,0.9984291548853284,207,0.5507382972038957,0.3842287150486962,0.06503298774740811
975,013,5557,101,1819,1384,5456,5557,1.0,0.018175274428648552,0.9818247255713515,2354,0.32733489292783874,0.2490552456361346,0.42360986143602664
976,013,4294,67,1015,1607,4227,4294,1.0,0.01560316721006055,0.9843968327899395,1672,0.23637633907778297,0.37424312994876574,0.3893805309734513
977,013,2494,36,975,917,2458,2494,1.0,0.014434643143544507,0.9855653568564555,602,0.3909382518043304,0.36768243785084204,0.2413793103448276
978,013,4998,32,1446,2110,4966,4998,1.0,0.006402561024409764,0.9935974389755903,1442,0.2893157262905162,0.4221688675470188,0.28851540616246496
979,013,4275,73,2611,595,4202,4275,1.0,0.017076023391812866,0.9829239766081871,1069,0.6107602339181286,0.1391812865497076,0.25005847953216376
980,013,8783,222,3498,2442,8561,8783,1.0,0.025276101559831492,0.9747238984401685,2843,0.39826938403734485,0.27803711715814644,0.3236934988045087
981,013,3847,43,583,1899,3804,3847,1.0,0.011177540940992981,0.988822459059007,1365,0.15154665973485834,0.4936314010917598,0.35482193917338184
982,013,4344,16,1195,2302,4328,4344,1.0,0.003683241252302026,0.996316758747698,847,0.27509208103130756,0.5299263351749539,0.19498158379373848
983,013,4080,74,1144,1140,4006,4080,1.0,0.018137254901960786,0.9818627450980392,1796,0.2803921568627451,0.27941176470588236,0.44019607843137254
984,013,5208,206,1911,1239,5002,5208,1.0,0.03955453149001536,0.9604454685099847,2058,0.36693548387096775,0.23790322580645162,0.3951612903225806
985,013,5404,258,1974,659,5146,5404,1.0,0.04774241302738712,0.9522575869726129,2771,0.36528497409326427,0.12194670614359733,0.5127683197631384
986,013,5260,101,1236,1361,5159,5260,1.0,0.019201520912547527,0.9807984790874524,2663,0.2349809885931559,0.25874524714828895,0.5062737642585551
987,013,2732,20,1219,870,2712,2732,1.0,0.007320644216691069,0.9926793557833089,643,0.44619326500732065,0.3184480234260615,0.23535871156661786
988,013,2423,36,1039,739,2387,2423,1.0,0.014857614527445316,0.9851423854725547,645,0.42880726372265787,0.3049938093272802,0.2661989269500619
989,013,7043,57,1661,3751,6986,7043,1.0,0.008093142126934546,0.9919068578730654,1631,0.23583700127786456,0.5325855459321311,0.23157745279000427
990,015,234,3,27,166,231,234,1.0,0.01282051282051282,0.9871794871794872,41,0.11538461538461539,0.7094017094017094,0.1752136752136752
991,015,348,6,58,144,342,348,1.0,0.017241379310344827,0.9827586206896551,146,0.16666666666666666,0.41379310344827586,0.41954022988505746
992,015,840,23,116,443,817,840,1.0,0.02738095238095238,0.9726190476190476,281,0.1380952380952381,0.5273809523809524,0.3345238095238095
993,015,801,8,87,410,793,801,1.0,0.009987515605493134,0.9900124843945068,304,0.10861423220973783,0.5118601747815231,0.37952559300873906
994,015,2396,5,60,1554,2391,2396,1.0,0.002086811352253756,0.9979131886477463,782,0.025041736227045076,0.6485809682804674,0.32637729549248745
995,015,2699,162,21,91,2537,2699,1.0,0.06002223045572434,0.9399777695442757,2587,0.007780659503519822,0.03371619118191923,0.9585031493145609
996,015,3111,23,395,1433,3088,3111,1.0,0.007393121182899389,0.9926068788171006,1283,0.12696882031501125,0.460623593699775,0.41240758598521376
997,015,1406,23,195,619,1383,1406,1.0,0.016358463726884778,0.9836415362731152,592,0.1386913229018492,0.4402560455192034,0.42105263157894735
998,015,1630,24,231,642,1606,1630,1.0,0.014723926380368098,0.9852760736196319,757,0.14171779141104293,0.39386503067484663,0.4644171779141104
999,015,9378,113,1204,4256,9265,9378,1.0,0.012049477500533163,0.9879505224994668,3918,0.12838558328001706,0.45382810833866494,0.417786308381318
1000,015,35281,498,5263,12804,34783,35281,1.0,0.014115246166491879,0.9858847538335082,17214,0.14917377625350756,0.362914883364984,0.48791134038150846
1001,015,19165,670,2781,8479,18495,19165,1.0,0.03495956170101748,0.9650404382989826,7905,0.14510827028437256,0.4424210800939212,0.4124706496217062
1002,015,2146,57,316,1288,2089,2146,1.0,0.026561043802423114,0.9734389561975769,542,0.14725069897483692,0.6001863932898416,0.25256290773532153
1003,015,197,36,17,107,161,197,1.0,0.18274111675126903,0.817258883248731,73,0.08629441624365482,0.5431472081218274,0.37055837563451777
1004,015,8274,147,1268,3209,8127,8274,1.0,0.017766497461928935,0.9822335025380711,3797,0.15325114817500604,0.3878414309886391,0.45890742083635483
1005,015,10005,134,1322,4011,9871,10005,1.0,0.013393303348325837,0.9866066966516741,4672,0.13213393303348325,0.40089955022488755,0.4669665167416292
1006,015,11049,168,1797,5435,10881,11049,1.0,0.015204995927233234,0.9847950040727668,3817,0.16263915286451264,0.49189971943162275,0.3454611277038646
1007,015,13955,253,1860,6424,13702,13955,1.0,0.018129702615549984,0.98187029738445,5671,0.13328556073092082,0.46033679684700823,0.4063776424220709
1008,015,12920,99,1730,7032,12821,12920,1.0,0.007662538699690403,0.9923374613003096,4158,0.13390092879256965,0.5442724458204334,0.3218266253869969
1009,015,36241,356,5153,18024,35885,36241,1.0,0.009823128500869182,0.9901768714991308,13064,0.14218702574432274,0.49733726994288235,0.3604757043127949
1010,015,2698,51,387,1012,2647,2698,1.0,0.018902891030392884,0.9810971089696071,1299,0.14343958487768718,0.37509266123054114,0.4814677538917717
1011,015,1722,37,249,857,1685,1722,1.0,0.02148664343786295,0.978513356562137,616,0.1445993031358885,0.49767711962833916,0.35772357723577236
1012,015,197,129,42,52,68,197,1.0,0.6548223350253807,0.34517766497461927,103,0.2131979695431472,0.2639593908629442,0.5228426395939086
1013,015,768,736,252,43,32,768,1.0,0.9583333333333334,0.041666666666666664,473,0.328125,0.055989583333333336,0.6158854166666666
1014,017,11032,10662,6500,1044,370,11032,1.0,0.9664612037708484,0.03353879622915156,3488,0.5891950688905003,0.09463379260333575,0.3161711385061639
1015,017,1538,1331,801,225,207,1538,1.0,0.8654096228868661,0.13459037711313393,512,0.5208062418725617,0.14629388816644995,0.3328998699609883
1016,017,1316,134,58,135,1182,1316,1.0,0.10182370820668693,0.898176291793313,1123,0.044072948328267476,0.10258358662613981,0.8533434650455927
1017,017,12409,8156,5059,1836,4253,12409,1.0,0.6572648883874607,0.3427351116125393,5514,0.40768796841002497,0.1479571278910468,0.4443549036989282
1018,017,1890,1852,1008,210,38,1890,1.0,0.9798941798941799,0.020105820105820106,672,0.5333333333333333,0.1111111111111111,0.35555555555555557
1019,017,825,821,380,57,4,825,1.0,0.9951515151515151,0.0048484848484848485,388,0.46060606060606063,0.06909090909090909,0.4703030303030303
1020,017,9195,411,840,5988,8784,9195,1.0,0.04469820554649266,0.9553017944535074,2367,0.09135399673735727,0.6512234910277325,0.25742251223491025
1021,017,4932,1283,924,1821,3649,4932,1.0,0.26013787510137876,0.7398621248986212,2187,0.1873479318734793,0.36922141119221413,0.44343065693430656
1022,017,2115,44,319,1175,2071,2115,1.0,0.020803782505910164,0.9791962174940898,621,0.1508274231678487,0.5555555555555556,0.2936170212765957
1023,017,1139,5,143,856,1134,1139,1.0,0.004389815627743635,0.9956101843722563,140,0.12554872695346794,0.7515364354697103,0.12291483757682177
1024,017,3580,61,587,2173,3519,3580,1.0,0.017039106145251396,0.9829608938547486,820,0.16396648044692738,0.6069832402234637,0.22905027932960895
1025,017,6241,285,253,867,5956,6241,1.0,0.045665758692517225,0.9543342413074828,5121,0.04053837526037494,0.13892004486460502,0.8205415798750201
1026,017,11530,363,1926,6458,11167,11530,1.0,0.031483087597571555,0.9685169124024284,3146,0.16704249783174327,0.5601040763226366,0.2728534258456201
1027,017,11466,7660,4585,4812,3806,11466,1.0,0.6680620966335252,0.3319379033664748,2069,0.3998778998778999,0.4196755625327054,0.18044653758939475
1028,019,2584,187,79,88,2397,2584,1.0,0.07236842105263158,0.9276315789473685,2417,0.030572755417956655,0.034055727554179564,0.9353715170278638
1029,019,1230,59,645,584,1171,1230,8.360544217687075,0.04796747967479675,0.9520325203252032,1,0.524390243902439,0.47479674796747967,0.0008130081300813008
1030,019,3016,2956,1583,1432,60,3016,9.950495049504951,0.980106100795756,0.01989389920424403,1,0.524867374005305,0.47480106100795755,0.0003315649867374005
1031,019,3849,3752,2134,1714,97,3849,3.3431798436142484,0.9747986489997402,0.025201351000259806,1,0.5544297220057157,0.44531047025201353,0.0002598077422707197
1032,019,5512,95,426,109,5417,5512,1.0,0.01723512336719884,0.9827648766328012,4977,0.07728592162554426,0.019775036284470245,0.9029390420899854
1033,019,4482,75,575,163,4407,4482,1.0,0.01673360107095047,0.9832663989290495,3744,0.1282909415439536,0.036367692994199015,0.8353413654618473
1034,019,2605,124,2034,570,2481,2605,17.594594594594593,0.04760076775431862,0.9523992322456813,1,0.7808061420345489,0.21880998080614203,0.00038387715930902113
1035,019,1031,29,811,219,1002,1031,1.5147058823529411,0.028128031037827354,0.9718719689621726,1,0.7866149369544132,0.21241513094083414,0.0009699321047526673
1036,019,3415,30,1116,1141,3385,3415,1.0,0.008784773060029283,0.9912152269399708,1158,0.32679355783308933,0.3341142020497804,0.3390922401171303
1037,019,2508,18,1442,355,2490,2508,1.0,0.007177033492822967,0.992822966507177,711,0.5749601275917066,0.14154704944178628,0.2834928229665072
1038,019,3641,18,1296,620,3623,3641,1.0,0.004943696786597089,0.9950563032134029,1725,0.3559461686349904,0.17028288931612195,0.47377094204888764
1039,019,6288,14,1268,1361,6274,6288,1.0,0.0022264631043256997,0.9977735368956743,3659,0.20165394402035625,0.21644402035623408,0.5819020356234097
1040,019,3832,33,1046,762,3799,3832,1.0,0.00861169102296451,0.9913883089770354,2024,0.272964509394572,0.1988517745302714,0.5281837160751566
1041,019,4479,59,1462,1572,4420,4479,1.0,0.013172583165885243,0.9868274168341148,1445,0.3264121455682072,0.35097119892833223,0.3226166555034606
1042,019,4848,57,2499,2348,4791,4848,2.4405840886203425,0.011757425742574257,0.9882425742574258,1,0.5154702970297029,0.48432343234323433,0.00020627062706270627
1043,019,3629,66,555,161,3563,3629,1.0,0.01818682832736291,0.981813171672637,2913,0.15293469275282448,0.0443648387985671,0.8027004684486084
1044,019,2882,99,1936,787,2783,2882,1.0,0.03435114503816794,0.9656488549618321,159,0.6717557251908397,0.2730742539902845,0.05517002081887578
1045,019,3527,183,1195,661,3344,3527,1.0,0.05188545506095832,0.9481145449390417,1671,0.33881485681882617,0.1874113977884888,0.473773745392685
1046,019,2334,140,1737,547,2194,2334,1.0,0.05998286203941731,0.9400171379605827,50,0.7442159383033419,0.23436161096829478,0.021422450728363324
1047,019,6470,436,368,363,6034,6470,1.0,0.06738794435857805,0.9326120556414219,5739,0.05687789799072643,0.05610510046367852,0.887017001545595
1048,019,4491,58,38,66,4433,4491,1.0,0.012914718325539969,0.9870852816744601,4387,0.008461367178802049,0.014696058784235137,0.9768425740369628
1049,019,7992,282,633,117,7710,7992,1.0,0.03528528528528529,0.9647147147147147,7242,0.07920420420420421,0.01463963963963964,0.9061561561561562
1050,019,4694,234,2127,1500,4460,4694,1.0,0.04985087345547507,0.9501491265445249,1067,0.4531316574350234,0.3195568811248402,0.22731146144013634
1051,019,3099,45,1690,1408,3054,3099,1.0237937871777925,0.01452081316553727,0.9854791868344628,1,0.5453372055501775,0.4543401097128106,0.00032268473701193933
1052,019,4211,232,373,16,3979,4211,1.0,0.05509380194728093,0.944906198052719,3822,0.08857753502730943,0.00379957254808834,0.9076228924246023
1053,019,4233,200,786,1095,4033,4233,1.0,0.04724781478856603,0.952752185211434,2352,0.1856839121190645,0.258681785967399,0.5556343019135365
1054,019,1006,0,499,507,1006,1006,20.958333333333332,0.0,1.0,0,0.4960238568588469,0.5039761431411531,0.0
1055,019,2287,90,374,525,2197,2287,1.0,0.03935286401399213,0.9606471359860078,1388,0.1635330126803673,0.22955837341495408,0.6069086139046787
1056,019,3782,25,2135,1476,3757,3782,1.0,0.006610259122157589,0.9933897408778424,171,0.5645161290322581,0.390269698572184,0.0452141723955579
1057,019,5319,46,1837,1833,5273,5319,1.0,0.008648242150780222,0.9913517578492198,1649,0.3453656702387667,0.34461364918217713,0.31002068057905624
1058,019,3114,72,590,307,3042,3114,1.0,0.023121387283236993,0.976878612716763,2217,0.1894669235709698,0.09858702633269108,0.7119460500963392
1059,019,8402,170,1494,2580,8232,8402,1.0,0.020233277791002143,0.9797667222089979,4328,0.17781480599857177,0.3070697452987384,0.5151154487026899
1060,019,3441,92,2125,936,3349,3441,1.0,0.026736413833188026,0.973263586166812,380,0.6175530369078757,0.27201394943330426,0.1104330136588201
1061,019,2884,86,1532,921,2798,2884,1.0,0.029819694868238558,0.9701803051317615,431,0.5312066574202496,0.3193481276005548,0.14944521497919555
1062,019,1234,5,769,464,1229,1234,1.6550335570469799,0.004051863857374392,0.9959481361426256,1,0.6231766612641815,0.3760129659643436,0.0008103727714748784
1063,019,8696,308,318,238,8388,8696,1.0,0.03541858325666973,0.9645814167433303,8140,0.036568537258509656,0.027368905243790247,0.9360625574977001
1064,019,2837,178,1620,1216,2659,2837,1.396356474643033,0.06274233345082834,0.9372576665491716,1,0.5710257314064152,0.4286217835741981,0.00035248501938667606
1065,019,4376,172,1603,1033,4204,4376,1.0,0.03930530164533821,0.9606946983546618,1740,0.3663162705667276,0.23606032906764168,0.3976234003656307
1066,019,4135,25,1218,1158,4110,4135,1.0,0.006045949214026602,0.9939540507859734,1759,0.29455864570737605,0.2800483675937122,0.42539298669891173
1067,019,3757,50,745,77,3707,3757,1.0,0.013308490817141336,0.9866915091828586,2935,0.19829651317540592,0.020495075858397657,0.7812084109661964
1068,019,9000,520,1509,1463,8480,9000,1.0,0.057777777777777775,0.9422222222222222,6028,0.16766666666666666,0.16255555555555556,0.6697777777777778
1069,019,8586,176,1936,2131,8410,8586,1.0,0.020498485907290937,0.979501514092709,4519,0.22548334498020034,0.24819473561611927,0.5263219194036804
1070,019,3812,613,1923,1888,3199,3812,1.5093069306930693,0.16080797481636935,0.8391920251836307,1,0.5044596012591815,0.49527806925498424,0.00026232948583420777
1071,019,3296,48,903,494,3248,3296,1.0,0.014563106796116505,0.9854368932038835,1899,0.27396844660194175,0.14987864077669902,0.5761529126213593
1072,019,2243,57,1606,389,2186,2243,1.0,0.02541239411502452,0.9745876058849755,248,0.7160053499777084,0.1734284440481498,0.11056620597414177
1073,019,1954,8,1585,368,1946,1954,1.9569138276553106,0.0040941658137154556,0.9959058341862845,1,0.8111566018423746,0.18833162743091095,0.0005117707267144319
1074,019,5340,505,1445,499,4835,5340,1.0,0.0945692883895131,0.9054307116104869,3396,0.2705992509363296,0.09344569288389513,0.6359550561797753
1075,019,5671,175,2949,793,5496,5671,1.0,0.03085875506965262,0.9691412449303474,1929,0.5200141068594604,0.13983424440134015,0.34015164873919945
1076,019,2117,25,1467,649,2092,2117,1.1671263099834528,0.011809163911195087,0.9881908360888049,1,0.6929617383089277,0.30656589513462446,0.0004723665564478035
1077,019,3940,175,1051,255,3765,3940,1.0,0.044416243654822336,0.9555837563451777,2634,0.266751269035533,0.06472081218274112,0.6685279187817259
1078,019,3362,127,8,3,3235,3362,1.0,0.03777513384889947,0.9622248661511006,3351,0.002379535990481856,0.000892325996430696,0.9967281380130875
1079,019,3821,230,1094,553,3591,3821,1.0,0.06019366657942947,0.9398063334205705,2174,0.28631248364302536,0.14472651138445433,0.5689610049725203
1080,019,10586,413,1124,240,10173,10586,1.0,0.039013791800491214,0.9609862081995088,9222,0.10617797090496883,0.022671452862270923,0.8711505762327603
1081,019,8436,214,2332,687,8222,8436,1.0,0.02536747273589379,0.9746325272641062,5417,0.27643432906590804,0.0814366998577525,0.6421289710763395
1082,019,2603,37,1410,1192,2566,2603,1.4057266342517558,0.014214368036880523,0.9857856319631195,1,0.5416826738378794,0.45793315405301577,0.000384172109104879
1083,019,2441,1,1427,481,2440,2441,1.0,0.00040966816878328555,0.9995903318312167,533,0.5845964768537485,0.19705038918476034,0.2183531339614912
1084,019,7312,168,2016,2597,7144,7312,1.0,0.022975929978118162,0.9770240700218819,2699,0.27571115973741794,0.3551695842450766,0.36911925601750545
1085,019,4924,152,2453,1123,4772,4924,1.0,0.030869212022745736,0.9691307879772543,1348,0.4981722177091795,0.22806661251015434,0.2737611697806661
1086,019,3014,142,1593,948,2872,3014,1.0,0.047113470471134705,0.9528865295288653,473,0.5285335102853351,0.31453218314532183,0.15693430656934307
1087,019,2684,83,112,8,2601,2684,1.0,0.030923994038748136,0.9690760059612519,2564,0.041728763040238454,0.0029806259314456036,0.9552906110283159
1088,019,3376,4,1596,1779,3372,3376,1.596499526963103,0.001184834123222749,0.9988151658767772,1,0.4727488151658768,0.5269549763033176,0.0002962085308056872
1089,019,10424,142,1852,1706,10282,10424,1.0,0.013622409823484267,0.9863775901765157,6866,0.17766692248656946,0.16366078280890253,0.658672294704528
1090,019,1735,19,794,753,1716,1735,1.0,0.01095100864553314,0.9890489913544669,188,0.45763688760806914,0.4340057636887608,0.10835734870317003
1091,019,3424,221,811,277,3203,3424,1.0,0.06454439252336448,0.9354556074766355,2336,0.236857476635514,0.08089953271028037,0.6822429906542056
1092,019,623,0,278,345,623,623,29.666666666666668,0.0,1.0,0,0.4462279293739968,0.5537720706260032,0.0
1093,019,5029,243,1577,686,4786,5029,1.0,0.04831974547623782,0.9516802545237621,2766,0.31358122887253925,0.1364088287930006,0.5500099423344601
1094,019,5008,199,1610,520,4809,5008,1.0,0.03973642172523962,0.9602635782747604,2878,0.3214856230031949,0.10383386581469649,0.5746805111821086
1095,019,3193,58,1236,388,3135,3193,1.0,0.01816473535859693,0.981835264641403,1569,0.3870967741935484,0.12151581584716567,0.4913874099592859
1096,019,6423,91,2035,1938,6332,6423,1.0,0.014167834345321501,0.9858321656546785,2450,0.31683014167834345,0.3017281644091546,0.38144169391250193
1097,019,3043,45,989,1045,2998,3043,1.0,0.014788038120276044,0.9852119618797239,1009,0.3250082155767335,0.3434111074597437,0.33158067696352284
1098,019,2645,2615,1289,1355,30,2645,7.447887323943662,0.9886578449905482,0.011342155009451797,1,0.4873345935727788,0.5122873345935728,0.0003780718336483932
1099,019,6557,154,555,578,6403,6557,1.0,0.023486350465151747,0.9765136495348482,5424,0.08464236693609882,0.08815006862894617,0.827207564434955
1100,019,3394,39,1472,572,3355,3394,1.0,0.011490866234531527,0.9885091337654685,1350,0.4337065409546258,0.16853270477312904,0.39776075427224517
1101,019,2851,5,972,1454,2846,2851,1.0,0.00175377060680463,0.9982462293931954,425,0.34093300596282006,0.5099964924587864,0.14907050157839355
1102,019,4436,119,1079,931,4317,4436,1.0,0.026825969341749325,0.9731740306582507,2426,0.24323715058611362,0.2098737601442741,0.5468890892696122
1103,019,3227,3139,2683,543,88,3227,3.4913419913419914,0.9727300898667492,0.027269910133250697,1,0.831422373721723,0.16826774093585373,0.0003098853424233034
1104,019,2633,16,54,55,2617,2633,1.0,0.0060767185719711354,0.9939232814280289,2524,0.020508925180402583,0.020888720091150777,0.9586023547284467
1105,019,2270,20,1571,699,2250,2270,1.0,0.00881057268722467,0.9911894273127754,0,0.6920704845814978,0.3079295154185022,0.0
1106,019,3993,58,1274,273,3935,3993,1.0,0.01452541948409717,0.9854745805159029,2446,0.31905835211620337,0.06836964688204357,0.612572001001753
1107,019,3371,52,124,16,3319,3371,1.0,0.0154256897063186,0.9845743102936814,3231,0.036784336991990504,0.004746366063482646,0.9584692969445269
1108,019,1368,16,145,5,1352,1368,1.0,0.011695906432748537,0.9883040935672515,1218,0.10599415204678363,0.003654970760233918,0.8903508771929824
1109,019,4813,147,2297,2515,4666,4813,1.741585233441911,0.03054228132142115,0.9694577186785789,1,0.4772491169748598,0.522543112403906,0.00020777062123415748
1110,019,2167,31,699,1195,2136,2167,1.0,0.01430549146285187,0.9856945085371481,273,0.32256575911398244,0.5514536225196124,0.12598061836640517
1111,019,6324,30,1040,219,6294,6324,1.0,0.004743833017077799,0.9952561669829222,5065,0.1644528779253637,0.03462998102466793,0.8009171410499684
1112,019,3322,54,1687,1634,3268,3322,1.5606203007518797,0.01625526791089705,0.983744732089103,1,0.5078266104756171,0.4918723660445515,0.00030102347983142685
1113,019,5227,211,1340,683,5016,5227,1.0,0.04036732351253109,0.9596326764874689,3204,0.2563612014539889,0.13066768700975703,0.612971111536254
1114,019,1647,31,1348,298,1616,1647,1.6042884990253412,0.018822100789313904,0.9811778992106861,1,0.8184578020643595,0.1809350333940498,0.0006071645415907711
1115,019,3275,7,659,750,3268,3275,1.0,0.002137404580152672,0.9978625954198473,1866,0.20122137404580154,0.22900763358778625,0.5697709923664123
1116,019,4141,51,394,135,4090,4141,1.0,0.012315865732914755,0.9876841342670852,3612,0.09514609997585124,0.03260082105771553,0.8722530789664332
1117,019,3110,24,2008,1101,3086,3110,1.5733805668016194,0.0077170418006430866,0.992282958199357,1,0.6456591639871383,0.3540192926045016,0.0003215434083601286
1118,019,4924,151,585,1061,4773,4924,1.0,0.03066612510154346,0.9693338748984566,3278,0.11880584890333062,0.2154752233956133,0.665718927701056
1119,019,3420,35,1945,1255,3385,3420,1.0,0.01023391812865497,0.9897660818713451,220,0.5687134502923976,0.3669590643274854,0.06432748538011696
1120,019,2885,77,2118,377,2808,2885,1.0,0.026689774696707105,0.9733102253032929,390,0.7341421143847487,0.13067590987868286,0.13518197573656845
1121,019,3276,71,2275,782,3205,3276,1.0,0.021672771672771672,0.9783272283272283,219,0.6944444444444444,0.23870573870573872,0.06684981684981685
1122,019,1623,6,689,466,1617,1623,1.0,0.0036968576709796672,0.9963031423290203,468,0.42452248921749847,0.2871226124460875,0.28835489833641403
1123,019,2909,48,1033,367,2861,2909,1.0,0.016500515641113784,0.9834994843588862,1509,0.35510484702646955,0.12616019250601582,0.5187349604675147
1124,019,2530,110,1857,462,2420,2530,1.0,0.043478260869565216,0.9565217391304348,211,0.7339920948616601,0.1826086956521739,0.08339920948616601
1125,019,5738,206,438,417,5532,5738,1.0,0.03590101080515859,0.9640989891948414,4883,0.07633321714883234,0.07267340536772394,0.8509933774834437
1126,019,3052,24,2287,764,3028,3052,1.1171731966312706,0.007863695937090432,0.9921363040629095,1,0.7493446920052425,0.2503276539973788,0.000327653997378768
1127,019,3987,77,2060,551,3910,3987,1.0,0.01931276649109606,0.980687233508904,1376,0.5166792074241284,0.1381991472284926,0.345121645347379
1128,019,2659,76,0,0,2583,2659,1.0,0.0285821737495299,0.9714178262504701,2659,0.0,0.0,1.0
1129,019,3978,239,2214,1233,3739,3978,1.0,0.06008044243338361,0.9399195575666164,531,0.5565610859728507,0.30995475113122173,0.1334841628959276
1130,019,2841,49,2008,832,2792,2841,1.780564263322884,0.017247448081661388,0.9827525519183387,1,0.7067933826117564,0.29285462865188316,0.00035198873636043646
1131,019,4490,66,998,204,4424,4490,1.0,0.014699331848552339,0.9853006681514477,3288,0.222271714922049,0.04543429844097996,0.7322939866369711
1132,019,2963,105,798,1089,2858,2963,1.0,0.03543705703678704,0.964562942963213,1076,0.2693216334795815,0.36753290583867704,0.36314546068174147
1133,019,2919,7,1470,1448,2912,2919,2.0534834623504574,0.002398081534772182,0.9976019184652278,1,0.5035971223021583,0.4960602946214457,0.00034258307639602604
1134,019,5174,107,496,270,5067,5174,1.0,0.020680324700425204,0.9793196752995748,4408,0.09586393505991496,0.052183996907615,0.85195206803247
1135,019,6057,113,615,1400,5944,6057,1.0,0.018656100379725937,0.981343899620274,4042,0.10153541357107479,0.23113752682846295,0.6673270596004622
1136,019,5785,43,1258,528,5742,5785,1.0,0.007433016421780467,0.9925669835782195,3999,0.2174589455488332,0.0912705272255834,0.6912705272255834
1137,019,2230,1859,821,727,371,2230,1.0,0.8336322869955157,0.1663677130044843,682,0.3681614349775785,0.32600896860986545,0.305829596412556
1138,019,2677,42,265,16,2635,2677,1.0,0.015689204333208816,0.9843107956667911,2396,0.09899140829286515,0.005976839745984311,0.8950317519611506
1139,019,3412,21,199,153,3391,3412,1.0,0.00615474794841735,0.9938452520515827,3060,0.058323563892145366,0.04484173505275498,0.8968347010550997
1140,019,4815,80,1980,1728,4735,4815,1.0,0.016614745586708203,0.9833852544132918,1107,0.411214953271028,0.35887850467289717,0.22990654205607478
1141,019,3933,50,1658,1518,3883,3933,1.0,0.012712941774726672,0.9872870582252733,757,0.42156114924993643,0.38596491228070173,0.1924739384693618
1142,019,5229,38,762,1277,5191,5229,1.0,0.007267163893669918,0.9927328361063301,3190,0.1457257601835915,0.24421495505832855,0.6100592847580799
1143,019,6181,77,1057,1150,6104,6181,1.0,0.01245753114382786,0.9875424688561721,3974,0.1710079275198188,0.18605403656366284,0.6429380359165183
1144,019,3271,68,1127,1232,3203,3271,1.0,0.020788749617853867,0.9792112503821462,912,0.34454295322531336,0.3766432283705289,0.27881381840415775
1145,019,3529,40,1451,1439,3489,3529,1.0,0.011334655709832813,0.9886653442901672,639,0.41116463587418534,0.4077642391612355,0.1810711249645792
1146,019,3214,50,1628,1530,3164,3214,1.0,0.015556938394523958,0.984443061605476,56,0.5065339141257,0.4760423148724331,0.017423771001866834
1147,019,4144,50,1569,1586,4094,4144,1.0,0.012065637065637066,0.987934362934363,989,0.3786196911196911,0.3827220077220077,0.23865830115830117
1148,019,2205,14,870,479,2191,2205,1.0,0.006349206349206349,0.9936507936507937,856,0.3945578231292517,0.21723356009070294,0.38820861678004537
1149,019,3213,54,1592,1340,3159,3213,1.0,0.01680672268907563,0.9831932773109243,281,0.4954870837223778,0.4170557111733582,0.08745720510426393
1150,019,6944,150,2345,1531,6794,6944,1.0,0.021601382488479263,0.9783986175115207,3068,0.3377016129032258,0.22047811059907835,0.44182027649769584
1151,019,2765,29,1131,1633,2736,2765,1.2339285714285715,0.010488245931283906,0.989511754068716,1,0.40904159132007234,0.5905967450271248,0.0003616636528028933
1152,019,2213,5,1607,309,2208,2213,1.0,0.0022593764121102574,0.9977406235878897,297,0.7261635788522368,0.1396294622684139,0.1342069588793493
1153,019,2710,20,1080,1629,2690,2710,1.506674082313682,0.007380073800738007,0.992619926199262,1,0.3985239852398524,0.6011070110701107,0.00036900369003690036
1154,019,9262,62,1531,1122,9200,9262,1.0,0.006694018570503131,0.9933059814294969,6609,0.16529907147484343,0.12114014251781473,0.7135607860073419
1155,019,5063,79,2327,2735,4984,5063,1.8630842841369157,0.015603397195338733,0.9843966028046612,1,0.45960892751333204,0.5401935611297649,0.00019751135690302193
1156,019,3287,41,736,897,3246,3287,1.0,0.012473379981746273,0.9875266200182538,1654,0.22391238211134773,0.27289321569820507,0.5031944021904472
1157,019,5165,79,1365,274,5086,5165,1.0,0.015295256534365925,0.9847047434656341,3526,0.26427879961277834,0.05304937076476283,0.6826718296224589
1158,019,2261,19,465,550,2242,2261,1.0,0.008403361344537815,0.9915966386554622,1246,0.20566121185316233,0.24325519681556834,0.5510835913312694
1159,019,3804,47,1723,632,3757,3804,1.0,0.012355415352260778,0.9876445846477392,1449,0.452944269190326,0.1661409043112513,0.38091482649842273
1160,019,5321,76,1068,1057,5245,5321,1.0,0.014283029505732006,0.985716970494268,3196,0.2007141514752866,0.19864687088893065,0.6006389776357828
1161,019,2786,25,1373,1067,2761,2786,1.0,0.008973438621679828,0.9910265613783201,346,0.4928212491026561,0.38298636037329503,0.12419239052404882
1162,019,2996,2986,2086,909,10,2996,9.538216560509554,0.9966622162883845,0.0033377837116154874,1,0.6962616822429907,0.30340453938584777,0.0003337783711615487
1163,019,311,300,187,4,11,311,1.0,0.9646302250803859,0.03536977491961415,120,0.6012861736334405,0.012861736334405145,0.3858520900321543
1164,019,1160,1106,933,226,54,1160,4.849372384937238,0.9534482758620689,0.04655172413793104,1,0.8043103448275862,0.19482758620689655,0.0008620689655172414
1165,019,3948,3840,2128,1819,108,3948,4.495444191343964,0.9726443768996961,0.02735562310030395,1,0.5390070921985816,0.46073961499493415,0.00025329280648429586
1166,019,1358,40,1011,346,1318,1358,1.7949735449735449,0.029455081001472753,0.9705449189985272,1,0.7444771723122239,0.2547864506627393,0.0007363770250368188
1167,019,2682,36,1463,1218,2646,2682,2.7190669371196754,0.013422818791946308,0.9865771812080537,1,0.5454884414615958,0.4541387024608501,0.0003728560775540641
1168,019,5586,16,625,683,5570,5586,1.0,0.0028643036161833156,0.9971356963838167,4278,0.11188686000716076,0.12226996061582528,0.765843179377014
1169,019,3830,37,1115,729,3793,3830,1.0,0.009660574412532636,0.9903394255874673,1986,0.29112271540469975,0.19033942558746736,0.5185378590078329
1170,019,1316,57,752,550,1259,1316,1.0,0.04331306990881459,0.9566869300911854,14,0.5714285714285714,0.41793313069908816,0.010638297872340425
1171,019,3089,94,1176,689,2995,3089,1.0,0.030430560051796698,0.9695694399482033,1224,0.38070573000971186,0.22304953059242474,0.39624473939786337
1172,019,6433,20,1002,821,6413,6433,1.0,0.00310896937665164,0.9968910306233484,4610,0.15575936577024715,0.12762319291154983,0.716617441318203
1173,019,4494,78,1481,614,4416,4494,1.0,0.017356475300400534,0.9826435246995995,2399,0.3295505117935024,0.13662661326212727,0.5338228749443703
1174,019,3466,46,1141,1317,3420,3466,1.0,0.013271783035199077,0.986728216964801,1008,0.32919792267743797,0.37997691863819966,0.2908251586843624
1175,019,2840,23,1148,122,2817,2840,1.0,0.008098591549295774,0.9919014084507042,1570,0.4042253521126761,0.04295774647887324,0.5528169014084507
1176,019,3167,28,1221,607,3139,3167,1.0,0.00884117461319861,0.9911588253868013,1339,0.38553836438269656,0.19166403536469845,0.422797600252605
1177,019,2000,33,1134,865,1967,2000,1.5484120836560806,0.0165,0.9835,1,0.567,0.4325,0.0005
1178,019,928,3,369,442,925,928,1.0,0.003232758620689655,0.9967672413793104,117,0.39762931034482757,0.47629310344827586,0.12607758620689655
1179,019,2203,100,1391,811,2103,2203,1.628698224852071,0.04539264639128461,0.9546073536087154,1,0.631411711302769,0.3681343622333182,0.00045392646391284613
1180,019,4524,76,828,513,4448,4524,1.0,0.016799292661361626,0.9832007073386384,3183,0.1830238726790451,0.11339522546419098,0.7035809018567639
1181,019,4555,241,206,265,4314,4555,1.0,0.05290889132821076,0.9470911086717893,4084,0.04522502744237102,0.05817782656421515,0.8965971459934138
1182,019,3324,68,10,10,3256,3324,1.0,0.02045728038507822,0.9795427196149218,3304,0.0030084235860409147,0.0030084235860409147,0.9939831528279182
1183,019,3238,39,1516,1721,3199,3238,1.152367390530438,0.012044471896232242,0.9879555281037677,1,0.46819024088943795,0.5315009264978382,0.00030883261272390367
1184,019,5007,258,1993,2106,4749,5007,1.0,0.05152786099460755,0.9484721390053924,908,0.3980427401637707,0.42061114439784303,0.18134611543838625
1185,019,2158,1,1187,822,2157,2158,1.0,0.0004633920296570899,0.9995366079703429,149,0.5500463392029658,0.3809082483781279,0.0690454124189064
1186,019,7759,307,2776,1371,7452,7759,1.0,0.03956695450444645,0.9604330454955535,3612,0.3577780641835288,0.17669802809640417,0.465523907720067
1187,019,2963,165,790,347,2798,2963,1.0,0.055686803914951066,0.9443131960850489,1826,0.26662166722915964,0.1171110361120486,0.6162672966587918
1188,019,1555,29,974,580,1526,1555,1.895121951219512,0.01864951768488746,0.9813504823151126,1,0.6263665594855305,0.3729903536977492,0.0006430868167202572
1189,019,2140,13,268,211,2127,2140,1.0,0.006074766355140187,0.9939252336448599,1661,0.1252336448598131,0.0985981308411215,0.7761682242990654
1190,019,2752,10,808,1943,2742,2752,1.201834862385321,0.003633720930232558,0.9963662790697675,1,0.2936046511627907,0.706031976744186,0.0003633720930232558
1191,019,3253,51,589,650,3202,3253,1.0,0.01567783584383646,0.9843221641561636,2014,0.18106363356901323,0.19981555487242544,0.6191208115585614
1192,019,4971,51,3272,1698,4920,4971,12.646310432569974,0.010259505129752565,0.9897404948702474,1,0.6582176624421645,0.3415811707905854,0.0002011667672500503
1193,019,5264,196,1935,886,5068,5264,1.0,0.03723404255319149,0.9627659574468085,2443,0.36759118541033436,0.1683130699088146,0.4640957446808511
1194,019,2383,55,1724,658,2328,2383,1.0374564459930313,0.02308015107007973,0.9769198489299202,1,0.7234578262694084,0.2761225346202266,0.000419639110365086
1195,019,1637,27,1354,282,1610,1637,1.4140017286084703,0.016493585827733658,0.9835064141722664,1,0.8271227855833843,0.17226634086744044,0.0006108735491753207
1196,019,4098,23,814,70,4075,4098,1.0,0.005612493899463153,0.9943875061005368,3214,0.19863347974621767,0.01708150317227916,0.7842850170815032
1197,019,3059,29,1772,1098,3030,3059,1.0,0.009480222294867604,0.9905197777051324,189,0.579274272638117,0.35894083033671137,0.06178489702517163
1198,019,3146,6,1683,954,3140,3146,1.0,0.0019071837253655435,0.9980928162746344,509,0.534965034965035,0.30324221233312143,0.16179275270184362
1199,019,4019,15,1028,2360,4004,4019,1.0,0.003732271709380443,0.9962677282906196,631,0.25578502114953966,0.587210748942523,0.1570042299079373
1200,019,3208,9,693,599,3199,3208,1.0,0.002805486284289277,0.9971945137157108,1916,0.2160224438902743,0.1867206982543641,0.5972568578553616
1201,019,4820,45,2342,1845,4775,4820,1.0,0.00933609958506224,0.9906639004149378,633,0.4858921161825726,0.38278008298755184,0.13132780082987552
1202,019,4651,133,263,67,4518,4651,1.0,0.028596000860030103,0.9714039991399699,4321,0.05654697914427005,0.014405504192646742,0.9290475166630832
1203,019,2143,35,306,246,2108,2143,1.0,0.016332244517032198,0.9836677554829678,1591,0.14279048063462435,0.11479234717685488,0.7424171721885208
1204,019,5215,84,620,501,5131,5215,1.0,0.016107382550335572,0.9838926174496644,4094,0.11888782358581017,0.09606903163950144,0.7850431447746884
1205,019,3071,37,160,243,3034,3071,1.0,0.012048192771084338,0.9879518072289156,2668,0.052100293064148484,0.07912732009117551,0.868772386844676
1206,019,3576,21,1666,941,3555,3576,1.0,0.00587248322147651,0.9941275167785235,969,0.4658836689038031,0.26314317673378074,0.2709731543624161
1207,019,4155,42,1603,430,4113,4155,1.0,0.010108303249097473,0.9898916967509025,2122,0.3858002406738869,0.10348977135980746,0.5107099879663056
1208,019,3929,16,543,708,3913,3929,1.0,0.004072283023670145,0.9959277169763299,2678,0.13820310511580555,0.18019852379740392,0.6815983710867906
1209,019,4401,59,1555,363,4342,4401,1.0,0.013406044080890706,0.9865939559191093,2483,0.353328788911611,0.08248125426039536,0.5641899568279937
1210,019,2967,42,1669,512,2925,2967,1.0,0.014155712841253791,0.9858442871587462,786,0.5625210650488709,0.17256488035052242,0.2649140546006067
1211,019,3263,24,577,651,3239,3263,1.0,0.007355194606190622,0.9926448053938094,2035,0.17683113699049954,0.19950965369292062,0.6236592093165798
1212,019,2665,49,1386,1278,2616,2665,1.1725352112676057,0.018386491557223265,0.9816135084427767,1,0.5200750469043152,0.47954971857410883,0.000375234521575985
1213,019,2512,0,1479,1033,2512,2512,8.345514950166113,0.0,1.0,0,0.5887738853503185,0.4112261146496815,0.0
1214,019,3913,27,1560,626,3886,3913,1.0,0.006900076667518528,0.9930999233324814,1727,0.39867109634551495,0.15997955532839253,0.4413493483260925
1215,019,3238,21,1395,1287,3217,3238,1.0,0.006485484867201977,0.993514515132798,556,0.4308214947498456,0.397467572575664,0.17171093267449042
1216,019,2358,49,1518,306,2309,2358,1.0,0.020780322307039863,0.9792196776929601,534,0.6437659033078881,0.1297709923664122,0.22646310432569974
1217,019,2812,188,1389,177,2624,2812,1.0,0.06685633001422475,0.9331436699857752,1246,0.49395448079658605,0.06294452347083926,0.44310099573257467
1218,019,1847,19,900,946,1828,1847,1.3504023408924652,0.01028695181375203,0.989713048186248,1,0.48727666486193827,0.5121819166215484,0.0005414185165132648
1219,019,3742,33,1292,1550,3709,3742,1.0,0.008818813468733297,0.9911811865312667,900,0.3452699091394976,0.4142169962586852,0.24051309460181722
1220,019,2039,11,1116,390,2028,2039,1.0,0.005394801373222168,0.9946051986267779,533,0.5473271211378127,0.19127023050514957,0.26140264835703775
1221,019,3544,3,720,724,3541,3544,1.0,0.0008465011286681715,0.9991534988713319,2100,0.20316027088036118,0.20428893905191872,0.59255079006772
1222,019,2126,11,84,364,2115,2126,1.0,0.0051740357478833494,0.9948259642521167,1678,0.03951081843838194,0.17121354656632173,0.7892756349952963
1223,019,2214,111,1769,444,2103,2214,36.88333333333333,0.05013550135501355,0.9498644986449865,1,0.7990063233965673,0.2005420054200542,0.00045167118337850043
1224,019,2927,29,801,813,2898,2927,1.0,0.009907755380936112,0.9900922446190639,1313,0.2736590365562009,0.2777587974034848,0.4485821660403143
1225,019,2282,16,579,701,2266,2282,1.0,0.007011393514460999,0.992988606485539,1002,0.2537248028045574,0.30718667835232255,0.43908851884312006
1226,019,2782,7,1208,764,2775,2782,1.0,0.0025161754133716753,0.9974838245866283,810,0.43421998562185476,0.27462257368799425,0.291157440690151
1227,019,7301,68,3334,3966,7233,7301,4.486785494775661,0.009313792631146418,0.9906862073688536,1,0.45664977400356116,0.5432132584577455,0.00013696753869332968
1228,019,3794,46,301,466,3748,3794,1.0,0.012124406958355299,0.9878755930416447,3027,0.07933579335793357,0.12282551396942541,0.797838692672641
1229,019,3632,33,1149,917,3599,3632,1.0,0.00908590308370044,0.9909140969162996,1566,0.3163546255506608,0.25247797356828194,0.43116740088105726
1230,019,2892,103,1827,1064,2789,2892,1.2596949891067537,0.03561549100968188,0.9643845089903181,1,0.6317427385892116,0.367911479944675,0.00034578146611341634
1231,019,1958,26,976,981,1932,1958,3.21875,0.013278855975485188,0.9867211440245148,1,0.49846782431052095,0.5010214504596527,0.0005107252298263534
1232,019,3305,0,997,421,3305,3305,1.0,0.0,1.0,1887,0.3016641452344932,0.12738275340393343,0.5709531013615734
1233,019,1440,42,598,841,1398,1440,2.3247172859450727,0.029166666666666667,0.9708333333333333,1,0.4152777777777778,0.5840277777777778,0.0006944444444444445
1234,019,3569,7,1324,275,3562,3569,1.0,0.001961333706920706,0.9980386662930792,1970,0.37097226113757353,0.07705239562902774,0.5519753432333987
1235,019,2175,67,761,186,2108,2175,1.0,0.030804597701149426,0.9691954022988506,1228,0.34988505747126436,0.08551724137931034,0.5645977011494253
1236,019,3493,26,1155,706,3467,3493,1.0,0.007443458345261953,0.9925565416547381,1632,0.3306613226452906,0.20211852275980532,0.46722015459490407
1237,019,2321,10,1674,477,2311,2321,1.0,0.004308487720809996,0.99569151227919,170,0.7212408444635933,0.2055148642826368,0.07324429125376992
1238,019,2501,16,1530,970,2485,2501,1.112099644128114,0.006397441023590564,0.9936025589764095,1,0.6117552978808477,0.38784486205517793,0.00039984006397441024
1239,019,3254,11,1315,1938,3243,3254,2.0129950495049505,0.003380454824830977,0.996619545175169,1,0.4041180086047941,0.5955746773202213,0.00030731407498463427
1240,019,2993,14,1701,1291,2979,2993,6.678571428571429,0.004677581022385567,0.9953224189776144,1,0.5683260942198463,0.4313397928499833,0.0003341129301703976
1241,019,3598,33,1287,1295,3565,3598,1.0,0.009171762090050028,0.99082823790995,1016,0.3576987215119511,0.35992217898832685,0.28237909949972206
1242,019,1929,17,1006,922,1912,1929,1.0332261521972133,0.008812856402280975,0.991187143597719,1,0.5215137376879212,0.47796785899429756,0.0005184033177812338
1243,019,2572,11,1134,767,2561,2572,1.0,0.0042768273716951785,0.9957231726283048,671,0.44090202177293936,0.29821150855365475,0.2608864696734059
1244,019,6964,72,1576,1600,6892,6964,1.0,0.010338885697874785,0.9896611143021252,3788,0.22630672027570362,0.22975301550832855,0.5439402642159679
1245,019,5235,37,1286,1350,5198,5235,1.0,0.007067812798471824,0.9929321872015282,2599,0.24565425023877746,0.25787965616045844,0.4964660936007641
1246,019,3348,50,1107,1126,3298,3348,1.0,0.014934289127837515,0.9850657108721624,1115,0.33064516129032256,0.3363201911589008,0.3330346475507766
1247,019,3304,9,701,747,3295,3304,1.0,0.002723970944309927,0.9972760290556901,1856,0.21216707021791767,0.22608958837772397,0.5617433414043583
1248,019,2766,28,1594,272,2738,2766,1.0,0.01012292118582791,0.9898770788141721,900,0.5762834417932032,0.09833694866232827,0.32537960954446854
1249,019,2553,36,1082,608,2517,2553,1.0,0.01410105757931845,0.9858989424206815,863,0.4238151194672934,0.2381511946729338,0.33803368585977284
1250,019,2924,62,2261,662,2862,2924,1.8641581632653061,0.021203830369357045,0.978796169630643,1,0.7732558139534884,0.22640218878248974,0.0003419972640218878
1251,019,5676,59,1030,754,5617,5676,1.0,0.010394644115574348,0.9896053558844257,3892,0.1814658210007047,0.1328400281888654,0.6856941508104298
1252,019,6306,126,913,699,6180,6306,1.0,0.019980970504281638,0.9800190294957184,4694,0.14478274659054868,0.11084681255946717,0.7443704408499842
1253,019,2411,19,1479,931,2392,2411,2.2800378429517503,0.007880547490667772,0.9921194525093322,1,0.6134384072998755,0.38614682704272085,0.00041476565740356696
1254,019,6937,122,1464,1741,6815,6937,1.0,0.0175868531065302,0.9824131468934698,3732,0.2110422372783624,0.2509730431022056,0.5379847196194321
1255,019,2168,24,1486,681,2144,2168,1.7953603976801988,0.01107011070110701,0.988929889298893,1,0.6854243542435424,0.31411439114391143,0.00046125461254612545
1256,019,5960,61,1147,225,5899,5960,1.0,0.01023489932885906,0.989765100671141,4588,0.1924496644295302,0.037751677852348994,0.7697986577181208
1257,019,1239,8,559,670,1231,1239,1.0,0.00645682001614205,0.993543179983858,10,0.45117029862792574,0.5407586763518967,0.008071025020177562
1258,019,10268,275,94,214,9993,10268,1.0,0.026782236073237244,0.9732177639267627,9960,0.009154655239579276,0.020841449162446436,0.9700038955979743
1259,019,2481,57,2033,447,2424,2481,1.007311129163282,0.022974607013301087,0.9770253929866989,1,0.8194276501410721,0.18016928657799275,0.00040306328093510683
1260,019,5310,192,775,1004,5118,5310,1.0,0.03615819209039548,0.9638418079096045,3531,0.14595103578154425,0.18907721280602638,0.6649717514124294
1261,019,3201,169,146,137,3032,3201,1.0,0.052796001249609495,0.9472039987503905,2918,0.04561074664167448,0.04279912527335208,0.9115901280849734
1262,019,3782,182,1601,976,3600,3782,1.0,0.048122686409307246,0.9518773135906927,1205,0.423320994182972,0.25806451612903225,0.31861448968799577
1263,019,2024,1159,1216,807,865,2024,1.2290400972053463,0.5726284584980237,0.42737154150197626,1,0.6007905138339921,0.3987154150197628,0.0004940711462450593
1264,019,4560,10,2379,2180,4550,4560,2.271549576482312,0.0021929824561403508,0.9978070175438597,1,0.5217105263157895,0.4780701754385965,0.0002192982456140351
1265,019,3545,19,1845,706,3526,3545,1.0,0.005359661495063469,0.9946403385049365,994,0.5204513399153737,0.1991537376586742,0.28039492242595204
1266,019,4293,16,1908,748,4277,4293,1.0,0.0037269974376892617,0.9962730025623108,1637,0.4444444444444444,0.17423713021197298,0.38131842534358257
1267,019,432,0,262,170,432,432,6.967741935483871,0.0,1.0,0,0.6064814814814815,0.39351851851851855,0.0
1268,019,2938,20,1792,1145,2918,2938,1.420899854862119,0.0068073519400953025,0.9931926480599047,1,0.6099387338325392,0.3897208985704561,0.0003403675970047651
1269,019,2621,26,760,728,2595,2621,1.0,0.009919877909194963,0.990080122090805,1133,0.28996566196108353,0.27775658145745896,0.43227775658145745
1270,019,2096,74,634,1040,2022,2096,1.0,0.035305343511450385,0.9646946564885496,422,0.30248091603053434,0.4961832061068702,0.2013358778625954
1271,019,1519,106,98,5,1413,1519,1.0,0.06978275181040158,0.9302172481895984,1416,0.06451612903225806,0.0032916392363396972,0.9321922317314022
1272,019,2446,83,790,1065,2363,2446,1.0,0.0339329517579722,0.9660670482420278,591,0.32297628781684384,0.43540474243663124,0.24161896974652494
1273,019,2676,103,761,356,2573,2676,1.0,0.03849028400597907,0.9615097159940209,1559,0.2843796711509716,0.13303437967115098,0.5825859491778774
1274,019,1664,112,937,726,1552,1664,2.8623063683304646,0.0673076923076923,0.9326923076923077,1,0.5631009615384616,0.4362980769230769,0.0006009615384615385
1275,019,2033,92,1647,385,1941,2033,1.6947456213511258,0.04525332021642892,0.9547466797835711,1,0.8101328086571569,0.18937530742744713,0.0004918839153959665
1276,019,2013,11,1468,188,2002,2013,1.0,0.00546448087431694,0.994535519125683,357,0.7292598112270243,0.09339294585196224,0.17734724292101342
1277,021,1556,33,435,640,1523,1556,1.0,0.021208226221079693,0.9787917737789203,481,0.2795629820051414,0.41131105398457585,0.30912596401028275
1278,021,738,27,259,193,711,738,1.0,0.036585365853658534,0.9634146341463414,286,0.3509485094850949,0.26151761517615174,0.3875338753387534
1279,021,2531,42,674,883,2489,2531,1.0,0.016594231529039907,0.9834057684709601,974,0.2662979059660213,0.3488739628605294,0.3848281311734492
1280,021,1021,27,412,205,994,1021,1.0,0.02644466209598433,0.9735553379040157,404,0.40352595494613125,0.2007835455435847,0.395690499510284
1281,021,2988,15,1160,1449,2973,2988,1.0,0.0050200803212851405,0.9949799196787149,379,0.38821954484605087,0.48493975903614456,0.12684069611780455
1282,021,3063,4,1208,1372,3059,3063,1.0,0.001305909239307868,0.9986940907606922,483,0.39438459027097617,0.44792686908259877,0.15768854064642507
1283,021,3147,95,633,1083,3052,3147,1.0,0.030187480139815696,0.9698125198601844,1431,0.2011439466158246,0.34413727359389895,0.4547187797902765
1284,021,3334,107,633,1188,3227,3334,1.0,0.032093581283743254,0.9679064187162567,1513,0.1898620275944811,0.35632873425314937,0.4538092381523695
1285,021,6398,122,72,165,6276,6398,1.0,0.019068458893404187,0.9809315411065959,6161,0.011253516723976243,0.025789309159112223,0.9629571741169115
1286,021,1586,102,436,162,1484,1586,1.0,0.06431273644388398,0.935687263556116,988,0.27490542244640603,0.1021437578814628,0.6229508196721312
1287,021,3681,84,1014,1268,3597,3681,1.0,0.022819885900570498,0.9771801140994295,1399,0.2754686226568867,0.34447161097527845,0.38005976636783484
1288,021,1827,108,493,211,1719,1827,1.0,0.059113300492610835,0.9408866995073891,1123,0.2698412698412698,0.11548987411056376,0.6146688560481663
1289,021,3037,5,1106,1449,3032,3037,1.0,0.0016463615409944023,0.9983536384590056,482,0.3641751728679618,0.4771155745801778,0.15870925255186039
1290,021,2736,43,576,1290,2693,2736,1.0,0.015716374269005847,0.9842836257309941,870,0.21052631578947367,0.47149122807017546,0.31798245614035087
1291,021,2370,132,429,451,2238,2370,1.0,0.05569620253164557,0.9443037974683545,1490,0.1810126582278481,0.19029535864978903,0.6286919831223629
1292,021,4173,168,947,1283,4005,4173,1.0,0.040258806613946804,0.9597411933860532,1943,0.22693505871075964,0.3074526719386532,0.4656122693505871
1293,021,2578,128,585,623,2450,2578,1.0,0.04965089216446858,0.9503491078355314,1370,0.2269200930954228,0.24166020170674943,0.5314197051978278
1294,021,1471,31,173,413,1440,1471,1.0,0.02107409925220938,0.9789259007477906,885,0.11760707002039429,0.2807613868116927,0.601631543167913
1295,021,1270,35,265,569,1235,1270,1.0,0.027559055118110236,0.9724409448818898,436,0.20866141732283464,0.44803149606299214,0.34330708661417325
1296,021,1225,39,194,459,1186,1225,1.0,0.03183673469387755,0.9681632653061224,572,0.15836734693877552,0.3746938775510204,0.4669387755102041
1297,021,9160,594,531,939,8566,9160,1.0,0.0648471615720524,0.9351528384279476,7690,0.05796943231441048,0.10251091703056768,0.8395196506550219
1298,021,10438,556,439,698,9882,10438,1.0,0.05326690936961104,0.946733090630389,9301,0.04205786549147346,0.0668710480935045,0.8910710864150221
1299,021,1891,21,292,1033,1870,1891,1.0,0.01110523532522475,0.9888947646747752,566,0.15441565309360128,0.5462718138551031,0.2993125330512956
1300,021,4300,31,1025,1682,4269,4300,1.0,0.007209302325581395,0.9927906976744186,1593,0.23837209302325582,0.3911627906976744,0.37046511627906975
1301,021,9216,112,2228,3820,9104,9216,1.0,0.012152777777777778,0.9878472222222222,3168,0.2417534722222222,0.4144965277777778,0.34375
1302,021,7501,71,2041,3460,7430,7501,1.0,0.009465404612718305,0.9905345953872817,2000,0.2720970537261698,0.46127183042261033,0.26663111585121985
1303,021,2244,2096,507,68,148,2244,1.0,0.9340463458110517,0.0659536541889483,1669,0.22593582887700533,0.030303030303030304,0.7437611408199644
1304,021,5246,169,1541,1514,5077,5246,1.0,0.03221502096835684,0.9677849790316432,2191,0.2937476172321769,0.2886008387342737,0.41765154403354937
1305,021,833,43,125,187,790,833,1.0,0.05162064825930372,0.9483793517406963,521,0.15006002400960383,0.22448979591836735,0.6254501800720288
1306,021,2870,156,676,673,2714,2870,1.0,0.05435540069686411,0.9456445993031359,1521,0.23554006968641114,0.23449477351916376,0.5299651567944251
1307,021,2632,150,689,723,2482,2632,1.0,0.056990881458966566,0.9430091185410334,1220,0.26177811550151975,0.27469604863221886,0.4635258358662614
1308,021,2982,155,745,757,2827,2982,1.0,0.051978537894030855,0.9480214621059692,1480,0.24983232729711602,0.25385647216633134,0.49631120053655264
1309,021,3180,26,889,1072,3154,3180,1.0,0.008176100628930818,0.9918238993710692,1219,0.27955974842767295,0.3371069182389937,0.38333333333333336
1310,021,3229,203,745,534,3026,3229,1.0,0.06286776091669248,0.9371322390833076,1950,0.23072158563022607,0.16537627748528957,0.6039021368844844
1311,021,4515,120,1064,1483,4395,4515,1.0,0.026578073089700997,0.973421926910299,1968,0.23565891472868217,0.3284606866002215,0.43588039867109635
1312,021,2552,90,434,591,2462,2552,1.0,0.03526645768025078,0.9647335423197492,1527,0.1700626959247649,0.23158307210031348,0.5983542319749217
1313,021,3677,100,1037,1396,3577,3677,1.0,0.027196083763937992,0.972803916236062,1244,0.28202338863203696,0.37965732934457436,0.3383192820233886
1314,021,3707,33,885,1220,3674,3707,1.0,0.008902077151335312,0.9910979228486647,1602,0.23873752360399245,0.3291070946857297,0.43215538171027784
1315,021,3962,86,912,1469,3876,3962,1.0,0.02170620898536093,0.9782937910146391,1581,0.23018677435638565,0.3707723372034326,0.3990408884401817
1316,021,3200,38,538,898,3162,3200,1.0,0.011875,0.988125,1764,0.168125,0.280625,0.55125
1317,021,4081,52,796,1319,4029,4081,1.0,0.01274197500612595,0.987258024993874,1966,0.19505023278608186,0.3232050967900025,0.4817446704239157
1318,021,4172,47,786,1490,4125,4172,1.0,0.011265580057526366,0.9887344199424737,1896,0.188398849472675,0.35714285714285715,0.45445829338446786
1319,021,3179,23,563,1416,3156,3179,1.0,0.007234979553318654,0.9927650204466814,1200,0.17709971689210444,0.44542308902170497,0.3774771940861906
1320,021,2676,21,597,1250,2655,2676,1.0,0.007847533632286996,0.992152466367713,829,0.22309417040358745,0.4671150971599402,0.30979073243647237
1321,021,3156,36,643,1033,3120,3156,1.0,0.011406844106463879,0.9885931558935361,1480,0.20373891001267427,0.32731305449936626,0.46894803548795944
1322,021,3138,30,937,1456,3108,3138,1.0,0.009560229445506692,0.9904397705544933,745,0.29859783301465903,0.4639898024219248,0.2374123645634162
1323,021,892,1,137,364,891,892,1.0,0.0011210762331838565,0.9988789237668162,391,0.15358744394618834,0.4080717488789238,0.4383408071748879
1324,021,1940,47,737,409,1893,1940,1.0,0.02422680412371134,0.9757731958762886,794,0.37989690721649483,0.21082474226804124,0.4092783505154639
1325,021,44,0,4,27,44,44,1.0,0.0,1.0,13,0.09090909090909091,0.6136363636363636,0.29545454545454547
1326,021,193,5,28,84,188,193,1.0,0.025906735751295335,0.9740932642487047,81,0.14507772020725387,0.43523316062176165,0.41968911917098445
1327,021,332,321,138,11,11,332,1.0,0.9668674698795181,0.03313253012048193,183,0.41566265060240964,0.03313253012048193,0.5512048192771084
1328,021,2253,70,406,914,2183,2253,1.0,0.031069684864624945,0.9689303151353751,933,0.18020417221482468,0.4056813138038171,0.4141145139813582
1329,021,3627,144,727,1061,3483,3627,1.0,0.03970223325062035,0.9602977667493796,1839,0.2004411359250069,0.29252826027019574,0.5070306038047974
1330,021,3561,50,607,1215,3511,3561,1.0,0.014040999719180006,0.98595900028082,1739,0.17045773659084526,0.34119629317607414,0.4883459702330806
1331,021,2748,27,703,1430,2721,2748,1.0,0.009825327510917031,0.990174672489083,615,0.25582241630276564,0.5203784570596798,0.22379912663755458
1332,021,2576,40,441,1050,2536,2576,1.0,0.015527950310559006,0.984472049689441,1085,0.17119565217391305,0.4076086956521739,0.421195652173913
1333,021,4369,23,893,1470,4346,4369,1.0,0.005264362554360266,0.9947356374456398,2006,0.20439459830624856,0.3364614328221561,0.4591439688715953
1334,021,1291,1187,415,45,104,1291,1.0,0.919442292796282,0.08055770720371805,831,0.3214562354763749,0.034856700232378,0.6436870642912471
1335,021,1834,1672,422,63,162,1834,1.0,0.9116684841875682,0.08833151581243184,1349,0.2300981461286805,0.03435114503816794,0.7355507088331515
1336,021,1606,1521,438,58,85,1606,1.0,0.9470734744707348,0.05292652552926526,1110,0.2727272727272727,0.0361145703611457,0.6911581569115816
1337,021,2642,23,417,701,2619,2642,1.0,0.00870552611657835,0.9912944738834216,1524,0.1578349735049205,0.26532929598788796,0.5768357305071915
1338,021,3405,8,894,1507,3397,3405,1.0,0.0023494860499265785,0.9976505139500734,1004,0.26255506607929513,0.44258443465491926,0.2948604992657856
1339,021,2197,7,511,877,2190,2197,1.0,0.0031861629494765588,0.9968138370505234,809,0.2325898953117888,0.3991807009558489,0.3682294037323623
1340,021,2063,67,376,687,1996,2063,1.0,0.03247697527872031,0.9675230247212797,1000,0.18225884634028114,0.3330101793504605,0.4847309743092584
1341,021,4897,66,1279,1849,4831,4897,1.0,0.013477639371043496,0.9865223606289565,1769,0.261180314478252,0.3775781090463549,0.3612415764753931
1342,021,2393,27,570,856,2366,2393,1.0,0.011282908483075638,0.9887170915169243,967,0.2381947346427079,0.357709987463435,0.4040952778938571
1343,021,5317,90,1132,2078,5227,5317,1.0,0.016926838442730862,0.9830731615572691,2107,0.21290201241301485,0.39082189204438594,0.3962760955425992
1344,021,3108,27,597,1379,3081,3108,1.0,0.008687258687258687,0.9913127413127413,1132,0.1920849420849421,0.4436936936936937,0.3642213642213642
1345,021,1309,7,324,640,1302,1309,1.0,0.0053475935828877,0.9946524064171123,345,0.2475171886936593,0.48892284186401835,0.2635599694423224
1346,021,2194,51,711,714,2143,2194,1.0,0.02324521422060164,0.9767547857793983,769,0.3240656335460346,0.325432999088423,0.3505013673655424
1347,021,3570,76,1128,1070,3494,3570,1.0,0.021288515406162466,0.9787114845938375,1372,0.31596638655462184,0.29971988795518206,0.3843137254901961
1348,021,4039,58,948,1489,3981,4039,1.0,0.014359990096558554,0.9856400099034415,1602,0.23471156226788809,0.36865560782371876,0.39663282990839316
1349,021,4055,53,851,1583,4002,4055,1.0,0.013070283600493218,0.9869297163995068,1621,0.20986436498150432,0.3903822441430333,0.3997533908754624
1350,021,669,568,279,45,101,669,1.0,0.8490284005979073,0.15097159940209268,345,0.4170403587443946,0.06726457399103139,0.515695067264574
1351,021,3421,67,1053,1202,3354,3421,1.0,0.019584916691026015,0.980415083308974,1166,0.30780473545746856,0.35135925168079507,0.3408360128617363
1352,021,3828,80,1200,1240,3748,3828,1.0,0.02089864158829676,0.9791013584117032,1388,0.31347962382445144,0.3239289446185998,0.3625914315569488
1353,021,7825,141,2495,2853,7684,7825,1.0,0.018019169329073482,0.9819808306709266,2477,0.31884984025559104,0.3646006389776358,0.3165495207667732
1354,021,4169,73,1012,1176,4096,4169,1.0,0.01751019429119693,0.9824898057088031,1981,0.24274406332453827,0.28208203406092586,0.47517390261453585
1355,021,1894,152,376,264,1742,1894,1.0,0.08025343189017951,0.9197465681098205,1254,0.19852164730728616,0.13938753959873285,0.662090813093981
1356,021,3766,129,970,1443,3637,3766,1.0,0.03425385023898035,0.9657461497610197,1353,0.2575677110993096,0.3831651619755709,0.3592671269251195
1357,021,1348,2,382,604,1346,1348,1.0,0.001483679525222552,0.9985163204747775,362,0.28338278931750743,0.44807121661721067,0.2685459940652819
1358,021,3637,72,883,1460,3565,3637,1.0,0.019796535606268904,0.9802034643937311,1294,0.24278251306021445,0.4014297497937861,0.3557877371459994
1359,021,5848,71,1474,2337,5777,5848,1.0,0.012140902872777018,0.987859097127223,2037,0.25205198358413133,0.39962380300957595,0.34832421340629277
1360,021,3699,52,910,1149,3647,3699,1.0,0.014057853473911868,0.9859421465260881,1640,0.2460124357934577,0.31062449310624496,0.4433630711002974
1361,021,9102,78,1929,4435,9024,9102,1.0,0.008569545154911009,0.991430454845089,2738,0.2119314436387607,0.48725554823115796,0.3008130081300813
1362,021,4749,57,806,1920,4692,4749,1.0,0.012002526847757423,0.9879974731522426,2023,0.16971994104021898,0.40429564118761846,0.42598441777216256
1363,021,3198,71,1015,812,3127,3198,1.0,0.022201375859912446,0.9777986241400876,1371,0.31738586616635395,0.25390869293308316,0.42870544090056284
1364,021,2229,70,425,855,2159,2229,1.0,0.03140421713772992,0.9685957828622701,949,0.19066846119336026,0.3835800807537012,0.4257514580529385
1365,021,4201,28,1562,1848,4173,4201,1.0,0.006665079742918353,0.9933349202570817,791,0.37181623422994525,0.4398952630326113,0.18828850273744346
1366,021,1631,21,616,591,1610,1631,1.0,0.012875536480686695,0.9871244635193133,424,0.3776824034334764,0.3623543838136113,0.25996321275291234
1367,021,4120,72,976,1496,4048,4120,1.0,0.017475728155339806,0.9825242718446602,1648,0.23689320388349513,0.36310679611650487,0.4
1368,021,3594,34,760,1389,3560,3594,1.0,0.009460211463550361,0.9905397885364496,1445,0.21146355036171396,0.38647746243739567,0.4020589872008904
1369,021,2477,34,439,1174,2443,2477,1.0,0.013726281792490917,0.9862737182075091,864,0.17723052079127977,0.473960436011304,0.34880904319741624
1370,021,3680,60,935,1339,3620,3680,1.0,0.016304347826086956,0.9836956521739131,1406,0.25407608695652173,0.36385869565217394,0.38206521739130433
1371,021,2855,46,630,1175,2809,2855,1.0,0.016112084063047285,0.9838879159369527,1050,0.22066549912434325,0.4115586690017513,0.36777583187390545
1372,021,3687,134,790,1200,3553,3687,1.0,0.03634391103878492,0.9636560889612151,1697,0.2142663411988066,0.32546786004882017,0.4602657987523732
1373,021,4009,92,1278,1146,3917,4009,1.0,0.022948366176103765,0.9770516338238963,1585,0.3187827388376154,0.2858568221501621,0.3953604390122225
1374,021,3521,60,1096,944,3461,3521,1.0,0.017040613462084634,0.9829593865379154,1481,0.31127520590741264,0.2681056518034649,0.4206191422891224
1375,021,4818,120,1481,1617,4698,4818,1.0,0.024906600249066,0.975093399750934,1720,0.3073889580738896,0.3356164383561644,0.35699460356994606
1377,021,469,8,80,138,461,469,1.0,0.017057569296375266,0.9829424307036247,251,0.17057569296375266,0.2942430703624733,0.535181236673774
1378,021,274,12,51,57,262,274,1.0,0.043795620437956206,0.9562043795620438,166,0.18613138686131386,0.20802919708029197,0.6058394160583942
1379,023,747,15,293,66,732,747,1.0,0.020080321285140562,0.9799196787148594,388,0.392235609103079,0.08835341365461848,0.5194109772423026
1380,023,2237,11,641,161,2226,2237,1.0,0.0049172999552972736,0.9950827000447027,1435,0.286544479213232,0.07197139025480555,0.6414841305319624
1381,023,1084,6,385,130,1078,1084,1.0,0.005535055350553505,0.9944649446494465,569,0.3551660516605166,0.11992619926199262,0.5249077490774908
1382,023,718,4,188,58,714,718,1.0,0.005571030640668524,0.9944289693593314,472,0.2618384401114206,0.0807799442896936,0.6573816155988857
1383,023,1354,0,694,218,1354,1354,1.0,0.0,1.0,442,0.5125553914327917,0.16100443131462333,0.32644017725258495
1384,023,646,4,221,354,642,646,1.0,0.006191950464396285,0.9938080495356038,71,0.34210526315789475,0.5479876160990712,0.10990712074303406
1385,023,4351,52,1691,1046,4299,4351,1.0,0.011951275568834751,0.9880487244311652,1614,0.388646288209607,0.24040450471156055,0.37094920707883244
1386,023,2472,42,1069,284,2430,2472,1.0,0.01699029126213592,0.9830097087378641,1119,0.4324433656957929,0.11488673139158576,0.4526699029126214
1387,023,663,2,174,80,661,663,1.0,0.0030165912518853697,0.9969834087481146,409,0.26244343891402716,0.12066365007541478,0.6168929110105581
1388,023,1599,13,491,158,1586,1599,1.0,0.008130081300813009,0.991869918699187,950,0.3070669168230144,0.09881175734834272,0.5941213258286429
1389,023,2084,29,1008,605,2055,2084,1.0,0.013915547024952015,0.986084452975048,471,0.4836852207293666,0.2903071017274472,0.22600767754318618
1390,023,845,2,310,81,843,845,1.0,0.002366863905325444,0.9976331360946745,454,0.3668639053254438,0.09585798816568047,0.5372781065088758
1391,023,492,9,178,108,483,492,1.0,0.018292682926829267,0.9817073170731707,206,0.3617886178861789,0.21951219512195122,0.4186991869918699
1392,023,953,5,496,246,948,953,1.0,0.005246589716684155,0.9947534102833159,211,0.5204616998950682,0.25813221406086045,0.22140608604407136
1393,023,940,5,290,525,935,940,1.0,0.005319148936170213,0.9946808510638298,125,0.30851063829787234,0.5585106382978723,0.13297872340425532
1394,023,700,3,205,82,697,700,1.0,0.004285714285714286,0.9957142857142857,413,0.29285714285714287,0.11714285714285715,0.59
1395,023,3823,31,1444,639,3792,3823,1.0,0.008108815066701544,0.9918911849332984,1740,0.3777138373005493,0.1671462202458802,0.4551399424535705
1396,023,606,4,317,140,602,606,1.0,0.006600660066006601,0.9933993399339934,149,0.523102310231023,0.23102310231023102,0.24587458745874588
1397,023,3451,43,1229,515,3408,3451,1.0,0.012460156476383656,0.9875398435236163,1707,0.35612865835989566,0.14923210663575776,0.4946392350043466
1398,023,1447,8,517,135,1439,1447,1.0,0.0055286800276434,0.9944713199723566,795,0.35729094678645473,0.09329647546648238,0.5494125777470629
1399,023,3096,53,972,402,3043,3096,1.0,0.017118863049095608,0.9828811369509044,1722,0.313953488372093,0.1298449612403101,0.5562015503875969
1400,023,676,0,226,81,676,676,1.0,0.0,1.0,369,0.3343195266272189,0.11982248520710059,0.5458579881656804
1401,023,71,1,26,26,70,71,1.0,0.014084507042253521,0.9859154929577465,19,0.36619718309859156,0.36619718309859156,0.2676056338028169
1402,023,160,4,73,54,156,160,1.0,0.025,0.975,33,0.45625,0.3375,0.20625
1403,025,10387,94,1592,5725,10293,10387,1.0,0.00904977375565611,0.9909502262443439,3070,0.15326850871281408,0.551169731395013,0.2955617598921729
1405,025,10242,91,2250,5132,10151,10242,1.0,0.008884983401679359,0.9911150165983207,2860,0.21968365553602812,0.5010740089826206,0.2792423354813513
1406,025,9030,155,2764,3166,8875,9030,1.0,0.01716500553709856,0.9828349944629015,3100,0.3060908084163898,0.350609080841639,0.3433001107419712
1407,025,5799,50,1888,2512,5749,5799,1.0,0.00862217623728229,0.9913778237627177,1399,0.32557337471977926,0.43317813416106227,0.24124849111915847
1408,025,9977,162,2985,4909,9815,9977,1.0,0.016237345895559786,0.9837626541044402,2083,0.299188132705222,0.49203167284754934,0.20878019444722862
1409,025,4772,29,1141,3266,4743,4772,1.0,0.006077116512992456,0.9939228834870075,365,0.23910310142497904,0.684409052808047,0.07648784576697401
1410,025,8628,155,1572,3196,8473,8628,1.0,0.017964765878535002,0.982035234121465,3860,0.18219749652294853,0.3704218822438572,0.4473806212331943
1411,025,1167,41,153,638,1126,1167,1.0,0.03513281919451585,0.9648671808054842,376,0.13110539845758354,0.5467009425878321,0.3221936589545844
1412,025,1525,35,140,655,1490,1525,1.0,0.022950819672131147,0.9770491803278688,730,0.09180327868852459,0.42950819672131146,0.4786885245901639
1413,025,61,0,13,19,61,61,1.0,0.0,1.0,29,0.21311475409836064,0.3114754098360656,0.47540983606557374
1414,025,1979,25,280,1044,1954,1979,1.0,0.012632642748863061,0.9873673572511369,655,0.1414855987872663,0.5275391611925214,0.3309752400202122
1415,025,1100,3,270,729,1097,1100,1.0,0.0027272727272727275,0.9972727272727273,101,0.24545454545454545,0.6627272727272727,0.09181818181818181
1416,025,7869,56,2916,3538,7813,7869,1.0,0.007116533231668573,0.9928834667683314,1415,0.37056805184902786,0.4496124031007752,0.17981954505019698
1417,025,6670,58,1839,3790,6612,6670,1.0,0.008695652173913044,0.991304347826087,1041,0.275712143928036,0.568215892053973,0.156071964017991
1418,025,79,2,2,76,77,79,1.1470588235294117,0.02531645569620253,0.9746835443037974,1,0.02531645569620253,0.9620253164556962,0.012658227848101266
1419,025,969,9,150,487,960,969,1.0,0.009287925696594427,0.9907120743034056,332,0.15479876160990713,0.5025799793601651,0.34262125902992774
1420,025,435,8,86,267,427,435,1.0,0.01839080459770115,0.9816091954022989,82,0.19770114942528735,0.6137931034482759,0.18850574712643678
1421,025,88,2,16,38,86,88,1.0,0.022727272727272728,0.9772727272727273,34,0.18181818181818182,0.4318181818181818,0.38636363636363635
1422,025,1023,14,194,554,1009,1023,1.0,0.013685239491691105,0.9863147605083089,275,0.18963831867057673,0.541544477028348,0.26881720430107525
1423,025,62,0,7,23,62,62,1.0,0.0,1.0,32,0.11290322580645161,0.3709677419354839,0.5161290322580645
1424,025,14383,182,2994,6217,14201,14383,1.0,0.012653827435166517,0.9873461725648335,5172,0.2081624139609261,0.4322464020023639,0.35959118403671003
1425,025,8168,127,1620,4626,8041,8168,1.0,0.015548481880509304,0.9844515181194907,1922,0.19833496571988246,0.566356513222331,0.2353085210577865
1426,025,6200,61,2789,2010,6139,6200,1.0,0.009838709677419354,0.9901612903225806,1401,0.44983870967741935,0.3241935483870968,0.22596774193548388
1427,025,11217,126,3131,4113,11091,11217,1.0,0.01123294998662744,0.9887670500133725,3973,0.27912989212802,0.36667558170633857,0.35419452616564145
1428,025,10097,160,2668,3516,9937,10097,1.0,0.015846290977518076,0.9841537090224819,3913,0.2642369020501139,0.3482222442309597,0.38754085371892644
1429,025,88,0,21,42,88,88,1.0,0.0,1.0,25,0.23863636363636365,0.4772727272727273,0.2840909090909091
1430,025,3335,35,997,1374,3300,3335,1.0,0.010494752623688156,0.9895052473763118,964,0.2989505247376312,0.41199400299850075,0.2890554722638681
1431,025,7074,72,3423,2118,7002,7074,1.0,0.010178117048346057,0.989821882951654,1533,0.48388464800678543,0.29940627650551316,0.21670907548770144
1432,025,848,10,125,429,838,848,1.0,0.01179245283018868,0.9882075471698113,294,0.1474056603773585,0.5058962264150944,0.3466981132075472
1433,025,429,3,109,266,426,429,1.0,0.006993006993006993,0.993006993006993,54,0.2540792540792541,0.62004662004662,0.1258741258741259
1434,025,4903,44,811,2316,4859,4903,1.0,0.008974097491331838,0.9910259025086682,1776,0.1654089333061391,0.4723638588619213,0.3622272078319396
1435,025,5245,32,1286,2974,5213,5245,1.0,0.006101048617731172,0.9938989513822688,985,0.2451858913250715,0.5670162059103908,0.18779790276453764
1436,025,11690,79,2957,5512,11611,11690,1.0,0.006757912745936698,0.9932420872540633,3221,0.25295124037639005,0.47151411462788706,0.27553464499572283
1437,025,9791,743,1726,4184,9048,9791,1.0,0.07588601777142273,0.9241139822285772,3881,0.17628434276376265,0.42733122255132266,0.39638443468491474
1438,025,2396,30,360,1287,2366,2396,1.0,0.012520868113522538,0.9874791318864775,749,0.15025041736227046,0.5371452420701168,0.3126043405676127
1439,025,90,0,15,75,90,90,1.0344827586206897,0.0,1.0,0,0.16666666666666666,0.8333333333333334,0.0
1440,025,8768,110,1243,4547,8658,8768,1.0,0.012545620437956205,0.9874543795620438,2978,0.1417655109489051,0.5185903284671532,0.3396441605839416
1441,025,3400,149,1271,1152,3251,3400,1.0,0.043823529411764706,0.9561764705882353,977,0.3738235294117647,0.3388235294117647,0.2873529411764706
1442,025,119,6,35,29,113,119,1.0,0.05042016806722689,0.9495798319327731,55,0.29411764705882354,0.24369747899159663,0.46218487394957986
1443,025,641,3,129,446,638,641,1.0,0.0046801872074883,0.9953198127925117,66,0.20124804992199688,0.6957878315132605,0.1029641185647426
1444,025,416,0,114,266,416,416,1.0,0.0,1.0,36,0.27403846153846156,0.6394230769230769,0.08653846153846154
1445,025,4152,142,924,1652,4010,4152,1.0,0.03420038535645472,0.9657996146435452,1576,0.22254335260115607,0.3978805394990366,0.37957610789980734
1446,025,3673,24,555,2545,3649,3673,1.0,0.006534168254832562,0.9934658317451674,573,0.151102640893003,0.6928940920228696,0.15600326708412743
1447,025,165,2,41,67,163,165,1.0,0.012121212121212121,0.9878787878787879,57,0.24848484848484848,0.40606060606060607,0.34545454545454546
1448,027,2495,81,510,260,2414,2495,1.0,0.03246492985971944,0.9675350701402805,1725,0.20440881763527055,0.10420841683366733,0.6913827655310621
1449,027,2245,39,533,388,2206,2245,1.0,0.01737193763919822,0.9826280623608018,1324,0.2374164810690423,0.17282850779510023,0.5897550111358575
1450,027,3528,92,546,386,3436,3528,1.0,0.026077097505668934,0.9739229024943311,2596,0.15476190476190477,0.10941043083900227,0.735827664399093
1451,027,5911,93,1515,1208,5818,5911,1.0,0.01573337844696329,0.9842666215530367,3188,0.25630181018440196,0.20436474369818983,0.5393334461174082
1452,027,3153,37,754,1234,3116,3153,1.0,0.011734855692990803,0.9882651443070092,1165,0.2391373295274342,0.3913732952743419,0.3694893751982239
1453,027,3963,47,1060,580,3916,3963,1.0,0.011859702245773405,0.9881402977542266,2323,0.2674741357557406,0.14635377239465053,0.5861720918496088
1454,027,5896,60,1554,556,5836,5896,1.0,0.0101763907734057,0.9898236092265943,3786,0.2635685210312076,0.09430122116689281,0.6421302578018996
1455,027,2091,10,427,635,2081,2091,1.0,0.004782400765184123,0.9952175992348159,1029,0.20420851267336204,0.3036824485891918,0.4921090387374462
1456,027,4008,41,450,1443,3967,4008,1.0,0.010229540918163672,0.9897704590818364,2115,0.1122754491017964,0.36002994011976047,0.5276946107784432
1457,027,7840,95,1543,2516,7745,7840,1.0,0.01211734693877551,0.9878826530612245,3781,0.1968112244897959,0.3209183673469388,0.48227040816326533
1458,027,3331,46,728,1234,3285,3331,1.0,0.013809666766736716,0.9861903332332633,1369,0.21855298709096369,0.37045932152506755,0.4109876913839688
1459,027,3135,44,599,1142,3091,3135,1.0,0.014035087719298246,0.9859649122807017,1394,0.19106858054226475,0.36427432216905903,0.44465709728867625
1460,027,3429,63,735,531,3366,3429,1.0,0.01837270341207349,0.9816272965879265,2163,0.21434820647419073,0.15485564304461943,0.6307961504811899
1461,027,928,15,207,219,913,928,1.0,0.016163793103448277,0.9838362068965517,502,0.22306034482758622,0.23599137931034483,0.540948275862069
1462,027,3968,87,854,1127,3881,3968,1.0,0.021925403225806453,0.9780745967741935,1987,0.21522177419354838,0.2840221774193548,0.5007560483870968
1463,027,3398,64,698,761,3334,3398,1.0,0.01883460859329017,0.9811653914067098,1939,0.20541494997057091,0.22395526780459094,0.5706297822248382
1464,027,5382,67,893,1838,5315,5382,1.0,0.01244890375325158,0.9875510962467484,2651,0.1659234485321442,0.34150873281308064,0.49256781865477517
1465,027,333,3,53,213,330,333,1.0,0.009009009009009009,0.990990990990991,67,0.15915915915915915,0.6396396396396397,0.2012012012012012
1466,027,287,0,55,62,287,287,1.0,0.0,1.0,170,0.1916376306620209,0.21602787456445993,0.5923344947735192
1467,027,3569,41,541,1449,3528,3569,1.0,0.011487811711964136,0.9885121882880359,1579,0.15158307649201458,0.40599607733258614,0.4424208461753993
1468,027,1,0,0,0,1,1,1.0,0.0,1.0,1,0.0,0.0,1.0
1469,027,4538,47,864,1512,4491,4538,1.0,0.010356985456148084,0.989643014543852,2162,0.19039224327897752,0.33318642573821067,0.4764213309828118
1470,027,3652,45,611,1301,3607,3652,1.0,0.012322015334063527,0.9876779846659365,1740,0.16730558598028478,0.3562431544359255,0.4764512595837897
1471,027,9660,92,1396,3633,9568,9660,1.0,0.009523809523809525,0.9904761904761905,4631,0.14451345755693581,0.3760869565217391,0.47939958592132503
1472,027,4576,29,780,1975,4547,4576,1.0,0.006337412587412587,0.9936625874125874,1821,0.17045454545454544,0.43159965034965037,0.3979458041958042
1473,027,1587,24,353,218,1563,1587,1.0,0.015122873345935728,0.9848771266540642,1016,0.22243226212980466,0.13736609955891618,0.6402016383112792
1474,027,1624,84,394,355,1540,1624,1.0,0.05172413793103448,0.9482758620689655,875,0.24261083743842365,0.2185960591133005,0.5387931034482759
1475,027,1182,164,309,178,1018,1182,1.0,0.13874788494077833,0.8612521150592216,695,0.2614213197969543,0.1505922165820643,0.5879864636209814
1476,027,6502,47,1784,470,6455,6502,1.0,0.00722854506305752,0.9927714549369425,4248,0.274377114733928,0.0722854506305752,0.6533374346354968
1477,027,4601,51,1498,482,4550,4601,1.0,0.01108454683764399,0.988915453162356,2621,0.32558139534883723,0.10475983481851771,0.5696587698326451
1478,027,14463,260,2421,865,14203,14463,1.0,0.017976906589227685,0.9820230934107723,11177,0.16739265712507778,0.059807785383392105,0.7727995574915301
1479,027,2422,126,567,347,2296,2422,1.0,0.05202312138728324,0.9479768786127167,1508,0.23410404624277456,0.14327002477291495,0.6226259289843105
1480,027,940,22,192,286,918,940,1.0,0.023404255319148935,0.9765957446808511,462,0.20425531914893616,0.30425531914893617,0.49148936170212765
1481,027,927,7,182,482,920,927,1.0,0.007551240560949299,0.9924487594390508,263,0.19633225458468176,0.5199568500539374,0.2837108953613808
1482,027,2774,63,620,801,2711,2774,1.0,0.022710886806056235,0.9772891131939437,1353,0.22350396539293438,0.28875270367700073,0.4877433309300649
1483,027,3666,83,850,869,3583,3666,1.0,0.022640480087288598,0.9773595199127114,1947,0.23186033824331698,0.23704309874522642,0.5310965630114566
1484,027,3358,109,850,565,3249,3358,1.0,0.032459797498511016,0.967540202501489,1943,0.2531268612269208,0.16825491363907089,0.5786182251340083
1485,027,3205,92,797,731,3113,3205,1.0,0.028705148205928236,0.9712948517940717,1677,0.2486739469578783,0.2280811232449298,0.5232449297971918
1486,027,3424,57,754,828,3367,3424,1.0,0.01664719626168224,0.9833528037383178,1842,0.22021028037383178,0.24182242990654207,0.5379672897196262
1487,027,3101,36,714,827,3065,3101,1.0,0.011609158336020638,0.9883908416639794,1560,0.23024830699774265,0.2666881651080297,0.5030635278942277
1488,027,3430,70,888,998,3360,3430,1.0,0.02040816326530612,0.9795918367346939,1544,0.2588921282798834,0.2909620991253644,0.4501457725947522
1489,027,4601,60,1120,1011,4541,4601,1.0,0.013040643338404694,0.9869593566615953,2470,0.24342534231688764,0.21973484025211912,0.5368398174309933
1490,027,45,3,11,18,42,45,1.0,0.06666666666666667,0.9333333333333333,16,0.24444444444444444,0.4,0.35555555555555557
