,COUNTYFP20,VAP,APAMINVAP,PRES20D,PRES20R,OVAP,TOT_VOTES,factor,APAMINVAP_pct,OVAP_pct,PRES20None,PRES20D_pct,PRES20R_pct,PRES20None_pct
0,001,582,22,94,283,560,582,1.0,0.037800687285223365,0.9621993127147767,205,0.16151202749140894,0.48625429553264604,0.35223367697594504
1,001,3208,3115,1982,273,93,3208,1.0,0.9710099750623441,0.02899002493765586,953,0.6178304239401496,0.0850997506234414,0.297069825436409
2,001,2108,1831,989,148,277,2108,1.0,0.868595825426945,0.13140417457305503,971,0.4691650853889943,0.07020872865275142,0.4606261859582543
3,001,2540,130,333,1486,2410,2540,1.0,0.051181102362204724,0.9488188976377953,721,0.1311023622047244,0.5850393700787402,0.28385826771653544
4,001,535,530,393,76,5,535,1.0,0.9906542056074766,0.009345794392523364,66,0.7345794392523365,0.14205607476635515,0.1233644859813084
5,001,1048,54,111,746,994,1048,1.0,0.05152671755725191,0.9484732824427481,191,0.10591603053435114,0.7118320610687023,0.18225190839694658
6,001,1131,1126,748,87,5,1131,1.0,0.995579133510168,0.004420866489832007,296,0.6613616268788682,0.07692307692307693,0.26171529619805484
7,001,793,783,560,90,10,793,1.0,0.987389659520807,0.012610340479192938,143,0.7061790668348046,0.11349306431273644,0.18032786885245902
8,001,1196,46,159,862,1150,1196,1.0,0.038461538461538464,0.9615384615384616,175,0.13294314381270902,0.7207357859531772,0.14632107023411373
9,001,1228,68,105,684,1160,1228,1.0,0.05537459283387622,0.9446254071661238,439,0.08550488599348534,0.5570032573289903,0.3574918566775244
10,001,3192,2979,1940,416,213,3192,1.0,0.9332706766917294,0.06672932330827068,836,0.6077694235588973,0.13032581453634084,0.2619047619047619
11,001,660,624,416,65,36,660,1.0,0.9454545454545454,0.05454545454545454,179,0.6303030303030303,0.09848484848484848,0.27121212121212124
12,001,829,792,647,119,37,829,1.0,0.9553679131483716,0.04463208685162847,63,0.7804583835946924,0.14354644149577805,0.07599517490952955
13,001,147,3,42,91,144,147,1.0,0.02040816326530612,0.9795918367346939,14,0.2857142857142857,0.6190476190476191,0.09523809523809523
14,001,1006,982,548,168,24,1006,1.0,0.9761431411530815,0.02385685884691849,290,0.5447316103379721,0.16699801192842942,0.2882703777335984
15,001,1105,1099,591,61,6,1105,1.0,0.9945701357466064,0.005429864253393665,453,0.534841628959276,0.05520361990950226,0.4099547511312217
16,001,627,619,436,109,8,627,1.0,0.9872408293460925,0.012759170653907496,82,0.6953748006379585,0.17384370015948963,0.13078149920255183
17,001,1336,1329,889,103,7,1336,1.0,0.9947604790419161,0.005239520958083832,344,0.6654191616766467,0.07709580838323353,0.25748502994011974
18,001,571,557,321,74,14,571,1.0,0.9754816112084063,0.024518388791593695,176,0.5621716287215411,0.1295971978984238,0.30823117338003503
19,001,295,284,85,29,11,295,1.0,0.9627118644067797,0.03728813559322034,181,0.288135593220339,0.09830508474576272,0.6135593220338983
20,001,1722,1676,1030,123,46,1722,1.0,0.9732868757259001,0.026713124274099883,569,0.5981416957026713,0.07142857142857142,0.33042973286875726
21,001,252,248,135,29,4,252,1.0,0.9841269841269841,0.015873015873015872,88,0.5357142857142857,0.11507936507936507,0.3492063492063492
22,001,817,817,554,110,0,817,1.0,1.0,0.0,153,0.6780905752753978,0.1346389228886169,0.18727050183598531
23,001,413,9,79,225,404,413,1.0,0.021791767554479417,0.9782082324455206,109,0.19128329297820823,0.5447941888619855,0.2639225181598063
24,001,364,361,282,42,3,364,1.0,0.9917582417582418,0.008241758241758242,40,0.7747252747252747,0.11538461538461539,0.10989010989010989
25,001,1636,1435,724,327,201,1636,1.0,0.8771393643031785,0.12286063569682151,585,0.44254278728606355,0.19987775061124693,0.3575794621026895
26,001,321,290,173,26,31,321,1.0,0.9034267912772586,0.09657320872274143,122,0.5389408099688473,0.08099688473520249,0.38006230529595014
27,001,796,789,317,167,7,796,1.0,0.9912060301507538,0.008793969849246231,312,0.39824120603015073,0.20979899497487436,0.39195979899497485
28,001,1002,973,802,111,29,1002,1.0,0.9710578842315369,0.028942115768463075,89,0.8003992015968064,0.11077844311377245,0.08882235528942116
29,001,874,865,526,57,9,874,1.0,0.9897025171624714,0.010297482837528604,291,0.6018306636155606,0.06521739130434782,0.3329519450800915
30,001,756,749,566,61,7,756,1.0,0.9907407407407407,0.009259259259259259,129,0.7486772486772487,0.08068783068783068,0.17063492063492064
31,001,1316,81,92,558,1235,1316,1.0,0.06155015197568389,0.9384498480243161,666,0.06990881458966565,0.42401215805471126,0.506079027355623
32,001,1705,154,236,873,1551,1705,1.0,0.09032258064516129,0.9096774193548387,596,0.13841642228739004,0.5120234604105571,0.3495601173020528
33,001,3864,3749,2320,418,115,3864,1.0,0.9702380952380952,0.02976190476190476,1126,0.6004140786749482,0.10817805383022774,0.291407867494824
34,001,722,716,480,85,6,722,1.0,0.9916897506925207,0.008310249307479225,157,0.6648199445983379,0.11772853185595568,0.21745152354570638
35,001,1266,73,159,666,1193,1266,1.0,0.05766192733017378,0.9423380726698263,441,0.12559241706161137,0.5260663507109005,0.34834123222748814
36,001,1240,1228,736,93,12,1240,1.0,0.9903225806451613,0.00967741935483871,411,0.5935483870967742,0.075,0.33145161290322583
37,001,547,527,312,76,20,547,1.0,0.9634369287020109,0.03656307129798903,159,0.5703839122486288,0.13893967093235832,0.2906764168190128
38,001,329,329,294,35,0,329,1.0444444444444445,1.0,0.0,0,0.8936170212765957,0.10638297872340426,0.0
39,001,642,631,436,101,11,642,1.0,0.9828660436137072,0.017133956386292833,105,0.6791277258566978,0.1573208722741433,0.16355140186915887
40,001,1862,96,238,1140,1766,1862,1.0,0.05155746509129968,0.9484425349087003,484,0.12781954887218044,0.6122448979591837,0.25993555316863587
41,001,1838,1432,988,79,406,1838,1.0,0.779107725788901,0.22089227421109903,771,0.5375408052230686,0.04298150163220892,0.41947769314472255
42,001,698,694,425,70,4,698,1.0,0.994269340974212,0.0057306590257879654,203,0.6088825214899714,0.10028653295128939,0.29083094555873923
43,003,2223,80,442,958,2143,2223,1.0,0.03598740440845704,0.964012595591543,823,0.19883040935672514,0.43094916779127307,0.3702204228520018
44,003,2332,97,445,1239,2235,2332,1.0,0.04159519725557462,0.9584048027444254,648,0.19082332761578044,0.5313036020583191,0.27787307032590053
45,003,2408,98,508,986,2310,2408,1.0,0.040697674418604654,0.9593023255813954,914,0.21096345514950166,0.40946843853820597,0.3795681063122924
46,003,1619,53,908,223,1566,1619,1.0,0.032736256948733784,0.9672637430512662,488,0.560840024706609,0.13773934527486104,0.30142063001853
47,003,1708,73,698,440,1635,1708,1.0,0.04274004683840749,0.9572599531615925,570,0.40866510538641687,0.2576112412177986,0.3337236533957845
48,003,1684,61,783,366,1623,1684,1.0,0.03622327790973872,0.9637767220902613,535,0.4649643705463183,0.2173396674584323,0.3176959619952494
49,003,510,26,62,148,484,510,1.0,0.050980392156862744,0.9490196078431372,300,0.12156862745098039,0.2901960784313726,0.5882352941176471
50,003,1963,67,404,1006,1896,1963,1.0,0.03413143148242486,0.9658685685175752,553,0.20580743759551706,0.5124808965868568,0.2817116658176261
51,003,1837,32,751,257,1805,1837,1.0,0.017419706042460535,0.9825802939575394,829,0.4088187261839956,0.13990201415351117,0.4512792596624932
52,003,2378,51,926,413,2327,2378,1.0,0.02144659377628259,0.9785534062237174,1039,0.3894028595458368,0.1736753574432296,0.43692178301093354
53,003,2688,77,891,250,2611,2688,1.0,0.028645833333333332,0.9713541666666666,1547,0.3314732142857143,0.09300595238095238,0.5755208333333334
54,003,2260,50,664,212,2210,2260,1.0,0.022123893805309734,0.9778761061946902,1384,0.2938053097345133,0.09380530973451327,0.6123893805309735
55,003,2294,77,641,380,2217,2294,1.0,0.03356582388840453,0.9664341761115954,1273,0.2794245858761988,0.16564952048823017,0.5549258936355711
56,003,2061,81,390,1053,1980,2061,1.0,0.039301310043668124,0.9606986899563319,618,0.18922852983988356,0.5109170305676856,0.29985443959243085
57,003,2111,77,567,1180,2034,2111,1.0,0.0364756039791568,0.9635243960208432,364,0.26859308384651825,0.5589767882520132,0.1724301279014685
58,003,1424,56,296,462,1368,1424,1.0,0.03932584269662921,0.9606741573033708,666,0.20786516853932585,0.324438202247191,0.46769662921348315
59,003,971,35,231,511,936,971,1.0,0.03604531410916581,0.9639546858908342,229,0.23789907312049433,0.5262615859938208,0.23583934088568487
60,003,876,34,314,153,842,876,1.0,0.03881278538812785,0.9611872146118722,409,0.3584474885844749,0.17465753424657535,0.4668949771689498
61,003,1580,75,341,781,1505,1580,1.0,0.04746835443037975,0.9525316455696202,458,0.2158227848101266,0.49430379746835446,0.289873417721519
62,003,3850,132,576,332,3718,3850,1.0,0.03428571428571429,0.9657142857142857,2942,0.1496103896103896,0.08623376623376623,0.7641558441558441
63,003,1313,32,271,694,1281,1313,1.0,0.024371667936024372,0.9756283320639756,348,0.2063975628332064,0.5285605483625285,0.26504188880426505
64,003,369,5,130,147,364,369,1.0,0.013550135501355014,0.986449864498645,92,0.3523035230352303,0.3983739837398374,0.24932249322493225
65,003,328,17,31,147,311,328,1.0,0.051829268292682924,0.948170731707317,150,0.09451219512195122,0.4481707317073171,0.4573170731707317
66,003,2052,91,332,1239,1961,2052,1.0,0.04434697855750487,0.9556530214424951,481,0.1617933723196881,0.6038011695906432,0.23440545808966862
67,003,573,31,123,290,542,573,1.0,0.05410122164048865,0.9458987783595113,160,0.21465968586387435,0.506108202443281,0.2792321116928447
68,003,2856,104,722,1151,2752,2856,1.0,0.036414565826330535,0.9635854341736695,983,0.25280112044817926,0.40301120448179273,0.344187675070028
69,003,2997,69,871,1468,2928,2997,1.0,0.023023023023023025,0.9769769769769769,658,0.29062395729062396,0.48982315648982316,0.21955288621955288
70,003,2612,109,576,737,2503,2612,1.0,0.041730474732006126,0.9582695252679939,1299,0.22052067381316998,0.2821592649310873,0.49732006125574274
71,003,1574,54,372,524,1520,1574,1.0,0.03430749682337993,0.96569250317662,678,0.2363405336721728,0.33290978398983484,0.4307496823379924
72,003,1546,63,327,412,1483,1546,1.0,0.0407503234152652,0.9592496765847348,807,0.2115135834411384,0.2664941785252264,0.5219922380336351
73,003,2437,62,624,849,2375,2437,1.0,0.0254411161263849,0.9745588838736151,964,0.2560525235945835,0.3483791546983997,0.39556832170701683
74,003,2371,43,685,1261,2328,2371,1.0,0.018135807676086038,0.981864192323914,425,0.2889076339097427,0.5318431041754534,0.1792492619148039
75,003,2566,109,584,937,2457,2566,1.0,0.04247856586126267,0.9575214341387374,1045,0.22759158222915044,0.3651597817614965,0.40724863600935307
76,003,2560,118,517,758,2442,2560,1.0,0.04609375,0.95390625,1285,0.201953125,0.29609375,0.501953125
77,003,2300,106,442,1175,2194,2300,1.0,0.04608695652173913,0.9539130434782609,683,0.19217391304347825,0.5108695652173914,0.29695652173913045
78,003,1944,70,446,699,1874,1944,1.0,0.0360082304526749,0.9639917695473251,799,0.2294238683127572,0.3595679012345679,0.41100823045267487
79,003,1716,64,422,880,1652,1716,1.0,0.037296037296037296,0.9627039627039627,414,0.24592074592074592,0.5128205128205128,0.24125874125874125
80,003,1469,39,406,559,1430,1469,1.0,0.02654867256637168,0.9734513274336283,504,0.2763784887678693,0.3805309734513274,0.3430905377808033
81,003,6716,213,849,964,6503,6716,1.0,0.03171530673019655,0.9682846932698035,4903,0.1264145324597975,0.14353782013103036,0.7300476474091722
82,003,2213,66,550,1125,2147,2213,1.0,0.0298237686398554,0.9701762313601446,538,0.24853140533212834,0.508359692724808,0.24310890194306373
83,003,2771,66,731,1267,2705,2771,1.0,0.02381811620353663,0.9761818837964634,773,0.26380368098159507,0.4572356549981956,0.2789606640202093
84,003,2357,100,583,841,2257,2357,1.0,0.04242681374628765,0.9575731862537123,933,0.24734832414085703,0.35680950360627917,0.39584217225286383
85,003,2232,73,602,1330,2159,2232,1.0,0.03270609318996416,0.9672939068100358,300,0.26971326164874554,0.5958781362007168,0.13440860215053763
86,003,1791,98,346,994,1693,1791,1.0,0.05471803461753211,0.9452819653824679,451,0.19318816303740927,0.5549972082635399,0.2518146286990508
87,003,716,19,133,341,697,716,1.0,0.02653631284916201,0.973463687150838,242,0.1857541899441341,0.4762569832402235,0.33798882681564246
88,003,2759,79,501,1360,2680,2759,1.0,0.028633562885103298,0.9713664371148967,898,0.18158753171438927,0.4929322218194998,0.3254802464661109
89,003,2191,111,285,804,2080,2191,1.0,0.05066179826563213,0.9493382017343679,1102,0.1300775901414879,0.36695572797809217,0.5029666818804199
90,003,1688,64,205,758,1624,1688,1.0,0.037914691943127965,0.9620853080568721,725,0.12144549763033176,0.4490521327014218,0.42950236966824645
91,003,1536,65,228,496,1471,1536,1.0,0.042317708333333336,0.9576822916666666,812,0.1484375,0.3229166666666667,0.5286458333333334
92,005,1880,186,1178,357,1694,1880,1.0,0.09893617021276596,0.9010638297872341,345,0.6265957446808511,0.1898936170212766,0.18351063829787234
93,005,1600,120,1060,202,1480,1600,1.0,0.075,0.925,338,0.6625,0.12625,0.21125
94,005,1249,75,798,125,1174,1249,1.0,0.0600480384307446,0.9399519615692554,326,0.6389111289031225,0.100080064051241,0.2610088070456365
95,005,1575,92,1149,347,1483,1575,1.0,0.058412698412698416,0.9415873015873016,79,0.7295238095238096,0.22031746031746033,0.05015873015873016
96,005,2230,130,1342,623,2100,2230,1.0,0.05829596412556054,0.9417040358744395,265,0.6017937219730942,0.27937219730941704,0.11883408071748879
97,005,2427,132,1091,655,2295,2427,1.0,0.054388133498145856,0.9456118665018541,681,0.4495261639884631,0.2698805109188298,0.28059332509270707
98,005,2512,124,860,418,2388,2512,1.0,0.04936305732484077,0.9506369426751592,1234,0.34235668789808915,0.1664012738853503,0.4912420382165605
99,005,975,114,611,196,861,975,1.0,0.11692307692307692,0.8830769230769231,168,0.6266666666666667,0.20102564102564102,0.1723076923076923
100,005,4896,784,1193,405,4112,4896,1.0,0.16013071895424835,0.8398692810457516,3298,0.24366830065359477,0.08272058823529412,0.6736111111111112
101,005,2145,128,162,35,2017,2145,1.0,0.059673659673659674,0.9403263403263403,1948,0.07552447552447553,0.016317016317016316,0.9081585081585082
102,005,1761,476,595,240,1285,1761,1.0,0.27030096536059056,0.7296990346394094,926,0.3378762067007382,0.1362862010221465,0.5258375922771152
103,005,2243,252,872,174,1991,2243,1.0,0.11234953187695051,0.8876504681230495,1197,0.38876504681230495,0.07757467677218012,0.533660276415515
104,005,4193,175,248,63,4018,4193,1.0,0.041736227045075125,0.9582637729549248,3882,0.05914619604102075,0.015025041736227046,0.9258287622227522
105,005,3226,504,903,282,2722,3226,1.0,0.15623062616243025,0.8437693738375698,2041,0.27991320520768753,0.08741475511469311,0.6326720396776193
106,005,4530,1084,1622,647,3446,4530,1.0,0.2392935982339956,0.7607064017660045,2261,0.35805739514348783,0.14282560706401767,0.49911699779249447
107,005,2064,213,1181,533,1851,2064,1.0,0.10319767441860465,0.8968023255813954,350,0.5721899224806202,0.25823643410852715,0.1695736434108527
108,005,989,137,382,216,852,989,1.0,0.1385237613751264,0.8614762386248737,391,0.3862487360970677,0.21840242669362994,0.3953488372093023
109,005,1069,183,382,279,886,1069,1.0,0.17118802619270346,0.8288119738072965,408,0.35734331150608045,0.2609915809167446,0.3816651075771749
110,005,2072,243,1000,612,1829,2072,1.0,0.11727799227799228,0.8827220077220077,460,0.4826254826254826,0.2953667953667954,0.222007722007722
111,005,4047,197,427,118,3850,4047,1.0,0.04867803311094638,0.9513219668890536,3502,0.10551025450951322,0.02915740054361255,0.8653323449468743
112,005,2644,163,1303,699,2481,2644,1.0,0.061649016641452344,0.9383509833585476,642,0.49281391830559756,0.2643721633888048,0.2428139183055976
113,005,3645,375,1658,973,3270,3645,1.0,0.102880658436214,0.897119341563786,1014,0.45486968449931414,0.26694101508916324,0.2781893004115226
114,005,2629,514,994,455,2115,2629,1.0,0.19551160136934195,0.804488398630658,1180,0.3780905287181438,0.17306960821605172,0.4488398630658045
115,005,3319,365,1502,1032,2954,3319,1.0,0.10997288339861404,0.890027116601386,785,0.4525459475745707,0.3109370292256704,0.23651702319975895
116,005,2385,257,1119,645,2128,2385,1.0,0.10775681341719077,0.8922431865828092,621,0.4691823899371069,0.27044025157232704,0.26037735849056604
117,005,1732,463,549,411,1269,1732,1.0,0.26732101616628173,0.7326789838337182,772,0.3169745958429561,0.23729792147806006,0.4457274826789838
118,005,837,51,282,338,786,837,1.0,0.06093189964157706,0.9390681003584229,217,0.33691756272401435,0.4038231780167264,0.25925925925925924
119,005,611,16,143,467,595,611,1.0016420361247949,0.02618657937806874,0.9738134206219312,1,0.23404255319148937,0.7643207855973814,0.0016366612111292963
120,005,1020,1004,566,174,16,1020,1.0,0.984313725490196,0.01568627450980392,280,0.5549019607843138,0.17058823529411765,0.27450980392156865
121,005,872,848,653,140,24,872,1.0,0.9724770642201835,0.027522935779816515,79,0.7488532110091743,0.16055045871559634,0.09059633027522936
122,005,408,399,319,88,9,408,1.1243093922651934,0.9779411764705882,0.022058823529411766,1,0.7818627450980392,0.21568627450980393,0.0024509803921568627
123,005,328,324,186,23,4,328,1.0,0.9878048780487805,0.012195121951219513,119,0.5670731707317073,0.0701219512195122,0.3628048780487805
124,005,2186,314,752,1019,1872,2186,1.0,0.14364135407136322,0.8563586459286368,415,0.34400731930466605,0.46614821591948763,0.1898444647758463
125,005,93,8,39,36,85,93,1.0,0.08602150537634409,0.9139784946236559,18,0.41935483870967744,0.3870967741935484,0.1935483870967742
126,005,2020,263,688,946,1757,2020,1.0,0.1301980198019802,0.8698019801980198,386,0.3405940594059406,0.46831683168316834,0.1910891089108911
127,005,162,12,40,111,150,162,1.0,0.07407407407407407,0.9259259259259259,11,0.24691358024691357,0.6851851851851852,0.06790123456790123
128,005,341,8,197,117,333,341,1.0,0.02346041055718475,0.9765395894428153,27,0.5777126099706745,0.34310850439882695,0.07917888563049853
129,005,717,11,363,307,706,717,1.0,0.015341701534170154,0.9846582984658299,47,0.5062761506276151,0.4281729428172943,0.06555090655509066
130,005,1076,126,116,482,950,1076,1.0,0.1171003717472119,0.8828996282527881,478,0.10780669144981413,0.4479553903345725,0.44423791821561337
131,005,1570,322,495,149,1248,1570,1.0,0.2050955414012739,0.7949044585987262,926,0.31528662420382164,0.09490445859872612,0.5898089171974522
132,005,168,131,57,5,37,168,1.0,0.7797619047619048,0.22023809523809523,106,0.3392857142857143,0.02976190476190476,0.6309523809523809
133,005,654,639,307,154,15,654,1.0,0.9770642201834863,0.022935779816513763,193,0.4694189602446483,0.23547400611620795,0.29510703363914376
134,005,3295,221,1696,1063,3074,3295,1.0,0.06707132018209408,0.932928679817906,536,0.5147192716236723,0.3226100151745068,0.16267071320182094
135,005,197,13,61,114,184,197,1.0,0.06598984771573604,0.934010152284264,22,0.3096446700507614,0.5786802030456852,0.1116751269035533
136,005,53,6,4,12,47,53,1.0,0.11320754716981132,0.8867924528301887,37,0.07547169811320754,0.22641509433962265,0.6981132075471698
137,005,1319,1309,735,218,10,1319,1.0,0.9924184988627748,0.0075815011372251705,366,0.5572403335860501,0.1652767247915087,0.27748294162244125
138,005,922,56,135,430,866,922,1.0,0.06073752711496746,0.9392624728850325,357,0.14642082429501085,0.46637744034707157,0.3872017353579176
139,005,1066,1045,534,186,21,1066,1.0,0.9803001876172608,0.019699812382739212,346,0.50093808630394,0.17448405253283303,0.324577861163227
140,005,1429,1410,844,198,19,1429,1.0,0.986703988803359,0.013296011196641007,387,0.5906228131560531,0.13855843247025892,0.2708187543736879
141,005,582,574,257,26,8,582,1.0,0.9862542955326461,0.013745704467353952,299,0.4415807560137457,0.044673539518900345,0.5137457044673539
142,005,92,91,71,19,1,92,1.0,0.9891304347826086,0.010869565217391304,2,0.7717391304347826,0.20652173913043478,0.021739130434782608
143,005,1559,536,350,452,1023,1559,1.0,0.3438101347017319,0.6561898652982682,757,0.22450288646568314,0.28992944194996795,0.48556767158434894
144,005,1281,351,313,519,930,1281,1.0,0.27400468384074944,0.7259953161592506,449,0.24434035909445745,0.405152224824356,0.3505074160811866
145,005,1655,1102,330,285,553,1655,1.0,0.6658610271903324,0.3341389728096677,1040,0.19939577039274925,0.17220543806646527,0.6283987915407855
146,005,1365,223,387,544,1142,1365,1.0,0.16336996336996337,0.8366300366300367,434,0.2835164835164835,0.39853479853479856,0.31794871794871793
147,005,1226,47,303,700,1179,1226,1.0,0.03833605220228385,0.9616639477977161,223,0.24714518760195758,0.5709624796084829,0.18189233278955955
148,005,1000,30,316,552,970,1000,1.0,0.03,0.97,132,0.316,0.552,0.132
149,005,1203,38,456,331,1165,1203,1.0,0.03158769742310889,0.9684123025768911,416,0.3790523690773067,0.27514546965918535,0.3458021612635079
150,005,1665,26,797,607,1639,1665,1.0,0.015615615615615615,0.9843843843843844,261,0.4786786786786787,0.36456456456456454,0.15675675675675677
151,005,654,80,228,252,574,654,1.0,0.12232415902140673,0.8776758409785933,174,0.3486238532110092,0.3853211009174312,0.26605504587155965
152,005,2084,234,692,966,1850,2084,1.0,0.11228406909788867,0.8877159309021113,426,0.33205374280230326,0.463531669865643,0.20441458733205375
153,005,296,12,101,141,284,296,1.0,0.04054054054054054,0.9594594594594594,54,0.34121621621621623,0.47635135135135137,0.18243243243243243
154,005,420,417,269,40,3,420,1.0,0.9928571428571429,0.007142857142857143,111,0.6404761904761904,0.09523809523809523,0.2642857142857143
155,005,1676,1665,1140,241,11,1676,1.0,0.9934367541766109,0.0065632458233890216,295,0.6801909307875895,0.14379474940334128,0.1760143198090692
156,005,2116,370,694,848,1746,2116,1.0,0.17485822306238186,0.8251417769376181,574,0.3279773156899811,0.4007561436672968,0.2712665406427221
157,005,1211,1059,654,136,152,1211,1.0,0.8744838976052849,0.1255161023947151,421,0.5400495458298926,0.11230388109000826,0.3476465730800991
158,005,1107,1065,564,83,42,1107,1.0,0.962059620596206,0.037940379403794036,460,0.5094850948509485,0.07497741644083107,0.41553748870822044
159,005,4149,3978,2302,350,171,4149,1.0,0.9587852494577006,0.04121475054229935,1497,0.5548324897565678,0.08435767654856592,0.36080983369486624
160,005,1147,195,258,335,952,1147,1.0,0.17000871839581516,0.8299912816041848,554,0.22493461203138623,0.2920662598081953,0.48299912816041846
161,005,2963,122,525,1568,2841,2963,1.0,0.041174485318933515,0.9588255146810665,870,0.1771852851839352,0.5291933850826864,0.29362132973337834
162,005,1208,63,298,538,1145,1208,1.0,0.052152317880794705,0.9478476821192053,372,0.24668874172185432,0.445364238410596,0.3079470198675497
163,007,1323,109,263,540,1214,1323,1.0,0.08238851095993953,0.9176114890400605,520,0.19879062736205594,0.40816326530612246,0.3930461073318216
164,007,289,26,81,96,263,289,1.0,0.08996539792387544,0.9100346020761245,112,0.28027681660899656,0.33217993079584773,0.3875432525951557
165,007,206,14,47,57,192,206,1.0,0.06796116504854369,0.9320388349514563,102,0.22815533980582525,0.2766990291262136,0.49514563106796117
166,007,800,58,229,248,742,800,1.0,0.0725,0.9275,323,0.28625,0.31,0.40375
167,007,1386,210,262,444,1176,1386,1.0,0.15151515151515152,0.8484848484848485,680,0.18903318903318903,0.3203463203463203,0.4906204906204906
168,007,1353,343,260,474,1010,1353,1.0,0.2535107169253511,0.7464892830746489,619,0.19216555801921656,0.35033259423503327,0.4575018477457502
169,007,610,55,138,231,555,610,1.0,0.09016393442622951,0.9098360655737705,241,0.2262295081967213,0.37868852459016394,0.3950819672131147
170,007,761,57,187,206,704,761,1.0,0.07490144546649145,0.9250985545335085,368,0.2457293035479632,0.2706964520367937,0.4835742444152431
171,007,3612,3530,1265,260,82,3612,1.0,0.9772978959025471,0.022702104097452935,2087,0.3502214839424142,0.07198228128460686,0.5777962347729789
172,007,1125,1070,264,47,55,1125,1.0,0.9511111111111111,0.04888888888888889,814,0.23466666666666666,0.041777777777777775,0.7235555555555555
173,007,926,49,162,403,877,926,1.0,0.052915766738660906,0.9470842332613391,361,0.17494600431965443,0.4352051835853132,0.3898488120950324
174,007,652,39,148,211,613,652,1.0,0.0598159509202454,0.9401840490797546,293,0.22699386503067484,0.3236196319018405,0.4493865030674847
175,007,715,47,168,156,668,715,1.0,0.06573426573426573,0.9342657342657342,391,0.23496503496503496,0.21818181818181817,0.5468531468531469
176,007,750,21,148,181,729,750,1.0,0.028,0.972,421,0.19733333333333333,0.24133333333333334,0.5613333333333334
177,007,726,61,110,234,665,726,1.0,0.08402203856749312,0.9159779614325069,382,0.15151515151515152,0.32231404958677684,0.5261707988980716
178,007,1062,57,165,416,1005,1062,1.0,0.05367231638418079,0.9463276836158192,481,0.1553672316384181,0.391713747645951,0.4529190207156309
179,007,1077,80,205,361,997,1077,1.0,0.07428040854224698,0.9257195914577531,511,0.1903435468895079,0.33519034354688954,0.4744661095636026
180,007,288,12,48,152,276,288,1.0,0.041666666666666664,0.9583333333333334,88,0.16666666666666666,0.5277777777777778,0.3055555555555556
181,007,220,5,20,106,215,220,1.0,0.022727272727272728,0.9772727272727273,94,0.09090909090909091,0.4818181818181818,0.42727272727272725
182,007,1492,25,209,906,1467,1492,1.0,0.01675603217158177,0.9832439678284183,377,0.1400804289544236,0.6072386058981233,0.2526809651474531
183,007,1862,100,263,851,1762,1862,1.0,0.05370569280343716,0.9462943071965628,748,0.14124597207303974,0.45703544575725025,0.40171858216971
184,007,2358,174,414,1268,2184,2358,1.0,0.0737913486005089,0.926208651399491,676,0.17557251908396945,0.53774385072095,0.2866836301950806
185,007,2864,115,639,1708,2749,2864,1.0,0.040153631284916204,0.9598463687150838,517,0.22311452513966482,0.5963687150837989,0.1805167597765363
186,007,1418,34,322,694,1384,1418,1.0,0.023977433004231313,0.9760225669957687,402,0.22708039492242596,0.4894217207334274,0.2834978843441467
187,007,1547,73,255,744,1474,1547,1.0,0.04718810601163542,0.9528118939883645,548,0.16483516483516483,0.48093083387201035,0.35423400129282484
188,007,1147,49,217,589,1098,1147,1.0,0.042720139494333044,0.9572798605056669,341,0.1891891891891892,0.5135135135135135,0.2972972972972973
189,007,1643,42,313,881,1601,1643,1.0,0.02556299452221546,0.9744370054777846,449,0.1905051734631771,0.5362142422398052,0.2732805842970176
190,007,2088,50,369,1140,2038,2088,1.0,0.023946360153256706,0.9760536398467433,579,0.17672413793103448,0.5459770114942529,0.27729885057471265
191,007,2902,83,480,1685,2819,2902,1.0,0.028600964851826328,0.9713990351481737,737,0.16540317022742937,0.5806340454858718,0.25396278428669883
192,007,291,6,52,165,285,291,1.0,0.020618556701030927,0.979381443298969,74,0.17869415807560138,0.5670103092783505,0.2542955326460481
193,007,597,4,159,381,593,597,1.0,0.006700167504187605,0.9932998324958124,57,0.2663316582914573,0.6381909547738693,0.09547738693467336
194,007,732,29,97,374,703,732,1.0,0.03961748633879782,0.9603825136612022,261,0.1325136612021858,0.5109289617486339,0.35655737704918034
195,007,627,15,65,417,612,627,1.0,0.023923444976076555,0.9760765550239234,145,0.10366826156299841,0.6650717703349283,0.23125996810207336
196,007,2010,55,430,1188,1955,2010,1.0,0.02736318407960199,0.972636815920398,392,0.21393034825870647,0.591044776119403,0.19502487562189055
197,007,72,67,12,2,5,72,1.0,0.9305555555555556,0.06944444444444445,58,0.16666666666666666,0.027777777777777776,0.8055555555555556
198,007,650,31,149,413,619,650,1.0,0.047692307692307694,0.9523076923076923,88,0.22923076923076924,0.6353846153846154,0.13538461538461538
199,007,825,31,328,148,794,825,1.0,0.037575757575757575,0.9624242424242424,349,0.3975757575757576,0.17939393939393938,0.42303030303030303
200,009,2190,70,242,534,2120,2190,1.0,0.0319634703196347,0.9680365296803652,1414,0.11050228310502283,0.24383561643835616,0.645662100456621
201,009,2587,116,382,791,2471,2587,1.0,0.04483958252802474,0.9551604174719752,1414,0.14766138384228836,0.30575956706609975,0.5465790490916119
202,009,895,27,134,412,868,895,1.0,0.030167597765363128,0.9698324022346368,349,0.14972067039106146,0.46033519553072627,0.38994413407821227
203,009,780,36,177,305,744,780,1.0,0.046153846153846156,0.9538461538461539,298,0.22692307692307692,0.391025641025641,0.382051282051282
204,009,1942,77,296,876,1865,1942,1.0,0.03964984552008239,0.9603501544799176,770,0.15242018537590113,0.451081359423275,0.3964984552008239
205,009,1085,29,90,623,1056,1085,1.0,0.026728110599078342,0.9732718894009217,372,0.08294930875576037,0.5741935483870968,0.34285714285714286
206,009,2425,91,296,1149,2334,2425,1.0,0.037525773195876286,0.9624742268041238,980,0.1220618556701031,0.4738144329896907,0.4041237113402062
207,009,670,28,37,449,642,670,1.0,0.041791044776119404,0.9582089552238806,184,0.05522388059701493,0.6701492537313433,0.2746268656716418
208,009,3603,126,289,1715,3477,3603,1.0,0.034970857618651124,0.9650291423813488,1599,0.08021093533166805,0.475992228698307,0.443796835970025
209,009,321,24,22,196,297,321,1.0,0.07476635514018691,0.9252336448598131,103,0.06853582554517133,0.6105919003115264,0.32087227414330216
210,009,1385,1370,606,87,15,1385,1.0,0.9891696750902527,0.010830324909747292,692,0.4375451263537906,0.0628158844765343,0.4996389891696751
211,009,65,2,14,41,63,65,1.0,0.03076923076923077,0.9692307692307692,10,0.2153846153846154,0.6307692307692307,0.15384615384615385
212,009,147,4,12,113,143,147,1.0,0.027210884353741496,0.9727891156462585,22,0.08163265306122448,0.7687074829931972,0.14965986394557823
213,009,430,13,55,235,417,430,1.0,0.030232558139534883,0.9697674418604652,140,0.12790697674418605,0.5465116279069767,0.32558139534883723
214,009,2240,74,415,856,2166,2240,1.0,0.033035714285714286,0.9669642857142857,969,0.18526785714285715,0.3821428571428571,0.43258928571428573
215,009,1546,1528,471,88,18,1546,1.0,0.9883570504527813,0.01164294954721863,987,0.30465717981888746,0.056921086675291076,0.6384217335058214
216,009,314,11,46,123,303,314,1.0,0.03503184713375796,0.964968152866242,145,0.1464968152866242,0.39171974522292996,0.46178343949044587
217,009,1377,41,174,788,1336,1377,1.0,0.029774872912127815,0.9702251270878722,415,0.12636165577342048,0.5722585330428468,0.30137981118373275
218,009,1651,45,152,754,1606,1651,1.0,0.027256208358570563,0.9727437916414294,745,0.09206541490006057,0.4566929133858268,0.45124167171411267
219,009,1852,151,100,531,1701,1852,1.0,0.08153347732181425,0.9184665226781857,1221,0.05399568034557235,0.2867170626349892,0.6592872570194385
220,009,124,5,13,64,119,124,1.0,0.04032258064516129,0.9596774193548387,47,0.10483870967741936,0.5161290322580645,0.3790322580645161
221,009,86,3,11,19,83,86,1.0,0.03488372093023256,0.9651162790697675,56,0.12790697674418605,0.22093023255813954,0.6511627906976745
222,011,42,3,1,14,39,42,1.0,0.07142857142857142,0.9285714285714286,27,0.023809523809523808,0.3333333333333333,0.6428571428571429
223,011,60,3,2,23,57,60,1.0,0.05,0.95,35,0.03333333333333333,0.38333333333333336,0.5833333333333334
224,011,1532,85,329,400,1447,1532,1.0,0.05548302872062663,0.9445169712793734,803,0.21475195822454307,0.26109660574412535,0.5241514360313316
225,011,678,11,226,227,667,678,1.0,0.016224188790560472,0.9837758112094396,225,0.3333333333333333,0.33480825958702065,0.33185840707964603
226,011,1924,131,278,594,1793,1924,1.0,0.06808731808731809,0.931912681912682,1052,0.1444906444906445,0.3087318087318087,0.5467775467775468
227,011,609,58,46,152,551,609,1.0,0.09523809523809523,0.9047619047619048,411,0.0755336617405583,0.24958949096880131,0.6748768472906403
228,011,960,46,157,433,914,960,1.0,0.04791666666666667,0.9520833333333333,370,0.16354166666666667,0.4510416666666667,0.3854166666666667
229,011,1038,45,143,590,993,1038,1.0,0.04335260115606936,0.9566473988439307,305,0.13776493256262043,0.5684007707129094,0.29383429672447015
230,012,4232,1476,0,0,2756,4232,1.0,0.3487712665406427,0.6512287334593573,4232,0.0,0.0,1.0
231,012,691,420,167,73,271,691,1.0,0.6078147612156295,0.3921852387843705,451,0.24167872648335745,0.10564399421128799,0.6526772793053546
232,012,2123,97,290,1235,2026,2123,1.0,0.045690061234102686,0.9543099387658973,598,0.1365991521431936,0.5817239755063589,0.28167687235044747
233,012,692,26,73,340,666,692,1.0,0.03757225433526012,0.9624277456647399,279,0.10549132947976879,0.4913294797687861,0.4031791907514451
234,012,354,12,36,101,342,354,1.0,0.03389830508474576,0.9661016949152542,217,0.1016949152542373,0.2853107344632768,0.6129943502824858
235,012,2933,79,1161,1771,2854,2933,1.9026606099935106,0.026934878963518583,0.9730651210364815,1,0.3958404364132288,0.60381861575179,0.00034094783498124785
236,012,1718,67,231,725,1651,1718,1.0,0.0389988358556461,0.9610011641443539,762,0.13445867287543656,0.4220023282887078,0.4435389988358556
237,012,199,9,14,80,190,199,1.0,0.04522613065326633,0.9547738693467337,105,0.07035175879396985,0.4020100502512563,0.5276381909547738
238,012,654,38,86,281,616,654,1.0,0.0581039755351682,0.9418960244648318,287,0.13149847094801223,0.42966360856269115,0.43883792048929665
239,012,415,7,47,174,408,415,1.0,0.016867469879518072,0.983132530120482,194,0.11325301204819277,0.41927710843373495,0.4674698795180723
240,012,886,31,131,349,855,886,1.0,0.034988713318284424,0.9650112866817155,406,0.14785553047404063,0.3939051918735892,0.4582392776523702
242,013,7172,359,1770,1475,6813,7172,1.0,0.05005577244841049,0.9499442275515895,3927,0.2467930842163971,0.20566090351366426,0.5475460122699386
243,013,3591,92,1029,1788,3499,3591,1.0,0.025619604566972987,0.974380395433027,774,0.28654970760233917,0.4979114452798663,0.21553884711779447
244,013,6883,279,1655,328,6604,6883,1.0,0.04053465058840622,0.9594653494115938,4900,0.24044747929681826,0.047653639401423795,0.7118988813017579
245,013,3567,123,875,1192,3444,3567,1.0,0.034482758620689655,0.9655172413793104,1500,0.24530417717970282,0.3341743762265209,0.42052144659377627
246,013,8662,161,2853,4067,8501,8662,1.0,0.018586931424613252,0.9814130685753868,1742,0.32936966058646966,0.46952205033479566,0.2011082890787347
247,013,1967,25,575,804,1942,1967,1.0,0.012709710218607015,0.987290289781393,588,0.2923233350279614,0.40874428063040164,0.298932384341637
248,013,702,33,103,224,669,702,1.0,0.04700854700854701,0.9529914529914529,375,0.1467236467236467,0.3190883190883191,0.5341880341880342
249,013,4270,137,1936,1468,4133,4270,1.0,0.03208430913348946,0.9679156908665105,866,0.4533957845433255,0.3437939110070258,0.2028103044496487
250,013,4424,137,1422,1200,4287,4424,1.0,0.03096745027124774,0.9690325497287523,1802,0.32142857142857145,0.27124773960216997,0.4073236889692586
251,013,5783,319,1825,1300,5464,5783,1.0,0.05516168078851807,0.944838319211482,2658,0.31558014871174134,0.22479681826041847,0.45962303302784024
252,013,5046,97,2729,1874,4949,5046,1.0,0.019223147047166073,0.9807768529528339,443,0.5408244153785177,0.37138327388030123,0.08779231074118113
253,013,3078,165,586,220,2913,3078,1.0,0.05360623781676413,0.9463937621832359,2272,0.1903833658219623,0.0714749837556855,0.7381416504223521
254,013,2267,18,662,955,2249,2267,1.0,0.007940008822232024,0.992059991177768,650,0.29201588001764445,0.42126157917953244,0.2867225408028231
255,013,2817,89,304,489,2728,2817,1.0,0.03159389421370252,0.9684061057862975,2024,0.10791622293219737,0.17358892438764642,0.7184948526801562
256,013,1759,48,449,802,1711,1759,1.0,0.027288231949971573,0.9727117680500285,508,0.25525866969869243,0.4559408754974417,0.28880045480386585
257,013,3825,142,1096,549,3683,3825,1.0,0.03712418300653595,0.962875816993464,2180,0.2865359477124183,0.14352941176470588,0.5699346405228758
258,013,1925,45,811,708,1880,1925,1.0,0.023376623376623377,0.9766233766233766,406,0.4212987012987013,0.3677922077922078,0.2109090909090909
259,013,3301,117,914,906,3184,3301,1.0,0.03544380490760376,0.9645561950923962,1481,0.27688579218418663,0.2744622841563163,0.44865192365949713
260,013,4217,159,1179,1007,4058,4217,1.0,0.037704529286222435,0.9622954707137775,2031,0.2795826416884041,0.23879535214607542,0.48162200616552053
261,013,5612,116,1747,2191,5496,5612,1.0,0.020669992872416252,0.9793300071275838,1674,0.31129722024233786,0.39041339985744833,0.2982893799002138
262,013,4253,129,1430,1464,4124,4253,1.0,0.030331530684222903,0.9696684693157771,1359,0.3362332471196802,0.3442276040442041,0.31953914883611567
263,013,2602,70,462,875,2532,2602,1.0,0.026902382782475018,0.973097617217525,1265,0.17755572636433511,0.33627978478093773,0.48616448885472713
264,013,3041,44,812,1117,2997,3041,1.0,0.014468924695823742,0.9855310753041763,1112,0.2670174284774745,0.3673133837553436,0.3656691877671818
265,013,6707,167,1704,2678,6540,6707,1.0,0.024899358878783362,0.9751006411212166,2325,0.25406291933800507,0.3992843298046817,0.34665275085731323
266,013,7255,128,2750,2884,7127,7255,1.0,0.01764300482425913,0.9823569951757408,1621,0.37904893177119225,0.3975189524465886,0.22343211578221917
267,013,4466,142,1101,2368,4324,4466,1.0,0.03179579041648007,0.9682042095835199,997,0.2465293327362293,0.5302283922973579,0.22324227496641288
268,013,3711,119,1702,1056,3592,3711,1.0,0.032066828348154136,0.9679331716518459,953,0.458636486122339,0.28455941794664513,0.2568040959310159
269,013,5075,217,2408,847,4858,5075,1.0,0.04275862068965517,0.9572413793103448,1820,0.47448275862068967,0.16689655172413792,0.3586206896551724
270,013,291,21,21,128,270,291,1.0,0.07216494845360824,0.9278350515463918,142,0.07216494845360824,0.43986254295532645,0.4879725085910653
271,013,2409,30,810,1012,2379,2409,1.0,0.012453300124533,0.987546699875467,587,0.33623910336239105,0.4200913242009132,0.24366957243669574
272,013,3422,115,1323,1294,3307,3422,1.0,0.03360607831677381,0.9663939216832261,805,0.38661601402688484,0.3781414377556984,0.23524254821741672
273,013,2268,35,928,1124,2233,2268,1.0,0.015432098765432098,0.9845679012345679,216,0.4091710758377425,0.49559082892416223,0.09523809523809523
274,013,4397,106,1062,1310,4291,4397,1.0,0.02410734591767114,0.9758926540823288,2025,0.24152831476006367,0.2979304070957471,0.4605412781441892
275,013,1744,86,544,356,1658,1744,1.0,0.04931192660550459,0.9506880733944955,844,0.3119266055045872,0.20412844036697247,0.48394495412844035
276,013,4339,99,1207,1869,4240,4339,1.0,0.022816317123761237,0.9771836828762388,1263,0.2781746946300991,0.4307444111546439,0.29108089421525696
277,013,4709,55,2036,2009,4654,4709,1.0,0.011679762157570609,0.9883202378424294,664,0.43236355914206837,0.426629857719261,0.14100658313867062
278,013,4259,185,901,377,4074,4259,1.0,0.043437426625968535,0.9565625733740315,2981,0.2115520075135008,0.08851843155670346,0.6999295609297957
279,013,6596,165,1628,1960,6431,6596,1.0,0.02501516070345664,0.9749848392965433,3008,0.24681625227410553,0.2971497877501516,0.45603395997574286
280,013,5023,271,2038,950,4752,5023,1.0,0.053951821620545494,0.9460481783794545,2035,0.40573362532351187,0.18913000199084212,0.405136372685646
281,013,8872,632,2324,599,8240,8872,1.0,0.07123534715960325,0.9287646528403968,5949,0.26194770063119927,0.06751577998196573,0.670536519386835
282,013,2532,46,1089,779,2486,2532,1.0,0.018167456556082148,0.9818325434439179,664,0.43009478672985785,0.3076619273301738,0.26224328593996843
283,013,6846,198,2563,2604,6648,6846,1.0,0.028921998247151623,0.9710780017528484,1679,0.37437919953257376,0.3803680981595092,0.24525270230791704
284,013,5283,85,1719,2538,5198,5283,1.0,0.01608934317622563,0.9839106568237743,1026,0.32538330494037476,0.4804088586030664,0.19420783645655879
285,013,2439,97,812,734,2342,2439,1.0,0.03977039770397704,0.9602296022960229,893,0.3329233292332923,0.3009430094300943,0.36613366133661335
286,013,1826,23,877,689,1803,1826,1.0,0.012595837897042717,0.9874041621029573,260,0.48028477546549836,0.3773274917853231,0.14238773274917854
287,013,2500,97,500,216,2403,2500,1.0,0.0388,0.9612,1784,0.2,0.0864,0.7136
288,013,8049,421,902,202,7628,8049,1.0,0.05230463411603926,0.9476953658839607,6945,0.1120636103863834,0.02509628525282644,0.8628401043607902
289,013,2762,36,1301,1078,2726,2762,1.0,0.013034033309196235,0.9869659666908037,383,0.4710354815351195,0.390296886314265,0.1386676321506155
290,013,4989,247,907,1895,4742,4989,1.0,0.04950891962317098,0.9504910803768291,2187,0.18179995991180598,0.37983563840448986,0.43836440168370416
291,013,13368,784,2650,1579,12584,13368,1.0,0.05864751645721125,0.9413524835427888,9139,0.19823459006582886,0.1181178934769599,0.6836475164572112
292,013,3126,25,900,1442,3101,3126,1.0,0.00799744081893794,0.9920025591810621,784,0.28790786948176583,0.46129238643634035,0.2507997440818938
293,013,5256,181,1442,1511,5075,5256,1.0,0.03443683409436834,0.9655631659056316,2303,0.2743531202435312,0.2874809741248097,0.4381659056316591
294,013,3349,170,746,1119,3179,3349,1.0,0.050761421319796954,0.949238578680203,1484,0.222753060615109,0.3341295909226635,0.44311734846222756
295,013,1261,5,361,601,1256,1261,1.0,0.003965107057890563,0.9960348929421095,299,0.28628072957969863,0.4766058683584457,0.23711340206185566
296,013,9292,314,2610,2094,8978,9292,1.0,0.03379250968575118,0.9662074903142488,4588,0.280886784330607,0.2253551442100732,0.4937580714593198
297,013,4482,130,1215,1508,4352,4482,1.0,0.02900490852298081,0.9709950914770192,1759,0.2710843373493976,0.3364569388665774,0.39245872378402497
298,013,2293,24,680,999,2269,2293,1.0,0.010466637592673354,0.9895333624073267,614,0.2965547317924117,0.43567378979502835,0.26777147841255994
299,013,3583,159,423,155,3424,3583,1.0,0.04437622104381803,0.955623778956182,3005,0.11805749372034607,0.043259838124476695,0.8386826681551772
300,013,4812,115,1259,1707,4697,4812,1.0,0.023898586866167915,0.9761014131338321,1846,0.26163757273482957,0.35473815461346636,0.38362427265170407
301,013,3867,36,1382,1968,3831,3867,1.0,0.009309542280837859,0.9906904577191621,517,0.3573829842254978,0.5089216446858029,0.13369537108869925
302,013,7222,128,2218,3669,7094,7222,1.0,0.01772362226530047,0.9822763777346996,1335,0.30711714206590973,0.5080310163389643,0.184851841595126
303,013,3176,156,520,717,3020,3176,1.0,0.0491183879093199,0.9508816120906801,1939,0.163727959697733,0.22575566750629722,0.6105163727959698
304,013,4742,326,1175,831,4416,4742,1.0,0.06874736398144243,0.9312526360185576,2736,0.24778574441164067,0.1752425137072965,0.5769717418810628
305,013,5219,168,1733,1719,5051,5219,1.0,0.032190074726959186,0.9678099252730408,1767,0.33205594941559685,0.32937344318835027,0.3385706073960529
306,013,209,6,40,81,203,209,1.0,0.028708133971291867,0.9712918660287081,88,0.19138755980861244,0.3875598086124402,0.42105263157894735
307,013,2263,53,831,885,2210,2263,1.0,0.02342023862129916,0.9765797613787008,547,0.3672116659301812,0.3910737958462218,0.241714538223597
308,013,755,20,104,231,735,755,1.0,0.026490066225165563,0.9735099337748344,420,0.13774834437086092,0.30596026490066225,0.5562913907284768
309,013,4731,263,1469,521,4468,4731,1.0,0.055590784189389134,0.9444092158106109,2741,0.31050517860917354,0.11012470936377088,0.5793701120270556
310,013,10877,481,2828,2125,10396,10877,1.0,0.04422175232141216,0.9557782476785879,5924,0.25999816125769976,0.19536636940332813,0.5446354693389721
311,013,3267,25,1132,1473,3242,3267,1.0,0.007652280379553107,0.9923477196204469,662,0.3464952555861647,0.4508723599632691,0.20263238445056628
312,013,3659,135,1699,650,3524,3659,1.0,0.03689532659196502,0.963104673408035,1310,0.4643345176277672,0.17764416507242417,0.3580213172998087
313,013,2481,74,603,674,2407,2481,1.0,0.029826682789197905,0.9701733172108021,1204,0.2430471584038694,0.27166465135026197,0.4852881902458686
314,013,1498,32,841,574,1466,1498,1.0,0.021361815754339118,0.9786381842456608,83,0.5614152202937249,0.38317757009345793,0.05540720961281709
315,013,4428,79,1049,1434,4349,4428,1.0,0.017841011743450767,0.9821589882565492,1945,0.2369015356820235,0.3238482384823848,0.4392502258355917
316,013,1788,104,418,95,1684,1788,1.0,0.058165548098434,0.941834451901566,1275,0.23378076062639822,0.053131991051454136,0.7130872483221476
317,013,4942,109,2498,2092,4833,4942,1.0,0.02205584783488466,0.9779441521651153,352,0.5054633751517604,0.42331040064751113,0.07122622420072845
318,013,3869,41,1180,1648,3828,3869,1.0,0.01059705350219695,0.989402946497803,1041,0.30498836908761956,0.42594985784440426,0.26906177306797624
319,013,4098,72,1200,2203,4026,4098,1.0,0.017569546120058566,0.9824304538799414,695,0.29282576866764276,0.5375793069790141,0.16959492435334309
320,013,2583,74,1104,628,2509,2583,1.0,0.028648857917150602,0.9713511420828495,851,0.4274099883855981,0.24312814556716997,0.3294618660472319
321,013,5069,132,1367,2704,4937,5069,1.0,0.026040639179325312,0.9739593608206747,998,0.2696784375616492,0.5334385480370882,0.19688301440126257
322,013,2917,78,1394,1189,2839,2917,1.0,0.026739801165581077,0.9732601988344189,334,0.47788824134384644,0.4076105587932808,0.11450119986287281
323,013,247,2,97,141,245,247,1.0,0.008097165991902834,0.9919028340080972,9,0.39271255060728744,0.5708502024291497,0.03643724696356275
324,013,4185,126,1211,1884,4059,4185,1.0,0.030107526881720432,0.9698924731182795,1090,0.2893667861409797,0.45017921146953405,0.26045400238948624
325,013,3860,189,1227,425,3671,3860,1.0,0.04896373056994819,0.9510362694300518,2208,0.31787564766839377,0.11010362694300518,0.572020725388601
326,013,3632,76,1812,1206,3556,3632,1.0,0.02092511013215859,0.9790748898678414,614,0.4988986784140969,0.33204845814977973,0.16905286343612336
327,013,3461,39,1127,1853,3422,3461,1.0,0.011268419531927188,0.9887315804680729,481,0.3256284310892806,0.5353943946836175,0.13897717422710198
328,013,6755,254,1735,632,6501,6755,1.0,0.037601776461880086,0.9623982235381199,4388,0.25684678016284235,0.09356032568467802,0.6495928941524797
329,013,4315,211,1334,784,4104,4315,1.0,0.0488991888760139,0.9511008111239861,2197,0.30915411355735806,0.1816917728852839,0.5091541135573581
330,013,6552,218,1499,2060,6334,6552,1.0,0.03327228327228327,0.9667277167277167,2993,0.22878510378510378,0.3144078144078144,0.4568070818070818
331,013,3656,137,1086,1095,3519,3656,1.0,0.037472647702407005,0.962527352297593,1475,0.29704595185995625,0.299507658643326,0.40344638949671774
332,013,3940,166,1473,1164,3774,3940,1.0,0.04213197969543147,0.9578680203045685,1303,0.3738578680203046,0.2954314720812183,0.33071065989847714
333,013,4979,234,1882,931,4745,4979,1.0,0.04699738903394256,0.9530026109660574,2166,0.37798754770034143,0.18698533842136975,0.4350271138782888
334,013,9890,357,3463,1174,9533,9890,1.0,0.03609706774519717,0.9639029322548028,5253,0.35015166835187056,0.11870576339737109,0.5311425682507583
335,013,3470,79,1028,1528,3391,3470,1.0,0.02276657060518732,0.9772334293948127,914,0.2962536023054755,0.4403458213256484,0.2634005763688761
336,013,5675,69,2177,2261,5606,5675,1.0,0.012158590308370043,0.9878414096916299,1237,0.3836123348017621,0.3984140969162996,0.2179735682819383
337,013,3794,57,1200,2039,3737,3794,1.0,0.015023721665788086,0.9849762783342119,555,0.316288877174486,0.5374275171323142,0.1462836056931998
338,013,5880,475,2021,843,5405,5880,1.0,0.08078231292517007,0.91921768707483,3016,0.34370748299319726,0.1433673469387755,0.5129251700680272
339,013,3666,210,802,750,3456,3666,1.0,0.057283142389525366,0.9427168576104746,2114,0.21876704855428258,0.20458265139116202,0.5766503000545554
340,013,4981,399,1952,597,4582,4981,1.0,0.08010439670748845,0.9198956032925115,2432,0.391889178879743,0.1198554507127083,0.4882553704075487
341,013,5820,229,1328,561,5591,5820,1.0,0.039347079037800686,0.9606529209621993,3931,0.2281786941580756,0.09639175257731959,0.6754295532646049
342,013,5857,100,2006,2793,5757,5857,1.0,0.017073587160662457,0.9829264128393376,1058,0.34249615844288883,0.4768652893973024,0.18063855215980879
343,013,3392,228,760,163,3164,3392,1.0,0.06721698113207547,0.9327830188679245,2469,0.2240566037735849,0.04805424528301887,0.7278891509433962
344,013,8127,385,3404,1051,7742,8127,1.0,0.047372954349698536,0.9526270456503014,3672,0.41885074443213977,0.12932201304294327,0.45182724252491696
345,013,3209,36,1188,1832,3173,3209,1.0,0.01121844811467747,0.9887815518853226,189,0.3702087877843565,0.5708943596135868,0.058896852602056717
346,013,2493,131,930,694,2362,2493,1.0,0.05254713196951464,0.9474528680304853,869,0.3730445246690734,0.27837946249498596,0.34857601283594064
347,013,6124,306,1607,1227,5818,6124,1.0,0.04996734160679295,0.950032658393207,3290,0.2624101894186806,0.2003592423252776,0.5372305682560418
348,013,2356,94,690,762,2262,2356,1.0,0.039898132427843805,0.9601018675721562,904,0.2928692699490662,0.3234295415959253,0.3837011884550085
349,013,3896,39,1535,1618,3857,3896,1.0,0.010010266940451745,0.9899897330595483,743,0.39399383983572894,0.4152977412731006,0.19070841889117043
350,013,3962,83,1218,1246,3879,3962,1.0,0.020949015648662292,0.9790509843513377,1498,0.30742049469964666,0.31448763250883394,0.37809187279151946
351,013,3177,152,1515,754,3025,3177,1.0,0.04784387787220649,0.9521561221277935,908,0.4768649669499528,0.23733081523449795,0.28580421781554927
352,013,5828,201,1429,1505,5627,5828,1.0,0.03448867536032944,0.9655113246396706,2894,0.2451956074124914,0.2582361015785861,0.49656829100892247
353,013,8632,181,1624,2148,8451,8632,1.0,0.020968489341983317,0.9790315106580166,4860,0.1881371640407785,0.24884151992585726,0.5630213160333642
354,013,685,13,169,409,672,685,1.0,0.01897810218978102,0.981021897810219,107,0.24671532846715327,0.5970802919708029,0.1562043795620438
355,013,3955,55,1548,1554,3900,3955,1.0,0.01390644753476612,0.9860935524652339,853,0.39140328697850824,0.3929203539823009,0.21567635903919088
356,013,1221,13,530,618,1208,1221,1.0,0.010647010647010647,0.9893529893529893,73,0.43407043407043405,0.5061425061425061,0.05978705978705979
357,013,1481,31,780,440,1450,1481,1.0,0.020931802835921675,0.9790681971640783,261,0.5266711681296421,0.2970965563808238,0.1762322754895341
358,013,4368,71,1594,2004,4297,4368,1.0,0.016254578754578756,0.9837454212454212,770,0.3649267399267399,0.45879120879120877,0.1762820512820513
359,013,2203,120,522,405,2083,2203,1.0,0.05447117566954154,0.9455288243304585,1276,0.23694961416250568,0.18384021788470267,0.5792101679527917
360,013,6039,162,2708,2258,5877,6039,1.0,0.026825633383010434,0.9731743666169895,1073,0.4484186123530386,0.3739029640668985,0.17767842358006292
361,013,2310,39,795,953,2271,2310,1.0,0.016883116883116882,0.9831168831168832,562,0.34415584415584416,0.41255411255411256,0.24329004329004328
362,013,5596,210,1918,903,5386,5596,1.0,0.03752680486061472,0.9624731951393852,2775,0.3427448177269478,0.16136526090064332,0.49588992137240884
363,013,7126,214,2644,2505,6912,7126,1.0,0.03003087285994948,0.9699691271400506,1977,0.37103564412012346,0.3515296098793152,0.27743474600056134
364,013,4251,115,1994,964,4136,4251,1.0,0.027052458245118795,0.9729475417548812,1293,0.46906610209362504,0.22677017172430017,0.3041637261820748
365,013,2855,114,878,397,2741,2855,1.0,0.039929947460595444,0.9600700525394046,1580,0.3075306479859895,0.13905429071803854,0.553415061295972
366,013,4804,143,1333,1588,4661,4804,1.0,0.029766860949208992,0.970233139050791,1883,0.27747710241465445,0.3305578684429642,0.39196502914238135
367,013,4067,178,1191,583,3889,4067,1.0,0.04376690435210229,0.9562330956478977,2293,0.29284484878288664,0.1433489058273912,0.5638062453897221
368,013,7339,166,2676,2355,7173,7339,1.0,0.02261888540673116,0.9773811145932688,2308,0.36462733342417225,0.3208884044147704,0.31448426216105735
369,013,2172,84,874,763,2088,2172,1.0,0.03867403314917127,0.9613259668508287,535,0.40239410681399634,0.35128913443830573,0.24631675874769798
370,013,2253,78,913,762,2175,2253,1.0,0.03462050599201065,0.9653794940079894,578,0.40523746116289394,0.3382157123834887,0.25654682645361737
371,013,1709,12,472,817,1697,1709,1.0,0.007021650087770626,0.9929783499122293,420,0.2761849034523113,0.47805734347571677,0.24575775307197192
372,013,2328,101,667,692,2227,2328,1.0,0.04338487972508591,0.9566151202749141,969,0.2865120274914089,0.2972508591065292,0.4162371134020619
373,013,2919,17,1240,1289,2902,2919,1.0,0.005823912298732443,0.9941760877012675,390,0.4248030147310723,0.4415895854744776,0.13360739979445016
374,013,2385,77,745,712,2308,2385,1.0,0.03228511530398323,0.9677148846960167,928,0.31236897274633124,0.29853249475890986,0.3890985324947589
375,013,2840,98,773,280,2742,2840,1.0,0.03450704225352113,0.9654929577464789,1787,0.2721830985915493,0.09859154929577464,0.629225352112676
376,013,4470,129,2202,1302,4341,4470,1.0,0.028859060402684565,0.9711409395973154,966,0.49261744966442955,0.2912751677852349,0.21610738255033557
377,013,2753,75,1056,423,2678,2753,1.0,0.027243007628042135,0.9727569923719579,1274,0.3835815474028333,0.15365056302215765,0.4627678895750091
378,013,4854,115,1483,855,4739,4854,1.0,0.02369180057684384,0.9763081994231562,2516,0.3055212196126906,0.1761433868974042,0.5183353934899052
379,013,9134,612,538,258,8522,9134,1.0,0.06700240858331509,0.9329975914166849,8338,0.058900810159842346,0.028246113422377928,0.9128530764177797
380,013,1975,60,926,615,1915,1975,1.0,0.030379746835443037,0.9696202531645569,434,0.4688607594936709,0.31139240506329113,0.21974683544303797
381,013,4492,167,1690,1262,4325,4492,1.0,0.03717720391807658,0.9628227960819234,1540,0.37622439893143367,0.2809439002671416,0.3428317008014248
382,013,3380,71,1047,1718,3309,3380,1.0,0.021005917159763313,0.9789940828402367,615,0.30976331360946746,0.508284023668639,0.1819526627218935
383,013,3606,188,680,440,3418,3606,1.0,0.052135330005546314,0.9478646699944537,2486,0.18857459789240155,0.12201885745978924,0.6894065446478093
384,013,10679,496,2046,2611,10183,10679,1.0,0.0464462964697069,0.9535537035302931,6022,0.19159097293754096,0.24449854855323533,0.5639104785092237
385,013,5330,53,1638,2415,5277,5330,1.0,0.009943714821763603,0.9900562851782364,1277,0.3073170731707317,0.4530956848030019,0.2395872420262664
386,013,2080,78,489,569,2002,2080,1.0,0.0375,0.9625,1022,0.23509615384615384,0.27355769230769234,0.4913461538461538
387,013,1268,38,351,382,1230,1268,1.0,0.02996845425867508,0.9700315457413249,535,0.27681388012618297,0.30126182965299686,0.4219242902208202
388,013,3678,111,1037,1638,3567,3678,1.0,0.030179445350734094,0.9698205546492659,1003,0.28194671016856987,0.4453507340946166,0.2727025557368135
389,013,3993,99,1196,1333,3894,3993,1.0,0.024793388429752067,0.9752066115702479,1464,0.2995241672927623,0.3338342098672677,0.3666416228399699
390,013,4717,87,1169,2579,4630,4717,1.0,0.018443926224295103,0.9815560737757049,969,0.24782700869196522,0.546745813016748,0.20542717829128684
391,013,3278,78,802,1327,3200,3278,1.0,0.023794996949359364,0.9762050030506406,1149,0.24466137888956682,0.40482001220256253,0.3505186089078707
392,013,5135,132,1466,2320,5003,5135,1.0,0.025705939629990262,0.9742940603700098,1349,0.285491723466407,0.45180136319376824,0.2627069133398247
393,013,6910,399,1901,667,6511,6910,1.0,0.0577424023154848,0.9422575976845152,4342,0.2751085383502171,0.09652677279305355,0.6283646888567294
394,013,1417,14,411,661,1403,1417,1.0,0.009880028228652082,0.9901199717713479,345,0.2900494001411433,0.4664784756527876,0.24347212420606917
395,013,5971,262,2221,1867,5709,5971,1.0,0.04387874727851281,0.9561212527214872,1883,0.371964495059454,0.3126779433930665,0.31535756154747946
396,013,2261,46,600,1008,2215,2261,1.0,0.020344980097302078,0.9796550199026979,653,0.26536930561698363,0.4458204334365325,0.2888102609464839
397,013,1732,29,482,661,1703,1732,1.0,0.01674364896073903,0.983256351039261,589,0.27829099307159355,0.3816397228637413,0.34006928406466513
398,013,7078,144,2257,2804,6934,7078,1.0,0.020344730149759818,0.9796552698502402,2017,0.3188753885278327,0.3961571065272676,0.2849675049448997
399,013,7759,285,2522,1626,7474,7759,1.0,0.03673153756927439,0.9632684624307256,3611,0.32504188684108776,0.20956308802680756,0.4653950251321047
400,013,3226,102,1142,1029,3124,3226,1.0,0.03161810291382517,0.9683818970861748,1055,0.3539987600743955,0.3189708617482951,0.32703037817730934
401,013,3495,116,961,265,3379,3495,1.0,0.03319027181688126,0.9668097281831187,2269,0.274964234620887,0.07582260371959942,0.6492131616595136
402,013,3156,79,646,875,3077,3156,1.0,0.025031685678073512,0.9749683143219265,1635,0.2046894803548796,0.27724968314321924,0.5180608365019012
403,013,2675,83,782,821,2592,2675,1.0,0.03102803738317757,0.9689719626168224,1072,0.29233644859813085,0.3069158878504673,0.40074766355140184
404,013,7207,263,1350,2157,6944,7207,1.0,0.036492299153600666,0.9635077008463994,3700,0.18731788538920494,0.2992923546551963,0.5133897599555988
405,013,3963,148,1080,1559,3815,3963,1.0,0.037345445369669446,0.9626545546303306,1324,0.27252081756245267,0.3933888468332072,0.33409033560434015
406,013,7043,341,1845,867,6702,7043,1.0,0.048416867812011925,0.9515831321879881,4331,0.2619622320034076,0.12310095129916229,0.61493681669743
407,013,3105,175,1229,460,2930,3105,1.0,0.05636070853462158,0.9436392914653784,1416,0.3958132045088567,0.14814814814814814,0.45603864734299515
408,013,7996,55,2997,3595,7941,7996,1.0,0.006878439219609805,0.9931215607803902,1404,0.3748124062031016,0.44959979989994997,0.17558779389694848
409,013,5309,103,1038,3440,5206,5309,1.0,0.019401017140704465,0.9805989828592956,831,0.19551704652476926,0.6479563006215859,0.15652665285364475
410,013,3989,161,960,1565,3828,3989,1.0,0.04036099273000752,0.9596390072699925,1464,0.2406618200050138,0.3923289044873402,0.367009275507646
411,013,1395,44,480,440,1351,1395,1.0,0.031541218637992835,0.9684587813620071,475,0.34408602150537637,0.3154121863799283,0.34050179211469533
412,013,3690,20,1487,1688,3670,3690,1.0,0.005420054200542005,0.994579945799458,515,0.4029810298102981,0.4574525745257453,0.13956639566395665
413,013,4018,117,1775,1085,3901,4018,1.0,0.029118964659034345,0.9708810353409657,1158,0.4417620706819313,0.2700348432055749,0.2882030861124938
414,013,8752,337,1840,1368,8415,8752,1.0,0.0385054844606947,0.9614945155393053,5544,0.21023765996343693,0.1563071297989031,0.6334552102376599
415,013,2221,51,704,1065,2170,2221,1.0,0.02296262944619541,0.9770373705538046,452,0.3169743358847366,0.4795137325529041,0.2035119315623593
416,013,2905,109,1243,762,2796,2905,1.0,0.03752151462994836,0.9624784853700517,900,0.4278829604130809,0.2623063683304647,0.3098106712564544
417,013,5764,159,1917,1796,5605,5764,1.0,0.02758501040943789,0.9724149895905622,2051,0.3325815405968078,0.31158917418459403,0.3558292852185982
418,013,5389,108,1638,2341,5281,5389,1.0,0.020040823900538133,0.9799591760994618,1410,0.30395249582482836,0.43440341436259045,0.2616440898125812
419,013,6498,156,1941,2981,6342,6498,1.0,0.024007386888273315,0.9759926131117267,1576,0.2987072945521699,0.458756540473992,0.2425361649738381
420,013,3373,21,992,1818,3352,3373,1.0,0.006225911651348948,0.9937740883486511,563,0.2941002075303884,0.5389860658167803,0.1669137266528313
421,013,4440,81,917,2770,4359,4440,1.0,0.018243243243243244,0.9817567567567568,753,0.20653153153153153,0.6238738738738738,0.16959459459459458
422,013,3949,171,1200,1030,3778,3949,1.0,0.04330210179792352,0.9566978982020765,1719,0.30387439858191945,0.2608255254494809,0.43530007596859965
423,013,9857,322,2206,5300,9535,9857,1.0,0.032667140103479764,0.9673328598965203,2351,0.22380034493253526,0.5376889520137973,0.23851070305366745
424,013,7237,144,2263,3432,7093,7237,1.0,0.019897747685505042,0.980102252314495,1542,0.3126986320298466,0.4742296531712035,0.21307171479894985
425,013,6968,401,1721,476,6567,6968,1.0,0.057548794489092996,0.942451205510907,4771,0.24698622273249138,0.06831228473019518,0.6847014925373134
426,013,7596,279,2410,2226,7317,7596,1.0,0.03672985781990521,0.9632701421800948,2960,0.3172722485518694,0.2930489731437599,0.3896787783043707
427,013,2458,76,916,933,2382,2458,1.0,0.030919446704637917,0.9690805532953621,609,0.3726606997558991,0.37957689178193654,0.24776240846216435
428,013,2385,107,838,797,2278,2385,1.0,0.044863731656184486,0.9551362683438155,750,0.35136268343815513,0.33417190775681344,0.31446540880503143
429,013,5483,204,1350,451,5279,5483,1.0,0.037205909173809955,0.96279409082619,3682,0.24621557541491884,0.08225424037935437,0.6715301842057267
430,013,6712,216,2426,1884,6496,6712,1.0,0.03218116805721097,0.9678188319427891,2402,0.36144219308700837,0.2806912991656734,0.35786650774731826
431,013,2592,134,984,558,2458,2592,1.0,0.05169753086419753,0.9483024691358025,1050,0.37962962962962965,0.2152777777777778,0.4050925925925926
432,013,7074,91,2406,3576,6983,7074,1.0,0.012864009047215155,0.9871359909527848,1092,0.34011874469889736,0.5055131467345207,0.15436810856658184
433,013,8731,377,3733,1616,8354,8731,1.0,0.04317947543236743,0.9568205245676326,3382,0.42755698087275223,0.18508761882945826,0.3873554002977895
434,013,2019,43,823,813,1976,2019,1.0,0.02129767211490837,0.9787023278850916,383,0.40762753838533927,0.4026745913818722,0.1896978702327885
435,013,5880,190,2478,1842,5690,5880,1.0,0.03231292517006803,0.967687074829932,1560,0.42142857142857143,0.31326530612244896,0.2653061224489796
436,013,2830,27,1145,1484,2803,2830,1.0,0.009540636042402828,0.9904593639575971,201,0.4045936395759717,0.5243816254416961,0.07102473498233215
437,013,3007,69,988,1528,2938,3007,1.0,0.022946458264050548,0.9770535417359495,491,0.32856667775191223,0.5081476554705687,0.16328566677751913
438,013,2118,52,836,423,2066,2118,1.0,0.024551463644948063,0.9754485363550519,859,0.3947119924457035,0.19971671388101983,0.40557129367327666
439,013,7041,161,1903,2579,6880,7041,1.0,0.022866070160488566,0.9771339298395114,2559,0.2702741087913649,0.36628319840931683,0.3634426927993183
440,013,3411,178,1145,615,3233,3411,1.0,0.05218411023160364,0.9478158897683964,1651,0.33567868660216943,0.1802990325417766,0.4840222808560539
441,013,2952,39,1167,1221,2913,2952,1.0,0.013211382113821139,0.9867886178861789,564,0.3953252032520325,0.4136178861788618,0.1910569105691057
442,013,5800,182,1783,2587,5618,5800,1.0,0.031379310344827584,0.9686206896551725,1430,0.3074137931034483,0.4460344827586207,0.24655172413793103
443,013,5000,256,1493,1092,4744,5000,1.0,0.0512,0.9488,2415,0.2986,0.2184,0.483
444,013,4756,242,1360,923,4514,4756,1.0,0.05088309503784693,0.9491169049621531,2473,0.28595458368376786,0.19407064760302775,0.5199747687132044
445,013,4964,289,1089,264,4675,4964,1.0,0.05821917808219178,0.9417808219178082,3611,0.21937953263497179,0.0531829170024174,0.7274375503626108
446,013,4879,180,1201,1313,4699,4879,1.0,0.03689280590284894,0.9631071940971511,2365,0.2461569993851199,0.2691125230580037,0.4847304775568764
447,013,10015,190,2401,5314,9825,10015,1.0,0.018971542685971045,0.981028457314029,2300,0.2397403894158762,0.5306040938592111,0.22965551672491263
448,013,5637,360,1686,655,5277,5637,1.0,0.06386375731772219,0.9361362426822778,3296,0.2990952634379989,0.11619655845307787,0.5847081781089232
449,013,4025,47,1475,1968,3978,4025,1.0,0.011677018633540372,0.9883229813664596,582,0.36645962732919257,0.488944099378882,0.14459627329192545
450,013,2257,78,482,625,2179,2257,1.0,0.034559149313247675,0.9654408506867523,1150,0.21355782011519717,0.2769162605228179,0.5095259193619849
451,013,2983,42,1059,1292,2941,2983,1.0,0.014079785450888367,0.9859202145491116,632,0.35501173315454243,0.43312101910828027,0.21186724773717733
452,013,3738,109,1131,1505,3629,3738,1.0,0.029159978598180845,0.9708400214018191,1102,0.3025682182985554,0.40262172284644193,0.29481005885500267
453,013,3102,214,825,531,2888,3102,1.0,0.06898774983881367,0.9310122501611864,1746,0.26595744680851063,0.17117988394584138,0.562862669245648
454,013,5165,341,1306,259,4824,5165,1.0,0.06602129719264278,0.9339787028073572,3600,0.25285575992255566,0.05014520813165537,0.6969990319457889
455,013,10049,755,2417,1195,9294,10049,1.0,0.07513185391581252,0.9248681460841874,6437,0.24052144491989252,0.11891730520449796,0.6405612498756095
456,013,3180,95,1325,730,3085,3180,1.0,0.029874213836477988,0.970125786163522,1125,0.4166666666666667,0.22955974842767296,0.35377358490566035
457,013,7228,248,2019,1574,6980,7228,1.0,0.03431101272827892,0.965688987271721,3635,0.27933038184836745,0.21776425013835085,0.5029053680132817
458,013,5336,262,821,757,5074,5336,1.0,0.049100449775112444,0.9508995502248876,3758,0.15386056971514242,0.1418665667166417,0.704272863568216
459,013,6139,440,2217,665,5699,6139,1.0,0.07167291089754031,0.9283270891024596,3257,0.36113373513601565,0.10832383124287344,0.530542433621111
460,013,3023,24,906,1296,2999,3023,1.0,0.007939133311280185,0.9920608666887198,821,0.299702282500827,0.42871319880913,0.271584518690043
461,013,5341,186,1947,1597,5155,5341,1.0,0.034824939149971916,0.9651750608500281,1797,0.36453847594083505,0.2990076764650814,0.33645384759408353
462,013,3377,126,1997,573,3251,3377,1.0,0.03731122297897542,0.9626887770210246,807,0.5913532721350311,0.16967722830915014,0.23896949955581878
463,013,4713,113,1206,1840,4600,4713,1.0,0.023976235943136005,0.976023764056864,1667,0.2558879694462126,0.3904095056227456,0.3537025249310418
464,013,3680,106,951,1847,3574,3680,1.0,0.028804347826086957,0.971195652173913,882,0.2584239130434783,0.5019021739130435,0.23967391304347826
465,013,8885,472,2480,757,8413,8885,1.0,0.05312324141812043,0.9468767585818796,5648,0.2791221159257175,0.08519977490151942,0.6356781091727631
466,013,2249,102,698,543,2147,2249,1.0,0.04535349044019564,0.9546465095598043,1008,0.31036016007114275,0.2414406402845709,0.44819919964428634
467,013,10033,353,2235,3156,9680,10033,1.0,0.03518389315259643,0.9648161068474036,4642,0.22276487590949864,0.3145619455795874,0.462673178510914
468,013,8522,733,2291,1064,7789,8522,1.0,0.08601267308143629,0.9139873269185638,5167,0.26883360713447546,0.12485332081670969,0.6063130720488148
469,013,7895,187,2610,3259,7708,7895,1.0,0.023685877137428753,0.9763141228625712,2026,0.3305889803673211,0.4127929069031032,0.2566181127295757
470,013,4645,172,2341,918,4473,4645,1.0,0.037029063509149626,0.9629709364908504,1386,0.5039827771797631,0.19763186221743811,0.2983853606027987
471,013,1638,26,674,719,1612,1638,1.0,0.015873015873015872,0.9841269841269841,245,0.41147741147741146,0.43894993894993894,0.14957264957264957
472,013,4196,309,1147,907,3887,4196,1.0,0.0736415633937083,0.9263584366062917,2142,0.27335557673975214,0.2161582459485224,0.5104861773117254
473,013,7886,179,1923,3342,7707,7886,1.0,0.022698452954603095,0.977301547045397,2621,0.2438498605123003,0.423788993152422,0.3323611463352777
474,013,6856,187,1589,3531,6669,6856,1.0,0.027275379229871645,0.9727246207701283,1736,0.23176779463243874,0.5150233372228705,0.2532088681446908
475,013,6349,115,1924,3194,6234,6349,1.0,0.01811308867538195,0.981886911324618,1231,0.30303984879508583,0.5030713498188691,0.19388880138604506
476,013,5095,128,1930,1721,4967,5095,1.0,0.025122669283611385,0.9748773307163886,1444,0.3788027477919529,0.33778213935230617,0.28341511285574095
477,013,9104,401,3219,2221,8703,9104,1.0,0.04404657293497364,0.9559534270650264,3664,0.3535808435852373,0.24395869947275922,0.4024604569420035
478,013,5446,109,2460,2170,5337,5446,1.0,0.02001468968049945,0.9799853103195005,816,0.45170767535806094,0.39845758354755784,0.1498347410943812
479,013,778,677,259,98,101,778,1.0,0.8701799485861182,0.12982005141388175,421,0.3329048843187661,0.12596401028277635,0.5411311053984575
480,013,3935,54,1121,1561,3881,3935,1.0,0.01372299872935197,0.986277001270648,1253,0.2848792884371029,0.3966963151207116,0.3184243964421855
481,013,5293,109,1531,2341,5184,5293,1.0,0.02059323634989609,0.9794067636501039,1421,0.2892499527678065,0.4422822595881353,0.2684677876440582
482,013,4975,95,1906,1544,4880,4975,1.0,0.019095477386934675,0.9809045226130654,1525,0.3831155778894472,0.31035175879396987,0.3065326633165829
483,013,2280,55,853,874,2225,2280,1.0,0.02412280701754386,0.9758771929824561,553,0.37412280701754386,0.38333333333333336,0.2425438596491228
484,013,3830,111,862,1470,3719,3830,1.0,0.02898172323759791,0.971018276762402,1498,0.22506527415143604,0.3838120104438642,0.39112271540469973
485,013,6604,118,1959,3115,6486,6604,1.0,0.017867958812840704,0.9821320411871592,1530,0.29663840096910965,0.4716838279830406,0.23167777104784978
486,013,8903,121,3343,3582,8782,8903,1.0,0.01359092440750309,0.9864090755924969,1978,0.37549140739076714,0.4023362911378187,0.22217230147141412
487,013,8641,359,3261,2118,8282,8641,1.0,0.04154611734752922,0.9584538826524708,3262,0.37738687651892144,0.2451105196157852,0.3775026038652934
488,013,5418,239,1924,882,5179,5418,1.0,0.04411221853082318,0.9558877814691769,2612,0.35511258767072723,0.16279069767441862,0.4820967146548542
489,013,2919,251,842,179,2668,2919,1.0,0.08598835217540253,0.9140116478245974,1898,0.28845495032545393,0.06132237067488866,0.6502226789996575
490,013,8284,377,1803,360,7907,8284,1.0,0.04550941574118783,0.9544905842588122,6121,0.21764847899565426,0.04345726702076291,0.7388942539835828
491,013,4860,64,1250,2126,4796,4860,1.0,0.01316872427983539,0.9868312757201646,1484,0.257201646090535,0.4374485596707819,0.30534979423868314
492,013,4147,140,1270,1351,4007,4147,1.0,0.03375934410417169,0.9662406558958283,1526,0.30624547865927176,0.3257776706052568,0.36797685073547143
493,013,3475,78,992,1585,3397,3475,1.0,0.022446043165467625,0.9775539568345324,898,0.2854676258992806,0.45611510791366905,0.25841726618705035
494,013,6282,191,2207,1771,6091,6282,1.0,0.03040432983126393,0.969595670168736,2304,0.35132123527539,0.2819165870741802,0.3667621776504298
495,013,2349,108,812,604,2241,2349,1.0,0.04597701149425287,0.9540229885057471,933,0.345679012345679,0.2571306939123031,0.39719029374201786
496,013,6407,330,2126,1493,6077,6407,1.0,0.051506165131887,0.948493834868113,2788,0.331824566879975,0.23302637739971907,0.43514905572030593
497,013,5912,354,212,307,5558,5912,1.0,0.05987821380243572,0.9401217861975643,5393,0.03585926928281461,0.05192828146143437,0.9122124492557511
498,013,4174,114,1404,1599,4060,4174,1.0,0.02731193100143747,0.9726880689985625,1171,0.33636799233349307,0.3830857690464782,0.28054623862002875
499,013,6373,200,2126,2195,6173,6373,1.0,0.03138239447669857,0.9686176055233015,2052,0.3335948532873058,0.3444217793817668,0.32198336733092736
500,013,5299,239,1233,989,5060,5299,1.0,0.04510284959426307,0.954897150405737,3077,0.2326854123419513,0.18663898848839403,0.5806755991696546
501,013,2081,69,1150,747,2012,2081,1.0,0.03315713599231139,0.9668428640076886,184,0.5526189332051898,0.3589620374819798,0.08841902931283037
502,013,2925,98,1289,656,2827,2925,1.0,0.033504273504273506,0.9664957264957265,980,0.4406837606837607,0.2242735042735043,0.335042735042735
503,013,3806,91,1043,2123,3715,3806,1.0,0.023909616395165527,0.9760903836048345,640,0.2740409879138203,0.5578034682080925,0.16815554387808723
504,013,1655,18,724,685,1637,1655,1.0,0.010876132930513595,0.9891238670694864,246,0.43746223564954684,0.41389728096676737,0.1486404833836858
505,013,4561,58,1446,2335,4503,4561,1.0,0.012716509537382154,0.9872834904626179,780,0.31703573777680333,0.5119491339618505,0.17101512826134618
506,013,8436,282,1877,1983,8154,8436,1.0,0.033428165007112376,0.9665718349928877,4576,0.22249881460407775,0.23506401137980085,0.5424371740161213
507,013,232,2,61,164,230,232,1.0,0.008620689655172414,0.9913793103448276,7,0.2629310344827586,0.7068965517241379,0.03017241379310345
508,013,2716,84,730,455,2632,2716,1.0,0.030927835051546393,0.9690721649484536,1531,0.26877761413843887,0.16752577319587628,0.5636966126656848
509,013,7571,370,1678,535,7201,7571,1.0,0.04887069079381852,0.9511293092061814,5358,0.22163518689737155,0.07066437722889975,0.7077004358737287
510,013,6072,45,1974,2589,6027,6072,1.0,0.007411067193675889,0.9925889328063241,1509,0.325098814229249,0.42638339920948615,0.24851778656126483
511,013,5665,105,1620,2310,5560,5665,1.0,0.018534863195057368,0.9814651368049426,1735,0.28596646072374227,0.4077669902912621,0.3062665489849956
512,013,5002,39,1298,2702,4963,5002,1.0,0.007796881247501,0.992203118752499,1002,0.25949620151939223,0.5401839264294283,0.20031987205117952
513,013,2636,14,929,1347,2622,2636,1.0,0.005311077389984826,0.9946889226100152,360,0.3524279210925645,0.5110015174506829,0.13657056145675264
514,013,3179,73,845,1602,3106,3179,1.0,0.022963195973576597,0.9770368040264235,732,0.2658068575023592,0.5039320541050645,0.23026108839257628
515,013,4062,163,1526,365,3899,4062,1.0,0.040128015755785326,0.9598719842442147,2171,0.37567700640078777,0.08985721319547021,0.534465780403742
516,013,7229,189,2068,2666,7040,7229,1.0,0.026144694978558584,0.9738553050214415,2495,0.28606999585004844,0.3687923640890856,0.34513764006086595
517,013,4696,121,1547,1560,4575,4696,1.0,0.025766609880749573,0.9742333901192505,1589,0.32942930153321975,0.3321976149914821,0.33837308347529815
518,013,1723,7,493,769,1716,1723,1.0,0.004062681369704005,0.995937318630296,461,0.2861288450377249,0.4463145676146257,0.2675565873476494
519,013,6281,295,1369,1247,5986,6281,1.0,0.04696704346441649,0.9530329565355835,3665,0.21795892373825823,0.19853526508517752,0.5835058111765642
520,013,5387,152,1601,2444,5235,5387,1.0,0.028216075737887508,0.9717839242621125,1342,0.29719695563393356,0.45368479673287543,0.24911824763319101
521,013,3781,1917,1629,222,1864,3781,1.0,0.5070087278497752,0.4929912721502248,1930,0.43083840253901085,0.058714625760380855,0.5104469717006083
522,013,7029,420,1540,790,6609,7029,1.0,0.0597524541186513,0.9402475458813487,4699,0.2190923317683881,0.11239152084222506,0.6685161473893868
523,013,3428,137,1208,521,3291,3428,1.0,0.03996499416569428,0.9600350058343057,1699,0.352392065344224,0.15198366394399065,0.4956242707117853
524,013,4006,157,2041,1022,3849,4006,1.0,0.03919121318022965,0.9608087868197703,943,0.5094857713429856,0.255117324013979,0.23539690464303545
525,013,2018,28,242,511,1990,2018,1.0,0.013875123885034688,0.9861248761149654,1265,0.1199207135777998,0.25322101090188304,0.6268582755203171
526,013,3142,46,889,1770,3096,3142,1.0,0.01464035646085296,0.9853596435391471,483,0.2829408020369192,0.5633354551241248,0.15372374283895607
527,013,8171,380,1904,1248,7791,8171,1.0,0.04650593562599437,0.9534940643740056,5019,0.233019214294456,0.1527352833190552,0.6142455023864888
528,013,5824,236,1622,2139,5588,5824,1.0,0.040521978021978024,0.959478021978022,2063,0.27850274725274726,0.3672733516483517,0.3542239010989011
529,013,295,17,45,69,278,295,1.0,0.0576271186440678,0.9423728813559322,181,0.15254237288135594,0.23389830508474577,0.6135593220338983
530,013,1892,92,502,424,1800,1892,1.0,0.048625792811839326,0.9513742071881607,966,0.2653276955602537,0.22410147991543342,0.5105708245243129
531,013,4944,222,851,174,4722,4944,1.0,0.044902912621359224,0.9550970873786407,3919,0.17212783171521034,0.03519417475728155,0.7926779935275081
532,013,477,19,64,87,458,477,1.0,0.039832285115303984,0.960167714884696,326,0.13417190775681342,0.18238993710691823,0.6834381551362684
533,013,3911,84,1162,1926,3827,3911,1.0,0.021477882894400408,0.9785221171055996,823,0.29711071337253897,0.4924571720787522,0.21043211454870878
534,013,4665,239,1315,860,4426,4665,1.0,0.05123258306538049,0.9487674169346195,2490,0.28188638799571275,0.18435155412647375,0.5337620578778135
535,013,5400,199,900,1468,5201,5400,1.0,0.03685185185185185,0.9631481481481482,3032,0.16666666666666666,0.27185185185185184,0.5614814814814815
536,013,5645,220,1120,204,5425,5645,1.0,0.03897254207263064,0.9610274579273693,4321,0.19840566873339238,0.036138175376439326,0.7654561558901682
537,013,6851,393,1688,1063,6458,6851,1.0,0.05736388848343307,0.9426361115165669,4100,0.24638738870237922,0.15515983068165232,0.5984527806159685
538,013,6652,272,2430,429,6380,6652,1.0,0.040889957907396274,0.9591100420926038,3793,0.36530366806975345,0.06449188214070956,0.570204449789537
539,013,5966,172,1790,3231,5794,5966,1.0,0.028830036875628563,0.9711699631243714,945,0.3000335232986926,0.5415688903788133,0.15839758632249412
540,013,61,61,31,0,0,61,1.0,1.0,0.0,30,0.5081967213114754,0.0,0.4918032786885246
541,013,6072,349,2460,713,5723,6072,1.0,0.05747694334650856,0.9425230566534915,2899,0.4051383399209486,0.11742424242424243,0.47743741765480896
542,013,7471,145,2234,3402,7326,7471,1.0,0.019408379065720786,0.9805916209342792,1835,0.29902288850220854,0.4553607281488422,0.24561638334894928
543,013,7475,201,2358,3272,7274,7475,1.0,0.02688963210702341,0.9731103678929766,1845,0.3154515050167224,0.4377257525083612,0.2468227424749164
544,013,3156,24,932,1296,3132,3156,1.0,0.0076045627376425855,0.9923954372623575,928,0.2953105196451204,0.41064638783269963,0.29404309252217997
545,013,2656,39,998,1292,2617,2656,1.0,0.014683734939759037,0.985316265060241,366,0.3757530120481928,0.4864457831325301,0.1378012048192771
546,013,3503,73,1377,1588,3430,3503,1.0,0.02083928061661433,0.9791607193833857,538,0.3930916357407936,0.45332572081073363,0.15358264344847275
547,013,1656,85,502,148,1571,1656,1.0,0.051328502415458936,0.9486714975845411,1006,0.3031400966183575,0.0893719806763285,0.607487922705314
548,013,5086,476,1347,995,4610,5086,1.0,0.09359024773889107,0.906409752261109,2744,0.26484467164766023,0.19563507668108535,0.5395202516712544
549,013,2761,106,699,206,2655,2761,1.0,0.03839188699746469,0.9616081130025353,1856,0.25316914161535675,0.0746106483158276,0.6722202100688156
550,013,7111,327,2019,620,6784,7111,1.0,0.045985093517086205,0.9540149064829138,4472,0.28392631134861485,0.08718886232597384,0.6288848263254113
551,013,4354,188,1764,791,4166,4354,1.0,0.04317868626550299,0.956821313734497,1799,0.40514469453376206,0.18167202572347266,0.41318327974276525
552,013,3184,207,995,307,2977,3184,1.0,0.06501256281407035,0.9349874371859297,1882,0.3125,0.09641959798994974,0.5910804020100503
553,013,7885,328,1675,424,7557,7885,1.0,0.04159797083069119,0.9584020291693088,5786,0.212428662016487,0.05377298668357641,0.7337983512999365
554,013,7742,295,1939,519,7447,7742,1.0,0.03810384913459054,0.9618961508654095,5284,0.2504520795660036,0.06703694135882202,0.6825109790751743
555,013,4387,3299,1621,486,1088,4387,1.0,0.7519945292910873,0.24800547070891268,2280,0.3695007978117164,0.11078185548210623,0.5197173467061773
556,013,5954,290,2219,497,5664,5954,1.0,0.04870675176352032,0.9512932482364796,3238,0.37269062814914344,0.08347329526368828,0.5438360765871683
557,013,6757,263,1477,1881,6494,6757,1.0,0.03892259878644369,0.9610774012135563,3399,0.21858813082729023,0.27837797839277784,0.5030338907799319
558,013,2937,29,1240,1304,2908,2937,1.0,0.009874021109976166,0.9901259788900239,393,0.42219952332311883,0.44399046646237655,0.1338100102145046
559,013,5530,94,2086,2309,5436,5530,1.0,0.016998191681735986,0.983001808318264,1135,0.37721518987341773,0.41754068716094034,0.20524412296564196
560,013,6816,105,2005,2441,6711,6816,1.0,0.015404929577464789,0.9845950704225352,2370,0.29416079812206575,0.3581279342723005,0.3477112676056338
561,013,2652,89,954,724,2563,2652,1.0,0.033559577677224735,0.9664404223227753,974,0.3597285067873303,0.2730015082956259,0.36726998491704377
562,013,17333,450,2055,648,16883,17333,1.0,0.025962037731494837,0.9740379622685051,14630,0.11855997230715976,0.03738533433335257,0.8440546933594877
563,013,5962,236,1769,1075,5726,5962,1.0,0.039584032203958404,0.9604159677960415,3118,0.29671251257967124,0.18030862126803085,0.5229788661522979
564,013,3901,156,1286,1137,3745,3901,1.0,0.03998974621891822,0.9600102537810817,1478,0.32965906177903104,0.2914637272494232,0.37887721097154575
565,013,8877,941,2417,1016,7936,8877,1.0,0.10600428072547032,0.8939957192745297,5444,0.2722766700461868,0.11445308099583193,0.6132702489579813
566,013,3644,81,1033,1854,3563,3644,1.0,0.022228320526893525,0.9777716794731065,757,0.2834796926454446,0.508781558726674,0.20773874862788144
567,013,2987,119,702,192,2868,2987,1.0,0.0398393036491463,0.9601606963508537,2093,0.23501841312353533,0.06427854034147974,0.7007030465349849
568,013,8768,207,3038,3420,8561,8768,1.0,0.023608576642335767,0.9763914233576643,2310,0.3464872262773723,0.39005474452554745,0.2634580291970803
569,013,4501,92,1500,1631,4409,4501,1.0,0.02043990224394579,0.9795600977560542,1370,0.33325927571650743,0.36236391912908245,0.3043768051544101
570,013,3473,124,1125,917,3349,3473,1.0,0.03570400230348402,0.964295997696516,1431,0.32392744025338327,0.2640368557443133,0.4120357040023035
571,013,1614,14,444,797,1600,1614,1.0,0.008674101610904586,0.9913258983890955,373,0.275092936802974,0.49380421313506817,0.23110285006195788
572,013,4654,180,1553,1152,4474,4654,1.0,0.03867640739149119,0.9613235926085089,1949,0.33369144821658786,0.2475290073055436,0.4187795444778685
573,013,6830,213,1986,788,6617,6830,1.0,0.031185944363103953,0.968814055636896,4056,0.29077598828696927,0.11537335285505125,0.5938506588579795
574,013,4740,114,1253,1838,4626,4740,1.0,0.024050632911392405,0.9759493670886076,1649,0.26434599156118144,0.38776371308016877,0.3478902953586498
575,013,5694,187,1622,1937,5507,5694,1.0,0.032841587636108185,0.9671584123638918,2135,0.2848612574639972,0.3401826484018265,0.3749560941341763
576,013,2099,86,522,795,2013,2099,1.0,0.04097189137684612,0.9590281086231539,782,0.2486898523106241,0.37875178656503095,0.37255836112434493
577,013,4539,127,1976,1297,4412,4539,1.0,0.02797973121833003,0.9720202687816699,1266,0.4353381802159066,0.2857457589777484,0.278916060806345
578,013,3203,37,1251,1420,3166,3203,1.0,0.011551670309085233,0.9884483296909148,532,0.39057133936934124,0.44333437402435216,0.1660942866063066
579,013,4095,86,1914,1139,4009,4095,1.0,0.021001221001221003,0.978998778998779,1042,0.4673992673992674,0.27814407814407816,0.25445665445665444
580,013,2186,26,997,1049,2160,2186,1.0,0.011893870082342177,0.9881061299176578,140,0.45608417200365964,0.479871912168344,0.06404391582799634
581,013,8068,348,2036,1495,7720,8068,1.0,0.04313336638572137,0.9568666336142786,4537,0.2523549826474963,0.18529995042141795,0.5623450669310858
582,013,6129,252,1577,841,5877,6129,1.0,0.041116005873715125,0.9588839941262849,3711,0.25730135421765377,0.13721651166585086,0.6054821341164953
583,013,7523,200,2249,3172,7323,7523,1.0,0.02658513890735079,0.9734148610926492,2102,0.29894988701315967,0.42164030307058353,0.2794098099162568
584,013,2102,46,529,882,2056,2102,1.0,0.021883920076117985,0.978116079923882,691,0.25166508087535683,0.4196003805899144,0.32873453853472884
585,013,4947,178,1295,1583,4769,4947,1.0,0.03598140287042652,0.9640185971295735,2069,0.2617748130179907,0.31999191429148977,0.4182332726905195
586,013,1038,7,429,566,1031,1038,1.0,0.00674373795761079,0.9932562620423893,43,0.41329479768786126,0.5452793834296724,0.041425818882466284
587,013,10722,788,2381,1272,9934,10722,1.0,0.07349375116582726,0.9265062488341728,7069,0.22206677858608467,0.11863458310016788,0.6592986383137475
588,013,1631,8,463,698,1623,1631,1.0,0.004904966278356836,0.9950950337216432,470,0.2838749233599019,0.42795830778663396,0.28816676885346415
589,013,7308,515,2863,1590,6793,7308,1.0,0.07047071702244116,0.9295292829775589,2855,0.39176245210727967,0.2175697865353038,0.39066776135741654
590,013,1465,1382,392,37,83,1465,1.0,0.9433447098976109,0.05665529010238908,1036,0.2675767918088737,0.025255972696245733,0.7071672354948806
591,013,2722,124,935,793,2598,2722,1.0,0.045554739162380606,0.9544452608376194,994,0.3434974283614989,0.2913299044819985,0.3651726671565026
592,013,5458,42,1678,2473,5416,5458,1.0,0.007695126419934042,0.9923048735800659,1307,0.30743862220593626,0.4530963722975449,0.23946500549651886
593,013,7663,177,2033,3966,7486,7663,1.0,0.02309800339292705,0.976901996607073,1664,0.2653007960328853,0.5175518726347383,0.21714733133237635
594,013,1748,9,515,760,1739,1748,1.0,0.005148741418764302,0.9948512585812357,473,0.29462242562929064,0.43478260869565216,0.2705949656750572
595,013,4583,146,2241,1591,4437,4583,1.0,0.031856862317259434,0.9681431376827405,751,0.4889810168012219,0.3471525201832861,0.16386646301549204
596,013,2020,54,878,678,1966,2020,1.0,0.026732673267326732,0.9732673267326732,464,0.43465346534653465,0.33564356435643566,0.2297029702970297
597,013,7290,126,2696,2588,7164,7290,1.0,0.01728395061728395,0.9827160493827161,2006,0.3698216735253772,0.3550068587105624,0.2751714677640604
598,013,4386,142,1689,1611,4244,4386,1.0,0.03237574099407205,0.967624259005928,1086,0.3850889192886457,0.36730506155950754,0.2476060191518468
599,013,5990,180,1579,2350,5810,5990,1.0,0.03005008347245409,0.9699499165275459,2061,0.2636060100166945,0.39232053422370616,0.34407345575959936
600,013,5639,90,1833,2857,5549,5639,1.0,0.015960276644795178,0.9840397233552048,949,0.3250576343323284,0.5066501152686647,0.16829225039900692
601,013,5768,279,1894,589,5489,5768,1.0,0.04837031900138696,0.951629680998613,3285,0.32836338418862693,0.10211511789181692,0.5695214979195562
602,013,1901,22,712,871,1879,1901,1.0,0.011572856391372961,0.988427143608627,318,0.3745397159389795,0.4581799053129932,0.16728037874802734
603,013,4483,224,1564,449,4259,4483,1.0,0.0499665402632166,0.9500334597367834,2470,0.3488735221949587,0.10015614543832255,0.5509703323667187
604,013,9006,392,3632,1339,8614,9006,1.0,0.04352653786364646,0.9564734621363535,4035,0.40328669775705084,0.14867865867199645,0.4480346435709527
605,013,591,7,253,253,584,591,1.0,0.011844331641285956,0.988155668358714,85,0.428087986463621,0.428087986463621,0.14382402707275804
606,013,4142,330,719,1235,3812,4142,1.0,0.07967165620473202,0.920328343795268,2188,0.1735876388218252,0.2981651376146789,0.5282472235634958
607,013,3075,29,874,1328,3046,3075,1.0,0.00943089430894309,0.9905691056910569,873,0.2842276422764228,0.431869918699187,0.2839024390243902
608,013,2579,149,799,211,2430,2579,1.0,0.05777433113609926,0.9422256688639007,1569,0.3098100038774719,0.08181465684373788,0.6083753392787903
609,013,2850,99,759,1114,2751,2850,1.0,0.034736842105263156,0.9652631578947368,977,0.26631578947368423,0.39087719298245616,0.34280701754385967
610,013,3579,125,973,1409,3454,3579,1.0,0.034925956971221014,0.965074043028779,1197,0.27186364906398436,0.39368538697960326,0.3344509639564124
611,013,3403,109,1018,1462,3294,3403,1.0,0.032030561269468114,0.9679694387305319,923,0.29914781075521596,0.42962092271525126,0.2712312665295328
612,013,2457,76,856,870,2381,2457,1.0,0.03093203093203093,0.9690679690679691,731,0.3483923483923484,0.3540903540903541,0.2975172975172975
613,013,3563,79,1156,1685,3484,3563,1.0,0.02217232669099074,0.9778276733090092,722,0.32444569183272526,0.47291608195341006,0.2026382262138647
614,013,4060,94,1339,1275,3966,4060,1.0,0.02315270935960591,0.9768472906403941,1446,0.32980295566502466,0.31403940886699505,0.3561576354679803
615,013,5551,341,2190,866,5210,5551,1.0,0.061430372905782744,0.9385696270942172,2495,0.39452350927760765,0.15600792649972978,0.44946856422266257
616,013,2266,21,690,1244,2245,2266,1.0,0.009267431597528684,0.9907325684024714,332,0.30450132391879964,0.5489849955869374,0.14651368049426303
617,013,97,83,13,5,14,97,1.0,0.8556701030927835,0.14432989690721648,79,0.13402061855670103,0.05154639175257732,0.8144329896907216
618,013,7444,117,2469,4154,7327,7444,1.0,0.015717356260075227,0.9842826437399248,821,0.33167651800107467,0.5580333154218162,0.11029016657710908
619,013,5359,174,1601,476,5185,5359,1.0,0.03246874416868819,0.9675312558313118,3282,0.2987497667475275,0.0888225415189401,0.6124276917335324
620,013,2915,85,783,1646,2830,2915,1.0,0.029159519725557463,0.9708404802744426,486,0.2686106346483705,0.5646655231560892,0.16672384219554032
621,013,5171,136,2127,1659,5035,5171,1.0,0.02630052214271901,0.973699477857281,1385,0.41133243086443627,0.3208276929027267,0.26783987623283695
622,013,3163,242,825,407,2921,3163,1.0,0.07650964274423017,0.9234903572557699,1931,0.2608283275371483,0.12867530825165982,0.6104963642111919
623,013,3099,43,1366,1213,3056,3099,1.0,0.013875443691513391,0.9861245563084866,520,0.4407873507583091,0.3914165859954824,0.16779606324620847
624,013,3685,133,901,1673,3552,3685,1.0,0.03609226594301221,0.9639077340569878,1111,0.2445047489823609,0.45400271370420625,0.30149253731343284
625,013,4507,114,1507,2248,4393,4507,1.0,0.025293987131129354,0.9747060128688706,752,0.33436875970712227,0.49877967605946305,0.16685156423341468
626,013,4767,297,777,217,4470,4767,1.0,0.062303335431088736,0.9376966645689113,3773,0.16299559471365638,0.04552129221732746,0.7914831130690162
627,013,9726,317,2489,3389,9409,9726,1.0,0.03259304955788608,0.9674069504421139,3848,0.2559119884844746,0.34844746041538144,0.39564055110014396
628,013,7035,364,1731,751,6671,7035,1.0,0.051741293532338306,0.9482587064676616,4553,0.24605543710021321,0.10675195451314855,0.6471926083866383
629,013,4271,151,1174,1010,4120,4271,1.0,0.0353547178646687,0.9646452821353313,2087,0.27487707796768907,0.23647857644579723,0.4886443455865137
630,013,5750,249,1278,260,5501,5750,1.0,0.043304347826086956,0.9566956521739131,4212,0.2222608695652174,0.04521739130434783,0.7325217391304348
631,013,1991,21,1009,787,1970,1991,1.0,0.01054746358613762,0.9894525364138623,195,0.5067805123053741,0.3952787543947765,0.09794073329984933
632,013,6588,491,2695,845,6097,6588,1.0,0.07452944748026716,0.9254705525197329,3048,0.40907710989678203,0.12826350941105039,0.46265938069216755
633,013,7988,380,1413,355,7608,7988,1.0,0.04757135703555333,0.9524286429644466,6220,0.1768903355032549,0.04444166249374061,0.7786680020030045
634,013,2697,80,752,997,2617,2697,1.0,0.029662588060808306,0.9703374119391917,948,0.27882832777159805,0.3696700037078235,0.3515016685205784
635,013,7159,290,3003,1967,6869,7159,1.0,0.04050845090096382,0.9594915490990362,2189,0.41947199329515295,0.274759044559296,0.30576896214555105
636,013,4048,94,1259,2078,3954,4048,1.0,0.023221343873517788,0.9767786561264822,711,0.31101778656126483,0.5133399209486166,0.1756422924901186
637,013,4760,161,1214,1306,4599,4760,1.0,0.033823529411764704,0.9661764705882353,2240,0.25504201680672267,0.2743697478991597,0.47058823529411764
638,013,4679,167,1130,590,4512,4679,1.0,0.03569138704851464,0.9643086129514854,2959,0.2415045949989314,0.12609531951271638,0.6324000854883522
639,013,2679,139,765,590,2540,2679,1.0,0.051885031728256814,0.9481149682717432,1324,0.2855543113101904,0.2202314296379246,0.49421425905188504
640,013,3663,93,1420,1087,3570,3663,1.0,0.025389025389025387,0.9746109746109746,1156,0.3876603876603877,0.29675129675129674,0.31558831558831557
641,013,3268,164,885,765,3104,3268,1.0,0.05018359853121175,0.9498164014687882,1618,0.2708078335373317,0.23408812729498163,0.49510403916768664
642,013,4704,185,1393,796,4519,4704,1.0,0.03932823129251701,0.9606717687074829,2515,0.2961309523809524,0.16921768707482993,0.5346513605442177
643,013,8121,280,1990,537,7841,8121,1.0,0.03447851249846078,0.9655214875015392,5594,0.24504371382834625,0.06612486147026228,0.6888314247013915
644,013,6306,396,2372,1067,5910,6306,1.0,0.06279733587059944,0.9372026641294006,2867,0.37614969869965115,0.16920393276244847,0.4546463685379004
645,013,4281,127,1369,1654,4154,4281,1.0,0.029665965895818734,0.9703340341041813,1258,0.3197850969399673,0.3863583274935763,0.29385657556645645
646,013,1775,106,262,501,1669,1775,1.0,0.05971830985915493,0.9402816901408451,1012,0.1476056338028169,0.28225352112676055,0.5701408450704225
647,013,2791,182,1014,411,2609,2791,1.0,0.06520960229308491,0.9347903977069151,1366,0.3633106413471874,0.14725904693658187,0.48943031171623075
648,013,6634,312,1524,494,6322,6634,1.0,0.04703044920108532,0.9529695507989147,4616,0.22972565571299366,0.07446487790171842,0.695809466385288
649,013,6076,254,2332,1179,5822,6076,1.0,0.04180381830151415,0.9581961816984859,2565,0.3838051349572087,0.19404213298222514,0.42215273206056614
650,013,2272,123,583,362,2149,2272,1.0,0.05413732394366197,0.945862676056338,1327,0.2566021126760563,0.15933098591549297,0.5840669014084507
651,013,7051,97,2788,2638,6954,7051,1.0,0.013756913912920153,0.9862430860870799,1625,0.3954049071053751,0.3741313288895192,0.23046376400510565
652,013,1132,13,484,382,1119,1132,1.0,0.011484098939929329,0.9885159010600707,266,0.4275618374558304,0.3374558303886926,0.23498233215547704
653,013,3028,139,1563,295,2889,3028,1.0,0.045904887714663146,0.9540951122853368,1170,0.5161822985468957,0.09742404227212681,0.38639365918097757
654,013,5195,197,1790,1281,4998,5195,1.0,0.03792107795957651,0.9620789220404234,2124,0.34456207892204044,0.2465832531280077,0.4088546679499519
655,013,4381,166,1861,1327,4215,4381,1.0,0.03789089249029902,0.962109107509701,1193,0.4247888609906414,0.3028988815338964,0.2723122574754622
656,013,9182,157,3215,3727,9025,9182,1.0,0.017098671313439336,0.9829013286865607,2240,0.35014158135482465,0.4059028534088434,0.24395556523633197
657,013,8508,231,2654,3217,8277,8508,1.0,0.027150916784203102,0.9728490832157969,2637,0.31194170192759757,0.3781147155618242,0.3099435825105783
658,013,1892,72,466,682,1820,1892,1.0,0.03805496828752643,0.9619450317124736,744,0.2463002114164905,0.36046511627906974,0.39323467230443976
659,013,5373,291,1092,872,5082,5373,1.0,0.05415968732551647,0.9458403126744835,3409,0.2032384142936907,0.1622929462125442,0.6344686394937651
660,013,5038,267,1416,1514,4771,5038,1.0,0.052997221119491865,0.9470027788805081,2108,0.2810639142516872,0.30051607780865425,0.4184200079396586
661,013,9345,287,2461,4098,9058,9345,1.0,0.030711610486891385,0.9692883895131086,2786,0.2633493846976993,0.43852327447833067,0.29812734082397
662,013,3667,253,927,567,3414,3667,1.0,0.06899372784292337,0.9310062721570767,2173,0.252795200436324,0.15462230706299426,0.5925824925006817
663,013,2182,79,568,686,2103,2182,1.0,0.03620531622364803,0.963794683776352,928,0.2603116406966086,0.31439046746104493,0.42529789184234645
664,013,4584,39,1242,1976,4545,4584,1.0,0.008507853403141362,0.9914921465968587,1366,0.2709424083769634,0.43106457242582896,0.29799301919720766
665,013,4228,177,865,273,4051,4228,1.0,0.041863765373699145,0.9581362346263008,3090,0.20458845789971616,0.06456953642384106,0.7308420056764428
666,013,6744,121,2288,2196,6623,6744,1.0,0.01794187425860024,0.9820581257413997,2260,0.33926453143534996,0.32562277580071175,0.3351126927639383
667,013,4282,131,1650,1397,4151,4282,1.0,0.030593180756655767,0.9694068192433443,1235,0.3853339560952826,0.3262494161606726,0.28841662774404486
668,013,2966,119,1468,372,2847,2966,1.0,0.04012137559002023,0.9598786244099797,1126,0.4949426837491571,0.12542144302090358,0.3796358732299393
669,013,65,6,13,33,59,65,1.0,0.09230769230769231,0.9076923076923077,19,0.2,0.5076923076923077,0.2923076923076923
670,013,4040,99,1688,1432,3941,4040,1.0,0.024504950495049506,0.9754950495049505,920,0.4178217821782178,0.35445544554455444,0.22772277227722773
671,013,3154,95,749,1090,3059,3154,1.0,0.030120481927710843,0.9698795180722891,1315,0.23747622067216234,0.34559289790741915,0.4169308814204185
672,013,5609,302,1869,581,5307,5609,1.0,0.05384203957924764,0.9461579604207524,3159,0.33321447673382065,0.10358352647530754,0.5632019967908718
673,013,5113,102,2119,1904,5011,5113,1.0,0.01994914922745942,0.9800508507725406,1090,0.41443379620575005,0.3723841189125758,0.21318208488167417
674,013,3446,165,924,230,3281,3446,1.0,0.04788160185722577,0.9521183981427742,2292,0.2681369704004643,0.06674405107370865,0.665118978525827
675,013,4699,228,964,391,4471,4699,1.0,0.04852096190678868,0.9514790380932113,3344,0.20515003192168546,0.08320919344541391,0.7116407746329007
676,013,4880,117,1410,2551,4763,4880,1.0,0.023975409836065574,0.9760245901639344,919,0.2889344262295082,0.5227459016393443,0.18831967213114753
677,013,2886,43,1158,1307,2843,2886,1.0,0.0148995148995149,0.9851004851004851,421,0.40124740124740127,0.4528759528759529,0.14587664587664587
678,013,1189,47,175,574,1142,1189,1.0,0.03952901597981497,0.960470984020185,440,0.1471825063078217,0.4827586206896552,0.3700588730025231
679,013,5529,196,1960,1615,5333,5529,1.0,0.035449448363175984,0.964550551636824,1954,0.35449448363175984,0.2920962199312715,0.3534092964369687
680,013,6087,89,1589,3383,5998,6087,1.0,0.014621324133399047,0.985378675866601,1115,0.2610481353704616,0.5557746016099885,0.18317726301954987
681,013,4922,102,1941,1550,4820,4922,1.0,0.02072328321820398,0.9792767167817961,1431,0.39435188947582284,0.31491263713937423,0.29073547338480293
682,013,8933,300,3123,2296,8633,8933,1.0,0.03358334266203963,0.9664166573379603,3514,0.34960259711183256,0.2570245158401433,0.3933728870480242
683,013,4553,48,1835,1917,4505,4553,1.0,0.010542499450911487,0.9894575005490885,801,0.40303096859213705,0.4210410718207775,0.17592795958708543
684,013,5105,130,1827,1937,4975,5105,1.0,0.025465230166503428,0.9745347698334965,1341,0.35788442703232126,0.3794319294809011,0.2626836434867777
685,013,5171,135,1073,2991,5036,5171,1.0,0.026107135950493136,0.9738928640495068,1107,0.20750338425836395,0.5784181009475924,0.21407851479404372
686,013,4233,206,1128,786,4027,4233,1.0,0.04866524923222301,0.951334750767777,2319,0.2664776754075124,0.1856839121190645,0.5478384124734231
687,013,3501,46,1422,1429,3455,3501,1.0,0.013139103113396172,0.9868608968866038,650,0.40616966580976865,0.40816909454441586,0.1856612396458155
688,013,9753,181,3192,4076,9572,9753,1.0,0.018558392289551934,0.9814416077104481,2485,0.3272839126422639,0.4179226904542192,0.2547933969035169
689,013,3606,177,1995,508,3429,3606,1.0,0.04908485856905158,0.9509151414309485,1103,0.5532445923460898,0.1408763172490294,0.30587909040488076
690,013,525,19,269,187,506,525,1.0,0.03619047619047619,0.9638095238095238,69,0.5123809523809524,0.35619047619047617,0.13142857142857142
691,013,2668,115,554,299,2553,2668,1.0,0.04310344827586207,0.9568965517241379,1815,0.20764617691154422,0.11206896551724138,0.6802848575712144
692,013,2285,87,930,654,2198,2285,1.0,0.038074398249452954,0.9619256017505471,701,0.40700218818380746,0.2862144420131291,0.3067833698030635
693,013,1088,24,417,540,1064,1088,1.0,0.022058823529411766,0.9779411764705882,131,0.38327205882352944,0.4963235294117647,0.12040441176470588
694,013,4798,97,2252,1691,4701,4798,1.0,0.020216756982075864,0.9797832430179242,855,0.46936223426427676,0.35243851604835347,0.17819924968736975
695,013,5546,22,1753,2669,5524,5546,1.0,0.003966822935448972,0.9960331770645511,1124,0.3160836639019113,0.48124774612333215,0.2026685899747566
696,013,8660,205,2196,3526,8455,8660,1.0,0.02367205542725173,0.9763279445727483,2938,0.2535796766743649,0.40715935334872977,0.3392609699769053
697,013,2931,142,795,401,2789,2931,1.0,0.04844762879563289,0.9515523712043671,1735,0.2712384851586489,0.13681337427499146,0.5919481405663596
698,013,5071,253,1362,1318,4818,5071,1.0,0.049891540130151846,0.9501084598698482,2391,0.2685860776967068,0.2599092881088543,0.47150463419443894
699,013,3176,41,907,1317,3135,3176,1.0,0.012909319899244332,0.9870906801007556,952,0.2855793450881612,0.41467254408060455,0.29974811083123426
700,013,4106,205,1787,904,3901,4106,1.0,0.04992693619094009,0.9500730638090599,1415,0.43521675596687776,0.2201656113005358,0.34461763273258644
701,013,2311,56,1242,854,2255,2311,1.0,0.024231934227607096,0.975768065772393,215,0.5374296841194288,0.3695369969710082,0.09303331890956296
702,013,4057,141,2002,1196,3916,4057,1.0,0.03475474488538329,0.9652452551146167,859,0.49346807986196695,0.29479911264481146,0.2117328074932216
703,013,1358,13,527,697,1345,1358,1.0,0.009572901325478646,0.9904270986745214,134,0.38807069219440354,0.5132547864506627,0.09867452135493372
704,013,2940,147,1183,614,2793,2940,1.0,0.05,0.95,1143,0.4023809523809524,0.20884353741496597,0.38877551020408163
705,013,10599,378,2955,3269,10221,10599,1.0,0.035663741862439854,0.9643362581375602,4375,0.27879988678177187,0.3084253231436928,0.4127747900745353
706,013,6689,228,2339,1209,6461,6689,1.0,0.0340858125280311,0.9659141874719689,3141,0.34967857676782776,0.1807445059052175,0.4695769173269547
707,013,5645,233,1620,1322,5412,5645,1.0,0.04127546501328609,0.958724534986714,2703,0.2869796279893711,0.2341895482728078,0.4788308237378211
708,013,4803,98,1627,2379,4705,4803,1.0,0.02040391422027899,0.979596085779721,797,0.33874661669789713,0.49531542785758903,0.16593795544451384
709,013,3102,88,904,1337,3014,3102,1.0,0.028368794326241134,0.9716312056737588,861,0.29142488716956805,0.4310122501611863,0.2775628626692456
710,013,7964,302,2312,1454,7662,7964,1.0,0.03792064289301859,0.9620793571069814,4198,0.29030637870416875,0.1825715720743345,0.5271220492214967
711,013,3301,48,1113,1629,3253,3301,1.0,0.014541048167222055,0.985458951832778,559,0.33717055437746135,0.4934868221750984,0.16934262344744017
712,013,971,48,178,138,923,971,1.0,0.04943357363542739,0.9505664263645726,655,0.18331616889804325,0.14212152420185376,0.674562306900103
713,013,3192,94,996,1107,3098,3192,1.0,0.02944862155388471,0.9705513784461153,1089,0.31203007518796994,0.3468045112781955,0.34116541353383456
714,013,1827,33,814,492,1794,1827,1.0,0.0180623973727422,0.9819376026272578,521,0.4455391351943076,0.26929392446633826,0.28516694033935414
715,013,6438,209,1981,1459,6229,6438,1.0,0.03246349798073936,0.9675365020192607,2998,0.307704255980118,0.22662317489903697,0.465672569120845
716,013,5984,343,1581,369,5641,5984,1.0,0.05731951871657754,0.9426804812834224,4034,0.26420454545454547,0.06166443850267379,0.6741310160427807
717,013,5559,294,1940,843,5265,5559,1.0,0.0528872099298435,0.9471127900701565,2776,0.34898363014930744,0.15164597949271452,0.49937039035797803
718,013,3591,81,1311,1505,3510,3591,1.0,0.022556390977443608,0.9774436090225563,775,0.36507936507936506,0.4191033138401559,0.21581732108047896
719,013,2297,32,980,1227,2265,2297,1.0,0.013931214627775359,0.9860687853722246,90,0.42664344797562037,0.5341750108837614,0.0391815411406182
720,013,7782,326,2224,1982,7456,7782,1.0,0.04189154459007967,0.9581084554099203,3576,0.2857877152402981,0.25469031097404266,0.45952197378565923
721,013,10931,426,1816,1285,10505,10931,1.0,0.038971731772024516,0.9610282682279755,7830,0.1661330161924801,0.11755557588509744,0.7163114079224224
722,013,3522,231,1154,419,3291,3522,1.0,0.065587734241908,0.934412265758092,1949,0.3276547416240772,0.11896649630891538,0.5533787620670074
723,013,4212,285,1712,451,3927,4212,1.0,0.06766381766381767,0.9323361823361823,2049,0.40645773979107314,0.10707502374169041,0.48646723646723644
724,013,2454,66,527,722,2388,2454,1.0,0.02689486552567237,0.9731051344743277,1205,0.21475142624286878,0.29421352893235536,0.4910350448247759
725,013,3603,115,1091,1116,3488,3603,1.0,0.031917846239245075,0.9680821537607549,1396,0.3028032195392728,0.3097418817651957,0.3874548986955315
726,013,8543,522,3776,1024,8021,8543,1.0,0.06110265714620157,0.9388973428537984,3743,0.4419992976706075,0.11986421631745288,0.4381364860119396
727,013,1538,20,567,735,1518,1538,1.0,0.013003901170351105,0.9869960988296489,236,0.36866059817945385,0.4778933680104031,0.15344603381014305
728,013,5598,126,1634,2484,5472,5598,1.0,0.022508038585209004,0.977491961414791,1480,0.2918899607002501,0.4437299035369775,0.2643801357627724
729,013,4881,134,1363,2581,4747,4881,1.0,0.02745339069862733,0.9725466093013727,937,0.2792460561360377,0.5287850850235607,0.19196885884040155
730,013,2982,22,891,1607,2960,2982,1.0,0.007377598926894702,0.9926224010731053,484,0.2987927565392354,0.5389000670690811,0.16230717639168343
731,013,9960,123,3168,4391,9837,9960,1.0,0.012349397590361445,0.9876506024096385,2401,0.3180722891566265,0.44086345381526104,0.24106425702811246
732,013,4486,160,818,328,4326,4486,1.0,0.03566651805617477,0.9643334819438253,3340,0.18234507356219348,0.07311636201515827,0.7445385644226482
733,013,5834,78,2425,2065,5756,5834,1.0,0.013369900582790539,0.9866300994172095,1344,0.41566678093932125,0.35395954748028796,0.23037367158039082
734,013,751,696,196,30,55,751,1.0,0.9267643142476698,0.07323568575233022,525,0.2609853528628495,0.03994673768308921,0.6990679094540613
735,013,2667,63,847,1250,2604,2667,1.0,0.023622047244094488,0.9763779527559056,570,0.31758530183727035,0.46869141357330335,0.21372328458942633
736,013,4868,189,1458,460,4679,4868,1.0,0.038824979457682825,0.9611750205423172,2950,0.29950698438783896,0.09449465899753492,0.6059983566146261
737,013,2813,150,628,311,2663,2813,1.0,0.053323853537148955,0.946676146462851,1874,0.22324920014219693,0.11055812300035549,0.6661926768574475
738,013,4836,180,1193,847,4656,4836,1.0,0.03722084367245657,0.9627791563275434,2796,0.2466914805624483,0.17514474772539287,0.5781637717121588
739,013,5375,399,1987,762,4976,5375,1.0,0.07423255813953489,0.9257674418604651,2626,0.36967441860465117,0.1417674418604651,0.4885581395348837
740,013,4444,224,1287,480,4220,4444,1.0,0.050405040504050404,0.9495949594959496,2677,0.2896039603960396,0.10801080108010801,0.6023852385238524
741,013,3004,105,764,1285,2899,3004,1.0,0.03495339547270306,0.965046604527297,955,0.25432756324900135,0.427762982689747,0.31790945406125165
742,013,2727,83,1205,875,2644,2727,1.0,0.030436376971030438,0.9695636230289696,647,0.44187752108544187,0.32086541987532086,0.23725705903923724
743,013,3357,188,1164,540,3169,3357,1.0,0.05600238308013107,0.9439976169198689,1653,0.34673815907059874,0.16085790884718498,0.4924039320822163
744,013,9717,462,2235,2365,9255,9717,1.0,0.04754553874652671,0.9524544612534733,5117,0.23000926211793762,0.24338787691674385,0.5266028609653185
745,013,3253,50,1357,1184,3203,3253,1.0,0.01537042729787888,0.9846295727021211,712,0.4171533968644328,0.3639717184137719,0.21887488472179525
746,013,4093,44,1444,1740,4049,4093,1.0,0.010750061079892499,0.9892499389201075,909,0.35279745907647203,0.42511605179574885,0.22208648912777915
747,013,7794,45,2356,4184,7749,7794,1.0,0.005773672055427252,0.9942263279445728,1254,0.3022838080574801,0.5368231973312805,0.1608929946112394
748,013,3645,30,1291,1773,3615,3645,1.0,0.00823045267489712,0.9917695473251029,581,0.3541838134430727,0.48641975308641977,0.15939643347050755
749,013,5940,206,2013,1913,5734,5940,1.0,0.03468013468013468,0.9653198653198654,2014,0.3388888888888889,0.32205387205387204,0.33905723905723906
750,013,3297,66,1574,1440,3231,3297,1.0,0.020018198362147407,0.9799818016378526,283,0.47740370033363666,0.4367606915377616,0.08583560812860176
751,013,1849,45,601,931,1804,1849,1.0,0.024337479718766902,0.9756625202812331,317,0.32504056246619795,0.5035154137371552,0.17144402379664683
752,013,5295,116,1698,2006,5179,5295,1.0,0.021907459867799812,0.9780925401322002,1591,0.3206798866855524,0.378847969782814,0.3004721435316336
753,013,2755,61,847,1526,2694,2755,1.0,0.022141560798548093,0.9778584392014519,382,0.3074410163339383,0.553901996370236,0.13865698729582576
754,013,1173,33,426,461,1140,1173,1.0,0.028132992327365727,0.9718670076726342,286,0.3631713554987212,0.39300937766410915,0.24381926683716965
755,013,3235,104,872,810,3131,3235,1.0,0.0321483771251932,0.9678516228748067,1553,0.2695517774343122,0.250386398763524,0.48006182380216383
756,013,4565,229,1179,923,4336,4565,1.0,0.050164293537787515,0.9498357064622125,2463,0.2582694414019715,0.2021905805038335,0.539539978094195
757,013,3937,242,985,1181,3695,3937,1.0,0.06146812293624587,0.9385318770637542,1771,0.25019050038100077,0.2999745999491999,0.44983489966979934
758,013,6327,178,1720,2409,6149,6327,1.0,0.028133396554449186,0.9718666034455508,2198,0.27185079816658764,0.3807491702228544,0.34740003161055794
759,013,6876,182,2236,2674,6694,6876,1.0,0.02646887725421757,0.9735311227457825,1966,0.3251890634089587,0.3888888888888889,0.2859220477021524
760,013,6826,166,2379,1677,6660,6826,1.0,0.024318781130969823,0.9756812188690301,2770,0.34852036331673014,0.24567828889539994,0.4058013477878699
761,013,6571,186,1935,1556,6385,6571,1.0,0.02830619388220971,0.9716938061177903,3080,0.2944757266778268,0.23679805204687263,0.46872622127530056
762,013,9826,172,3111,4625,9654,9826,1.0,0.0175045796865459,0.982495420313454,2090,0.3166089965397924,0.4706900061062487,0.2127009973539589
763,013,6255,117,2330,2329,6138,6255,1.0,0.01870503597122302,0.981294964028777,1596,0.37250199840127896,0.37234212629896085,0.2551558752997602
764,013,5358,123,1199,3157,5235,5358,1.0,0.02295632698768197,0.977043673012318,1002,0.22377752892870473,0.5892123926838373,0.187010078387458
765,013,3503,96,619,1143,3407,3503,1.0,0.027405081358835286,0.9725949186411648,1741,0.17670568084499,0.3262917499286326,0.49700256922637737
766,013,5065,228,2385,1034,4837,5065,1.0,0.04501480750246792,0.9549851924975321,1646,0.47087857847976305,0.20414610069101677,0.32497532082922015
767,013,8038,356,2183,1893,7682,8038,1.0,0.04428962428464792,0.9557103757153521,3962,0.2715849713859169,0.23550634486190594,0.49290868375217717
768,013,3345,33,1095,1812,3312,3345,1.0,0.009865470852017937,0.9901345291479821,438,0.3273542600896861,0.5417040358744395,0.13094170403587443
769,013,3332,111,897,377,3221,3332,1.0,0.03331332533013205,0.9666866746698679,2058,0.2692076830732293,0.1131452581032413,0.6176470588235294
770,013,4163,84,1420,1970,4079,4163,1.0,0.020177756425654576,0.9798222435743454,773,0.34110016814797023,0.47321643045880374,0.18568340139322603
771,013,2229,84,1006,584,2145,2229,1.0,0.03768506056527591,0.9623149394347241,639,0.45132346343651863,0.2620008972633468,0.28667563930013457
772,013,3887,60,1616,1282,3827,3887,1.0,0.015436068947774634,0.9845639310522254,989,0.4157447903267301,0.32981733985078465,0.25443786982248523
773,013,2918,138,700,483,2780,2918,1.0,0.047292666209732694,0.9527073337902673,1735,0.23989033584647018,0.16552433173406442,0.5945853324194654
774,013,9161,273,2602,3593,8888,9161,1.0,0.02980024014845541,0.9701997598515446,2966,0.28403012771531494,0.3922060910380963,0.3237637812465888
775,013,2463,69,777,678,2394,2463,1.0,0.028014616321559074,0.9719853836784409,1008,0.315468940316687,0.27527405602923266,0.4092570036540804
776,013,3152,105,914,1154,3047,3152,1.0,0.033312182741116754,0.9666878172588832,1084,0.2899746192893401,0.36611675126903553,0.34390862944162437
777,013,2963,23,930,1286,2940,2963,1.0,0.0077624029699628755,0.9922375970300371,747,0.31387107661154234,0.43401957475531555,0.2521093486331421
778,013,2547,28,1056,1301,2519,2547,1.0,0.01099332548095799,0.989006674519042,190,0.41460541813898705,0.5107970160973695,0.0745975657636435
779,013,4721,103,1520,1486,4618,4721,1.0,0.021817411565346324,0.9781825884346537,1715,0.3219656852361788,0.3147638212243169,0.36327049353950436
780,013,8925,435,2463,867,8490,8925,1.0,0.04873949579831933,0.9512605042016806,5595,0.27596638655462186,0.09714285714285714,0.626890756302521
781,013,6195,83,1490,3519,6112,6195,1.0,0.013397901533494754,0.9866020984665053,1186,0.24051654560129138,0.5680387409200969,0.19144471347861178
782,013,9938,292,2730,5805,9646,9938,1.0,0.02938216945059368,0.9706178305494063,1403,0.2747031595894546,0.5841215536325216,0.14117528677802374
783,013,9812,417,2165,573,9395,9812,1.0,0.042498980839788016,0.957501019160212,7074,0.22064818589482266,0.05839788014675907,0.7209539339584182
784,013,5465,356,1738,1099,5109,5465,1.0,0.06514181152790485,0.9348581884720951,2628,0.3180237877401647,0.20109789569990852,0.4808783165599268
785,013,2203,96,672,853,2107,2203,1.0,0.04357694053563323,0.9564230594643668,678,0.3050385837494326,0.3871992737176577,0.3077621425329097
786,013,3273,131,822,224,3142,3273,1.0,0.040024442407577146,0.9599755575924228,2227,0.25114573785517874,0.06843874121600978,0.6804155209288115
787,013,4270,113,2002,1662,4157,4270,1.0,0.026463700234192037,0.9735362997658079,606,0.46885245901639344,0.3892271662763466,0.14192037470725996
788,013,2054,70,637,547,1984,2054,1.0,0.034079844206426485,0.9659201557935735,870,0.310126582278481,0.26630963972736127,0.42356377799415773
789,013,6809,341,2595,681,6468,6809,1.0,0.050080775444264945,0.9499192245557351,3533,0.38111323248641504,0.1000146864444118,0.5188720810691732
790,013,5771,270,1998,949,5501,5771,1.0,0.04678565239993069,0.9532143476000693,2824,0.3462138277594871,0.16444290417605267,0.4893432680644602
791,013,9008,287,2714,1100,8721,9008,1.0,0.03186056838365897,0.9681394316163411,5194,0.30128774422735344,0.12211367673179396,0.5765985790408525
792,013,7491,281,2069,2060,7210,7491,1.0,0.03751168068348685,0.9624883193165131,3362,0.276198104391937,0.2749966626618609,0.4488052329462021
793,013,4959,158,1057,1058,4801,4959,1.0,0.0318612623512805,0.9681387376487195,2844,0.21314781205888284,0.21334946561806817,0.573502722323049
794,013,4343,135,1994,1230,4208,4343,1.0,0.03108450379921713,0.9689154962007829,1119,0.45912963389362194,0.28321436794842275,0.2576559981579553
795,013,3329,115,1567,901,3214,3329,1.0,0.03454490838089516,0.9654550916191048,861,0.4707119255031541,0.2706518474016221,0.25863622709522377
796,013,3360,31,1098,1256,3329,3360,1.0,0.009226190476190476,0.9907738095238096,1006,0.3267857142857143,0.3738095238095238,0.2994047619047619
797,013,7380,385,2930,1211,6995,7380,1.0,0.0521680216802168,0.9478319783197832,3239,0.3970189701897019,0.16409214092140922,0.4388888888888889
798,013,4707,52,1228,2066,4655,4707,1.0,0.011047376248141066,0.9889526237518589,1413,0.26088803909071595,0.4389207563203739,0.30019120458891013
799,013,7199,126,2264,3419,7073,7199,1.0,0.01750243089317961,0.9824975691068204,1516,0.31448812335046533,0.47492707320461175,0.21058480344492292
800,013,4386,61,1301,2183,4325,4386,1.0,0.013907888736890105,0.9860921112631099,902,0.296625626994984,0.49772001823985407,0.2056543547651619
801,013,3196,104,867,874,3092,3196,1.0,0.03254067584480601,0.967459324155194,1455,0.2712765957446808,0.2734668335419274,0.45525657071339176
802,013,948,19,104,365,929,948,1.0,0.020042194092827006,0.979957805907173,479,0.10970464135021098,0.3850210970464135,0.5052742616033755
803,013,4140,135,1401,1056,4005,4140,1.0,0.03260869565217391,0.967391304347826,1683,0.3384057971014493,0.25507246376811593,0.40652173913043477
804,013,3174,95,950,1330,3079,3174,1.0,0.029930686830497794,0.9700693131695022,894,0.29930686830497794,0.4190296156269691,0.28166351606805295
805,013,201,196,74,7,5,201,1.0,0.9751243781094527,0.024875621890547265,120,0.3681592039800995,0.03482587064676617,0.5970149253731343
806,013,4904,240,1406,830,4664,4904,1.0,0.048939641109298535,0.9510603588907015,2668,0.2867047308319739,0.16924959216965743,0.5440456769983687
807,013,7590,190,2007,2603,7400,7590,1.0,0.025032938076416336,0.9749670619235836,2980,0.26442687747035576,0.3429512516469038,0.3926218708827404
808,013,2404,128,703,436,2276,2404,1.0,0.05324459234608985,0.9467554076539102,1265,0.29242928452579037,0.18136439267886856,0.5262063227953411
809,013,514,5,124,132,509,514,1.0,0.009727626459143969,0.9902723735408561,258,0.24124513618677043,0.25680933852140075,0.5019455252918288
810,013,2654,98,892,750,2556,2654,1.0,0.03692539562923888,0.9630746043707611,1012,0.3360964581763376,0.2825923134890731,0.3813112283345893
811,013,1498,12,675,625,1486,1498,1.0,0.00801068090787717,0.9919893190921228,198,0.4506008010680908,0.4172229639519359,0.1321762349799733
812,013,3488,28,1128,1113,3460,3488,1.0,0.008027522935779817,0.9919724770642202,1247,0.32339449541284404,0.31909403669724773,0.35751146788990823
813,013,3432,147,1621,1042,3285,3432,1.0,0.04283216783216783,0.9571678321678322,769,0.4723193473193473,0.30361305361305363,0.22406759906759907
814,013,2863,53,1050,1376,2810,2863,1.0,0.01851205029689137,0.9814879497031086,437,0.36674816625916873,0.48061473978344393,0.15263709395738737
815,013,3069,106,964,882,2963,3069,1.0,0.03453893776474422,0.9654610622352557,1223,0.3141088302378625,0.2873900293255132,0.3985011404366243
816,013,3035,186,974,351,2849,3035,1.0,0.06128500823723229,0.9387149917627677,1710,0.32092257001647445,0.1156507413509061,0.5634266886326195
817,013,2721,82,572,1607,2639,2721,1.0,0.03013597941933113,0.9698640205806689,542,0.21021683204704153,0.5905916942300625,0.199191473722896
818,013,3224,50,1249,1424,3174,3224,1.0,0.015508684863523574,0.9844913151364765,551,0.38740694789081886,0.44168734491315137,0.17090570719602977
819,013,2652,41,877,1043,2611,2652,1.0,0.01546003016591252,0.9845399698340875,732,0.3306938159879336,0.39328808446455504,0.27601809954751133
820,013,4166,149,1055,1631,4017,4166,1.0,0.0357657225156025,0.9642342774843975,1480,0.25324051848295726,0.3915026404224676,0.3552568410945751
821,013,6751,112,2298,2220,6639,6751,1.0,0.016590134794845206,0.9834098652051548,2233,0.34039401570137756,0.3288401718263961,0.33076581247222636
822,013,4736,196,2140,1270,4540,4736,1.0,0.041385135135135136,0.9586148648648649,1326,0.4518581081081081,0.26815878378378377,0.2799831081081081
823,013,6646,245,2162,731,6401,6646,1.0,0.03686427926572374,0.9631357207342762,3753,0.32530845621426424,0.10999097201324105,0.5647005717724948
824,013,162,14,23,32,148,162,1.0,0.08641975308641975,0.9135802469135802,107,0.1419753086419753,0.19753086419753085,0.6604938271604939
825,013,4515,41,1528,1518,4474,4515,1.0,0.009080841638981174,0.9909191583610188,1469,0.33842746400885937,0.3362126245847176,0.325359911406423
826,013,10536,482,2455,1062,10054,10536,1.0,0.04574791192103265,0.9542520880789673,7019,0.2330106302201974,0.10079726651480637,0.6661921032649962
827,013,7182,167,2198,3457,7015,7182,1.0,0.02325257588415483,0.9767474241158451,1527,0.3060428849902534,0.48134224450013924,0.21261487050960734
828,013,2603,40,1262,1079,2563,2603,1.0,0.01536688436419516,0.9846331156358048,262,0.48482520169035725,0.4145217057241644,0.10065309258547829
829,013,3804,114,840,951,3690,3804,1.0,0.02996845425867508,0.9700315457413249,2013,0.22082018927444794,0.25,0.5291798107255521
830,013,2917,144,1336,793,2773,2917,1.0,0.049365786767226603,0.9506342132327734,788,0.45800479945149125,0.27185464518340763,0.2701405553651011
831,013,3635,35,1101,1660,3600,3635,1.0,0.009628610729023384,0.9903713892709766,874,0.30288858321870704,0.45667125171939477,0.24044016506189822
832,013,4772,284,1352,1130,4488,4772,1.0,0.05951383067896061,0.9404861693210393,2290,0.28331936295054483,0.23679798826487847,0.4798826487845767
833,013,2264,65,866,781,2199,2264,1.0,0.02871024734982332,0.9712897526501767,617,0.3825088339222615,0.34496466431095407,0.27252650176678445
834,013,3729,108,1464,1305,3621,3729,1.0,0.028962188254223652,0.9710378117457763,960,0.3925985518905873,0.3499597747385358,0.2574416733708769
835,013,3711,30,1447,1832,3681,3711,1.0,0.008084074373484237,0.9919159256265158,432,0.389921853947723,0.493667475074104,0.116410670978173
836,013,4085,112,1394,1589,3973,4085,1.0,0.027417380660954713,0.9725826193390453,1102,0.3412484700122399,0.38898408812729496,0.26976744186046514
837,013,5462,59,2191,2070,5403,5462,1.0,0.010801904064445257,0.9891980959355547,1201,0.40113511534236546,0.37898205785426586,0.21988282680336874
838,013,2745,52,817,1017,2693,2745,1.0,0.01894353369763206,0.981056466302368,911,0.297632058287796,0.3704918032786885,0.3318761384335155
839,013,4173,209,1760,416,3964,4173,1.0,0.050083872513779056,0.9499161274862209,1997,0.4217589264318236,0.09968847352024922,0.47855260004792716
840,013,1932,68,565,723,1864,1932,1.0,0.035196687370600416,0.9648033126293996,644,0.2924430641821946,0.37422360248447206,0.3333333333333333
841,013,5293,74,2027,2323,5219,5293,1.0,0.01398072926506707,0.9860192707349329,943,0.38295862459852636,0.4388815416587946,0.17815983374267902
842,013,11180,639,2652,925,10541,11180,1.0,0.05715563506261181,0.9428443649373882,7603,0.2372093023255814,0.08273703041144902,0.6800536672629696
843,013,3713,148,1735,927,3565,3713,1.0,0.03985995152168058,0.9601400484783195,1051,0.4672771343926744,0.24966334500403986,0.28305952060328576
844,013,1632,14,446,827,1618,1632,1.0,0.00857843137254902,0.991421568627451,359,0.27328431372549017,0.5067401960784313,0.21997549019607843
845,013,2773,64,810,1033,2709,2773,1.0,0.02307969707897584,0.9769203029210242,930,0.29210241615578797,0.3725207356653444,0.33537684817886765
846,013,14,1,1,1,13,14,1.0,0.07142857142857142,0.9285714285714286,12,0.07142857142857142,0.07142857142857142,0.8571428571428571
847,013,8,1,3,2,7,8,1.0,0.125,0.875,3,0.375,0.25,0.375
848,013,24,0,11,12,24,24,1.0,0.0,1.0,1,0.4583333333333333,0.5,0.041666666666666664
849,013,5821,357,2199,800,5464,5821,1.0,0.06132966844184848,0.9386703315581515,2822,0.37777014258718433,0.1374334306820134,0.48479642673080225
850,013,1566,56,770,493,1510,1566,1.0,0.035759897828863345,0.9642401021711366,303,0.49169859514687103,0.3148148148148148,0.19348659003831417
851,013,7111,246,1760,998,6865,7111,1.0,0.03459429053578962,0.9654057094642103,4353,0.24750386724792575,0.1403459429053579,0.6121501898467163
852,013,6179,142,1351,3689,6037,6179,1.0,0.02298106489723256,0.9770189351027674,1139,0.2186437934940929,0.5970221718724713,0.18433403463343584
853,013,8781,192,2309,4846,8589,8781,1.0,0.02186539118551418,0.9781346088144858,1626,0.26295410545495956,0.5518733629427173,0.1851725316023232
854,013,4813,223,1478,356,4590,4813,1.0,0.046332848535217123,0.9536671514647829,2979,0.30708497818408476,0.07396634115936007,0.6189486806565552
855,013,338,16,161,92,322,338,1.0,0.047337278106508875,0.9526627218934911,85,0.47633136094674555,0.27218934911242604,0.2514792899408284
861,013,5990,267,2084,414,5723,5990,1.0,0.04457429048414023,0.9554257095158598,3492,0.34791318864774623,0.06911519198664441,0.5829716193656094
862,013,3444,65,796,1210,3379,3444,1.0,0.018873403019744484,0.9811265969802555,1438,0.2311265969802555,0.351335656213705,0.4175377468060395
863,013,2257,82,844,654,2175,2257,1.0,0.03633141338059371,0.9636685866194062,759,0.37394771821001327,0.2897651750110766,0.33628710677891005
864,013,2886,190,488,274,2696,2886,1.0,0.06583506583506583,0.9341649341649342,2124,0.1690921690921691,0.09494109494109494,0.735966735966736
865,013,6165,143,2205,2555,6022,6165,1.0,0.023195458231954583,0.9768045417680454,1405,0.35766423357664234,0.4144363341443633,0.2278994322789943
866,013,95,0,27,68,95,95,1.130952380952381,0.0,1.0,0,0.28421052631578947,0.7157894736842105,0.0
867,013,1712,37,501,688,1675,1712,1.0,0.02161214953271028,0.9783878504672897,523,0.29264018691588783,0.40186915887850466,0.3054906542056075
868,013,3117,142,1070,556,2975,3117,1.0,0.04555662495989734,0.9544433750401027,1491,0.34327879371190245,0.17837664420917548,0.47834456207892206
869,013,3525,115,901,1111,3410,3525,1.0,0.032624113475177303,0.9673758865248226,1513,0.25560283687943264,0.315177304964539,0.42921985815602837
870,013,1706,24,486,764,1682,1706,1.0,0.01406799531066823,0.9859320046893317,456,0.28487690504103164,0.447831184056272,0.2672919109026964
871,013,3926,136,1032,368,3790,3926,1.0,0.034640855832908816,0.9653591441670912,2526,0.2628629648497198,0.09373408048904738,0.6434029546612328
872,013,5856,301,1174,554,5555,5856,1.0,0.05140027322404372,0.9485997267759563,4128,0.20047814207650272,0.09460382513661202,0.7049180327868853
873,013,5453,208,2306,1782,5245,5453,1.0,0.03814414083990464,0.9618558591600953,1365,0.4228864845039428,0.326792591234183,0.2503209242618742
874,013,2142,9,789,1025,2133,2142,1.0,0.004201680672268907,0.9957983193277311,328,0.36834733893557425,0.4785247432306256,0.1531279178338002
875,013,118,1,40,28,117,118,1.0,0.00847457627118644,0.9915254237288136,50,0.3389830508474576,0.23728813559322035,0.423728813559322
876,013,11641,556,3977,1330,11085,11641,1.0,0.04776221974057212,0.9522377802594278,6334,0.34163731638175415,0.11425135297654841,0.5441113306416975
877,013,1754,21,527,698,1733,1754,1.0,0.011972633979475485,0.9880273660205245,529,0.30045610034207526,0.3979475484606613,0.3015963511972634
878,013,6260,207,1667,1938,6053,6260,1.0,0.03306709265175719,0.9669329073482428,2655,0.2662939297124601,0.3095846645367412,0.4241214057507987
879,013,3656,68,1019,1500,3588,3656,1.0,0.018599562363238512,0.9814004376367614,1137,0.2787199124726477,0.4102844638949672,0.31099562363238514
880,013,5992,165,952,419,5827,5992,1.0,0.02753671562082777,0.9724632843791722,4621,0.1588785046728972,0.06992656875834447,0.7711949265687583
881,013,4211,97,1545,1706,4114,4211,1.0,0.023034908572785562,0.9769650914272144,960,0.36689622417478035,0.40512942293991927,0.2279743528853004
882,013,3049,45,866,1264,3004,3049,1.0,0.014758937356510331,0.9852410626434897,919,0.28402755001639884,0.4145621515250902,0.301410298458511
883,013,6023,197,1635,2343,5826,6023,1.0,0.03270795284741823,0.9672920471525818,2045,0.27145940561182136,0.38900879960152746,0.3395317947866512
884,013,3219,137,824,895,3082,3219,1.0,0.04255980118049084,0.9574401988195091,1500,0.25598011804908355,0.27803665734700217,0.4659832246039143
885,013,6932,259,1844,1855,6673,6932,1.0,0.037362954414310444,0.9626370455856895,3233,0.2660126947489902,0.267599538372764,0.4663877668782458
886,013,3203,160,795,846,3043,3203,1.0,0.049953168904152356,0.9500468310958476,1562,0.24820480799250702,0.26412738058070556,0.4876678114267874
887,013,6992,278,1900,2036,6714,6992,1.0,0.03975972540045766,0.9602402745995423,3056,0.2717391304347826,0.2911899313501144,0.43707093821510296
888,013,3022,33,1096,1157,2989,3022,1.0,0.010919920582395765,0.9890800794176042,769,0.3626737260092654,0.3828590337524818,0.2544672402382528
889,013,8,0,0,7,8,8,1.0,0.0,1.0,1,0.0,0.875,0.125
890,013,5555,228,1477,362,5327,5555,1.0,0.04104410441044105,0.958955895589559,3716,0.2658865886588659,0.06516651665166516,0.668946894689469
891,013,7514,137,2056,3088,7377,7514,1.0,0.01823263241948363,0.9817673675805164,2370,0.2736225712004259,0.41096619643332444,0.3154112323662497
892,013,5256,158,2473,1572,5098,5256,1.0,0.030060882800608826,0.9699391171993912,1211,0.4705098934550989,0.2990867579908676,0.2304033485540335
893,013,1305,32,495,574,1273,1305,1.0,0.024521072796934867,0.9754789272030652,236,0.3793103448275862,0.43984674329501916,0.18084291187739462
894,013,3229,139,946,510,3090,3229,1.0,0.04304738309074017,0.9569526169092598,1773,0.29296995973985757,0.15794363580055745,0.549086404459585
895,013,5678,146,1622,2812,5532,5678,1.0,0.02571327932370553,0.9742867206762945,1244,0.2856639661852765,0.4952448045086298,0.2190912293060937
896,013,6216,244,1490,1693,5972,6216,1.0,0.039253539253539256,0.9607464607464608,3033,0.2397039897039897,0.27236164736164736,0.48793436293436293
897,013,3673,139,978,923,3534,3673,1.0,0.037843724475905255,0.9621562755240948,1772,0.2662673563844269,0.2512932208004356,0.48243942281513746
898,013,2358,170,826,459,2188,2358,1.0,0.0720949957591179,0.9279050042408821,1073,0.35029686174724345,0.1946564885496183,0.45504664970313824
899,013,3904,133,979,525,3771,3904,1.0,0.03406762295081967,0.9659323770491803,2400,0.25076844262295084,0.13447745901639344,0.6147540983606558
900,013,8611,254,2225,3563,8357,8611,1.0,0.029497154801997445,0.9705028451980026,2823,0.25839043084426894,0.41377308094297993,0.32783648821275113
901,013,2144,18,885,798,2126,2144,1.0,0.008395522388059701,0.9916044776119403,461,0.41277985074626866,0.37220149253731344,0.2150186567164179
902,013,3843,84,1168,1300,3759,3843,1.0,0.02185792349726776,0.9781420765027322,1375,0.30392922196200883,0.33827738745771535,0.3577933905802758
903,013,65,1,7,35,64,65,1.0,0.015384615384615385,0.9846153846153847,23,0.1076923076923077,0.5384615384615384,0.35384615384615387
904,013,6519,201,1285,1548,6318,6519,1.0,0.030832949838932353,0.9691670501610676,3686,0.19711612210461726,0.23745973308789692,0.5654241448074858
905,013,5679,222,1216,2079,5457,5679,1.0,0.03909138932910724,0.9609086106708927,2384,0.2141222046134883,0.36608557844690964,0.41979221693960206
906,013,11918,145,3889,3905,11773,11918,1.0,0.012166470884376572,0.9878335291156234,4124,0.32631313978855514,0.32765564692062427,0.3460312132908206
907,013,5358,49,1675,2764,5309,5358,1.0,0.009145203434117209,0.9908547965658828,919,0.31261664800298616,0.5158641284061217,0.1715192235908921
908,013,1034,45,445,248,989,1034,1.0,0.043520309477756286,0.9564796905222437,341,0.43036750483558994,0.23984526112185686,0.32978723404255317
909,013,2818,131,728,1120,2687,2818,1.0,0.046486870120652946,0.9535131298793471,970,0.25833924769339955,0.397444996451384,0.34421575585521647
910,013,3644,63,1207,1894,3581,3644,1.0,0.01728869374313941,0.9827113062568605,543,0.33122941822173435,0.5197585071350165,0.14901207464324917
911,013,4972,188,1684,518,4784,4972,1.0,0.03781174577634755,0.9621882542236525,2770,0.33869670152855996,0.10418342719227675,0.5571198712791633
912,013,2388,104,367,931,2284,2388,1.0,0.04355108877721943,0.9564489112227805,1090,0.1536850921273032,0.3898659966499162,0.4564489112227806
913,013,5564,161,1610,2247,5403,5564,1.0,0.028936017253774263,0.9710639827462257,1707,0.28936017253774265,0.40384615384615385,0.30679367361610355
914,013,22,0,2,6,22,22,1.0,0.0,1.0,14,0.09090909090909091,0.2727272727272727,0.6363636363636364
915,013,3478,90,1150,1543,3388,3478,1.0,0.025876940770557792,0.9741230592294422,785,0.33064979873490513,0.4436457734330075,0.2257044278320874
916,013,2341,210,609,265,2131,2341,1.0,0.0897052541648868,0.9102947458351132,1467,0.2601452370781717,0.11319948739854763,0.6266552755232806
917,013,3511,42,946,1549,3469,3511,1.0,0.011962403873540303,0.9880375961264597,1016,0.269438906294503,0.4411848476217602,0.28937624608373685
918,013,8879,256,2468,3447,8623,8879,1.0,0.028832075684198672,0.9711679243158013,2964,0.2779592296429778,0.38821939407590944,0.33382137628111275
919,013,4393,168,1008,292,4225,4393,1.0,0.03824265877532438,0.9617573412246756,3093,0.22945595265194627,0.06646938310949238,0.7040746642385614
920,013,10791,197,3386,4904,10594,10791,1.0,0.01825595403577055,0.9817440459642295,2501,0.31378000185339633,0.4544527847280141,0.23176721341858955
921,013,4941,201,701,275,4740,4941,1.0,0.04068002428658166,0.9593199757134183,3965,0.14187411455171017,0.05565674964582069,0.8024691358024691
922,013,4086,230,1864,886,3856,4086,1.0,0.056289769946157614,0.9437102300538424,1336,0.45619187469407735,0.21683798335780716,0.3269701419481155
923,013,8029,256,1927,519,7773,8029,1.0,0.03188441898119317,0.9681155810188068,5583,0.24000498194046582,0.06464067754390335,0.6953543405156308
924,013,1966,61,574,490,1905,1966,1.0,0.031027466937945065,0.9689725330620549,902,0.29196337741607326,0.24923702950152593,0.4587995930824008
925,013,5858,387,2912,766,5471,5858,1.0,0.06606350290201433,0.9339364970979857,2180,0.497097985660635,0.13076135199726868,0.37214066234209625
926,013,14611,403,4229,6937,14208,14611,1.0,0.027581958798165766,0.9724180412018343,3445,0.2894394634179728,0.47477927588802954,0.23578126069399769
927,013,4408,229,1705,600,4179,4408,1.0,0.05195099818511797,0.948049001814882,2103,0.3867967332123412,0.13611615245009073,0.47708711433756806
928,013,998,68,220,181,930,998,1.0,0.06813627254509018,0.9318637274549099,597,0.22044088176352705,0.1813627254509018,0.5981963927855711
929,013,4064,137,1080,1647,3927,4064,1.0,0.033710629921259845,0.9662893700787402,1337,0.265748031496063,0.40526574803149606,0.32898622047244097
930,013,2766,144,1027,609,2622,2766,1.0,0.052060737527114966,0.9479392624728851,1130,0.37129428778018797,0.22017353579175705,0.40853217642805495
931,013,6299,228,1650,1650,6071,6299,1.0,0.036196221622479756,0.9638037783775203,2999,0.26194634068899825,0.26194634068899825,0.4761073186220035
932,013,1992,66,737,604,1926,1992,1.0,0.03313253012048193,0.9668674698795181,651,0.36997991967871485,0.3032128514056225,0.32680722891566266
933,013,3940,139,1543,1174,3801,3940,1.0,0.03527918781725888,0.9647208121827411,1223,0.3916243654822335,0.29796954314720814,0.31040609137055836
934,013,4600,244,1389,910,4356,4600,1.0,0.05304347826086957,0.9469565217391305,2301,0.30195652173913046,0.19782608695652174,0.5002173913043478
935,013,4183,227,1337,684,3956,4183,1.0,0.05426727229261296,0.945732727707387,2162,0.31962706191728424,0.16351900549844609,0.5168539325842697
936,013,3630,168,1187,769,3462,3630,1.0,0.04628099173553719,0.9537190082644628,1674,0.32699724517906337,0.2118457300275482,0.46115702479338844
937,013,3346,52,1041,972,3294,3346,1.0,0.015540944411237299,0.9844590555887627,1333,0.3111177525403467,0.2904961147638972,0.3983861326957561
938,013,5536,279,2152,914,5257,5536,1.0,0.05039739884393064,0.9496026011560693,2470,0.38872832369942195,0.16510115606936415,0.4461705202312139
939,013,3640,154,1457,938,3486,3640,1.0,0.04230769230769231,0.9576923076923077,1245,0.4002747252747253,0.25769230769230766,0.34203296703296704
940,013,4364,155,1411,1367,4209,4364,1.0,0.03551787351054079,0.9644821264894592,1586,0.32332722273143905,0.3132447296058662,0.36342804766269476
941,013,494,19,102,289,475,494,1.0,0.038461538461538464,0.9615384615384616,103,0.20647773279352227,0.5850202429149798,0.20850202429149797
942,013,7415,92,2565,3539,7323,7415,1.0,0.012407282535401213,0.9875927174645988,1311,0.3459204315576534,0.4772757923128793,0.1768037761294673
943,013,6465,296,1765,1692,6169,6465,1.0,0.045784996133023975,0.954215003866976,3008,0.27300850734725446,0.2617169373549884,0.46527455529775713
944,013,3412,109,969,1503,3303,3412,1.0,0.03194607268464244,0.9680539273153576,940,0.28399765533411486,0.4405041031652989,0.27549824150058616
945,013,10814,304,2684,5872,10510,10814,1.0,0.028111707046421307,0.9718882929535787,2258,0.24819678194932496,0.5429998150545589,0.20880340299611613
946,013,3622,73,1943,1333,3549,3622,1.0,0.02015461071231364,0.9798453892876864,346,0.5364439536167863,0.3680287134180011,0.09552733296521258
947,013,4427,67,1415,1715,4360,4427,1.0,0.015134402529929975,0.9848655974700701,1297,0.3196295459679241,0.3873955274452225,0.2929749265868534
948,013,8367,300,2460,1160,8067,8367,1.0,0.035855145213338116,0.9641448547866619,4747,0.2940121907493725,0.13863989482490738,0.5673479144257201
949,013,4220,131,1664,1253,4089,4220,1.0,0.03104265402843602,0.968957345971564,1303,0.3943127962085308,0.29691943127962084,0.30876777251184834
950,013,1245,42,232,602,1203,1245,1.0,0.033734939759036145,0.9662650602409638,411,0.18634538152610441,0.4835341365461847,0.3301204819277108
951,013,3775,180,863,329,3595,3775,1.0,0.04768211920529802,0.952317880794702,2583,0.2286092715231788,0.08715231788079471,0.6842384105960265
952,013,2322,70,840,665,2252,2322,1.0,0.030146425495262703,0.9698535745047373,817,0.36175710594315247,0.28639104220499567,0.35185185185185186
953,013,7209,321,1530,685,6888,7209,1.0,0.04452767374115689,0.9554723262588432,4994,0.21223470661672908,0.0950201137467055,0.6927451796365655
954,013,9512,247,2530,3258,9265,9512,1.0,0.025967199327165687,0.9740328006728343,3724,0.2659798149705635,0.3425147182506308,0.3915054667788057
955,013,9677,172,2909,5084,9505,9677,1.0,0.017774103544486927,0.9822258964555131,1684,0.30060969308670044,0.5253694326754159,0.17402087423788365
956,013,4229,137,1226,1884,4092,4229,1.0,0.032395365334594466,0.9676046346654056,1119,0.2899030503665169,0.44549538898084656,0.26460156065263657
957,013,4108,71,1199,2051,4037,4108,1.0,0.017283349561830575,0.9827166504381695,858,0.2918695228821811,0.499269717624148,0.2088607594936709
958,013,4112,192,1796,1025,3920,4112,1.0,0.04669260700389105,0.953307392996109,1291,0.4367704280155642,0.2492704280155642,0.3139591439688716
959,013,4138,153,1251,1213,3985,4138,1.0,0.036974383760270665,0.9630256162397294,1674,0.30231996133397776,0.2931367810536491,0.40454325761237314
960,013,7605,337,1475,495,7268,7605,1.0,0.0443129520052597,0.9556870479947404,5635,0.19395134779750164,0.0650887573964497,0.7409598948060486
961,013,8163,409,3009,666,7754,8163,1.0,0.05010412838417248,0.9498958716158276,4488,0.36861447997059904,0.08158765159867695,0.549797868430724
962,013,4310,342,995,1226,3968,4310,1.0,0.07935034802784223,0.9206496519721578,2089,0.2308584686774942,0.28445475638051043,0.48468677494199536
963,013,6499,72,2773,3009,6427,6499,1.0,0.011078627481150946,0.988921372518849,717,0.42668102785043854,0.4629943068164333,0.11032466533312818
964,013,1120,31,269,446,1089,1120,1.0,0.027678571428571427,0.9723214285714286,405,0.24017857142857144,0.3982142857142857,0.36160714285714285
965,013,5130,98,1697,2346,5032,5130,1.0,0.019103313840155945,0.980896686159844,1087,0.3307992202729045,0.45730994152046783,0.21189083820662769
966,013,2587,133,1178,178,2454,2587,1.0,0.05141090065713181,0.9485890993428682,1231,0.45535369153459604,0.06880556629300348,0.47584074217240047
967,013,405,10,184,157,395,405,1.0,0.024691358024691357,0.9753086419753086,64,0.454320987654321,0.38765432098765434,0.1580246913580247
968,013,7778,244,1973,2024,7534,7778,1.0,0.031370532270506554,0.9686294677294934,3781,0.2536641810233993,0.260221136538956,0.48611468243764466
969,013,6725,248,1104,3237,6477,6725,1.0,0.03687732342007435,0.9631226765799257,2384,0.1641635687732342,0.4813382899628253,0.3544981412639405
970,013,2857,74,801,923,2783,2857,1.0,0.02590129506475324,0.9740987049352468,1133,0.28036401820091006,0.32306615330766536,0.3965698284914246
971,013,10293,228,3572,3998,10065,10293,1.0,0.02215097639172253,0.9778490236082775,2723,0.3470319634703196,0.3884193140969591,0.26454872243272126
972,013,4172,117,1364,1455,4055,4172,1.0,0.028044103547459252,0.9719558964525408,1353,0.32694151486097794,0.3487535953978907,0.32430488974113136
973,013,2254,75,671,832,2179,2254,1.0,0.03327417923691216,0.9667258207630879,751,0.2976929902395741,0.3691215616681455,0.3331854480922804
974,013,3183,41,1753,1223,3142,3183,1.0,0.012880929940307886,0.9871190700596921,207,0.5507382972038957,0.3842287150486962,0.06503298774740811
975,013,5557,201,1819,1384,5356,5557,1.0,0.03617059564513227,0.9638294043548677,2354,0.32733489292783874,0.2490552456361346,0.42360986143602664
976,013,4294,141,1015,1607,4153,4294,1.0,0.0328365160689334,0.9671634839310667,1672,0.23637633907778297,0.37424312994876574,0.3893805309734513
977,013,2494,75,975,917,2419,2494,1.0,0.030072173215717722,0.9699278267842822,602,0.3909382518043304,0.36768243785084204,0.2413793103448276
978,013,4998,127,1446,2110,4871,4998,1.0,0.02541016406562625,0.9745898359343738,1442,0.2893157262905162,0.4221688675470188,0.28851540616246496
979,013,4275,125,2611,595,4150,4275,1.0,0.029239766081871343,0.9707602339181286,1069,0.6107602339181286,0.1391812865497076,0.25005847953216376
980,013,8783,333,3498,2442,8450,8783,1.0,0.03791415233974724,0.9620858476602527,2843,0.39826938403734485,0.27803711715814644,0.3236934988045087
981,013,3847,134,583,1899,3713,3847,1.0,0.03483233688588511,0.965167663114115,1365,0.15154665973485834,0.4936314010917598,0.35482193917338184
982,013,4344,56,1195,2302,4288,4344,1.0,0.01289134438305709,0.9871086556169429,847,0.27509208103130756,0.5299263351749539,0.19498158379373848
983,013,4080,167,1144,1140,3913,4080,1.0,0.04093137254901961,0.9590686274509804,1796,0.2803921568627451,0.27941176470588236,0.44019607843137254
984,013,5208,314,1911,1239,4894,5208,1.0,0.06029185867895545,0.9397081413210445,2058,0.36693548387096775,0.23790322580645162,0.3951612903225806
985,013,5404,364,1974,659,5040,5404,1.0,0.06735751295336788,0.9326424870466321,2771,0.36528497409326427,0.12194670614359733,0.5127683197631384
986,013,5260,184,1236,1361,5076,5260,1.0,0.0349809885931559,0.9650190114068441,2663,0.2349809885931559,0.25874524714828895,0.5062737642585551
987,013,2732,60,1219,870,2672,2732,1.0,0.021961932650073207,0.9780380673499268,643,0.44619326500732065,0.3184480234260615,0.23535871156661786
988,013,2423,64,1039,739,2359,2423,1.0,0.026413536937680563,0.9735864630623194,645,0.42880726372265787,0.3049938093272802,0.2661989269500619
989,013,7043,186,1661,3751,6857,7043,1.0,0.02640920062473378,0.9735907993752663,1631,0.23583700127786456,0.5325855459321311,0.23157745279000427
990,015,234,14,27,166,220,234,1.0,0.05982905982905983,0.9401709401709402,41,0.11538461538461539,0.7094017094017094,0.1752136752136752
991,015,348,15,58,144,333,348,1.0,0.04310344827586207,0.9568965517241379,146,0.16666666666666666,0.41379310344827586,0.41954022988505746
992,015,840,62,116,443,778,840,1.0,0.07380952380952381,0.9261904761904762,281,0.1380952380952381,0.5273809523809524,0.3345238095238095
993,015,801,21,87,410,780,801,1.0,0.026217228464419477,0.9737827715355806,304,0.10861423220973783,0.5118601747815231,0.37952559300873906
994,015,2396,32,60,1554,2364,2396,1.0,0.01335559265442404,0.986644407345576,782,0.025041736227045076,0.6485809682804674,0.32637729549248745
995,015,2699,214,21,91,2485,2699,1.0,0.07928862541682105,0.920711374583179,2587,0.007780659503519822,0.03371619118191923,0.9585031493145609
996,015,3111,92,395,1433,3019,3111,1.0,0.029572484731597556,0.9704275152684024,1283,0.12696882031501125,0.460623593699775,0.41240758598521376
997,015,1406,55,195,619,1351,1406,1.0,0.03911806543385491,0.9608819345661451,592,0.1386913229018492,0.4402560455192034,0.42105263157894735
998,015,1630,72,231,642,1558,1630,1.0,0.044171779141104296,0.9558282208588957,757,0.14171779141104293,0.39386503067484663,0.4644171779141104
999,015,9378,422,1204,4256,8956,9378,1.0,0.04499893367455748,0.9550010663254426,3918,0.12838558328001706,0.45382810833866494,0.417786308381318
1000,015,35281,1291,5263,12804,33990,35281,1.0,0.036591933335222926,0.9634080666647771,17214,0.14917377625350756,0.362914883364984,0.48791134038150846
1001,015,19165,1193,2781,8479,17972,19165,1.0,0.062248891207931124,0.9377511087920689,7905,0.14510827028437256,0.4424210800939212,0.4124706496217062
1002,015,2146,101,316,1288,2045,2146,1.0,0.04706430568499534,0.9529356943150047,542,0.14725069897483692,0.6001863932898416,0.25256290773532153
1003,015,197,44,17,107,153,197,1.0,0.2233502538071066,0.7766497461928934,73,0.08629441624365482,0.5431472081218274,0.37055837563451777
1004,015,8274,392,1268,3209,7882,8274,1.0,0.047377326565143825,0.9526226734348562,3797,0.15325114817500604,0.3878414309886391,0.45890742083635483
1005,015,10005,418,1322,4011,9587,10005,1.0,0.04177911044477761,0.9582208895552224,4672,0.13213393303348325,0.40089955022488755,0.4669665167416292
1006,015,11049,420,1797,5435,10629,11049,1.0,0.038012489818083084,0.9619875101819169,3817,0.16263915286451264,0.49189971943162275,0.3454611277038646
1007,015,13955,641,1860,6424,13314,13955,1.0,0.04593335721963454,0.9540666427803655,5671,0.13328556073092082,0.46033679684700823,0.4063776424220709
1008,015,12920,344,1730,7032,12576,12920,1.0,0.026625386996904025,0.973374613003096,4158,0.13390092879256965,0.5442724458204334,0.3218266253869969
1009,015,36241,1083,5153,18024,35158,36241,1.0,0.02988328136640821,0.9701167186335918,13064,0.14218702574432274,0.49733726994288235,0.3604757043127949
1010,015,2698,89,387,1012,2609,2698,1.0,0.032987398072646404,0.9670126019273536,1299,0.14343958487768718,0.37509266123054114,0.4814677538917717
1011,015,1722,75,249,857,1647,1722,1.0,0.04355400696864112,0.9564459930313589,616,0.1445993031358885,0.49767711962833916,0.35772357723577236
1012,015,197,136,42,52,61,197,1.0,0.6903553299492385,0.3096446700507614,103,0.2131979695431472,0.2639593908629442,0.5228426395939086
1013,015,768,740,252,43,28,768,1.0,0.9635416666666666,0.036458333333333336,473,0.328125,0.055989583333333336,0.6158854166666666
1014,017,11032,10803,6500,1044,229,11032,1.0,0.9792422044960116,0.0207577955039884,3488,0.5891950688905003,0.09463379260333575,0.3161711385061639
1015,017,1538,1357,801,225,181,1538,1.0,0.8823146944083224,0.1176853055916775,512,0.5208062418725617,0.14629388816644995,0.3328998699609883
1016,017,1316,142,58,135,1174,1316,1.0,0.10790273556231003,0.89209726443769,1123,0.044072948328267476,0.10258358662613981,0.8533434650455927
1017,017,12409,8460,5059,1836,3949,12409,1.0,0.6817632363607059,0.31823676363929404,5514,0.40768796841002497,0.1479571278910468,0.4443549036989282
1018,017,1890,1863,1008,210,27,1890,1.0,0.9857142857142858,0.014285714285714285,672,0.5333333333333333,0.1111111111111111,0.35555555555555557
1019,017,825,823,380,57,2,825,1.0,0.9975757575757576,0.0024242424242424242,388,0.46060606060606063,0.06909090909090909,0.4703030303030303
1020,017,9195,624,840,5988,8571,9195,1.0,0.06786296900489397,0.932137030995106,2367,0.09135399673735727,0.6512234910277325,0.25742251223491025
1021,017,4932,1428,924,1821,3504,4932,1.0,0.2895377128953771,0.7104622871046229,2187,0.1873479318734793,0.36922141119221413,0.44343065693430656
1022,017,2115,81,319,1175,2034,2115,1.0,0.03829787234042553,0.9617021276595744,621,0.1508274231678487,0.5555555555555556,0.2936170212765957
1023,017,1139,25,143,856,1114,1139,1.0,0.021949078138718173,0.9780509218612818,140,0.12554872695346794,0.7515364354697103,0.12291483757682177
1024,017,3580,107,587,2173,3473,3580,1.0,0.02988826815642458,0.9701117318435755,820,0.16396648044692738,0.6069832402234637,0.22905027932960895
1025,017,6241,417,253,867,5824,6241,1.0,0.06681621535010415,0.9331837846498958,5121,0.04053837526037494,0.13892004486460502,0.8205415798750201
1026,017,11530,617,1926,6458,10913,11530,1.0,0.05351257588898525,0.9464874241110147,3146,0.16704249783174327,0.5601040763226366,0.2728534258456201
1027,017,11466,7800,4585,4812,3666,11466,1.0,0.6802721088435374,0.3197278911564626,2069,0.3998778998778999,0.4196755625327054,0.18044653758939475
1028,019,2584,251,79,88,2333,2584,1.0,0.09713622291021672,0.9028637770897833,2417,0.030572755417956655,0.034055727554179564,0.9353715170278638
1029,019,1230,84,645,584,1146,1230,8.360544217687075,0.06829268292682927,0.9317073170731708,1,0.524390243902439,0.47479674796747967,0.0008130081300813008
1030,019,3016,2986,1583,1432,30,3016,9.950495049504951,0.9900530503978779,0.009946949602122016,1,0.524867374005305,0.47480106100795755,0.0003315649867374005
1031,019,3849,3785,2134,1714,64,3849,3.3431798436142484,0.9833723044946739,0.01662769550532606,1,0.5544297220057157,0.44531047025201353,0.0002598077422707197
1032,019,5512,273,426,109,5239,5512,1.0,0.049528301886792456,0.9504716981132075,4977,0.07728592162554426,0.019775036284470245,0.9029390420899854
1033,019,4482,175,575,163,4307,4482,1.0,0.039045069165551095,0.9609549308344489,3744,0.1282909415439536,0.036367692994199015,0.8353413654618473
1034,019,2605,229,2034,570,2376,2605,17.594594594594593,0.08790786948176584,0.9120921305182341,1,0.7808061420345489,0.21880998080614203,0.00038387715930902113
1035,019,1031,60,811,219,971,1031,1.5147058823529411,0.058195926285160036,0.94180407371484,1,0.7866149369544132,0.21241513094083414,0.0009699321047526673
1036,019,3415,95,1116,1141,3320,3415,1.0,0.027818448023426062,0.972181551976574,1158,0.32679355783308933,0.3341142020497804,0.3390922401171303
1037,019,2508,40,1442,355,2468,2508,1.0,0.01594896331738437,0.9840510366826156,711,0.5749601275917066,0.14154704944178628,0.2834928229665072
1038,019,3641,100,1296,620,3541,3641,1.0,0.027464982147761604,0.9725350178522384,1725,0.3559461686349904,0.17028288931612195,0.47377094204888764
1039,019,6288,91,1268,1361,6197,6288,1.0,0.014472010178117048,0.9855279898218829,3659,0.20165394402035625,0.21644402035623408,0.5819020356234097
1040,019,3832,103,1046,762,3729,3832,1.0,0.02687891440501044,0.9731210855949896,2024,0.272964509394572,0.1988517745302714,0.5281837160751566
1041,019,4479,124,1462,1572,4355,4479,1.0,0.027684751060504578,0.9723152489394954,1445,0.3264121455682072,0.35097119892833223,0.3226166555034606
1042,019,4848,123,2499,2348,4725,4848,2.4405840886203425,0.025371287128712873,0.9746287128712872,1,0.5154702970297029,0.48432343234323433,0.00020627062706270627
1043,019,3629,148,555,161,3481,3629,1.0,0.040782584734086524,0.9592174152659134,2913,0.15293469275282448,0.0443648387985671,0.8027004684486084
1044,019,2882,146,1936,787,2736,2882,1.0,0.05065926439972242,0.9493407356002775,159,0.6717557251908397,0.2730742539902845,0.05517002081887578
1045,019,3527,252,1195,661,3275,3527,1.0,0.07144882336263113,0.9285511766373689,1671,0.33881485681882617,0.1874113977884888,0.473773745392685
1046,019,2334,159,1737,547,2175,2334,1.0,0.06812339331619537,0.9318766066838047,50,0.7442159383033419,0.23436161096829478,0.021422450728363324
1047,019,6470,547,368,363,5923,6470,1.0,0.08454404945904173,0.9154559505409583,5739,0.05687789799072643,0.05610510046367852,0.887017001545595
1048,019,4491,117,38,66,4374,4491,1.0,0.026052104208416832,0.9739478957915831,4387,0.008461367178802049,0.014696058784235137,0.9768425740369628
1049,019,7992,416,633,117,7576,7992,1.0,0.05205205205205205,0.9479479479479479,7242,0.07920420420420421,0.01463963963963964,0.9061561561561562
1050,019,4694,331,2127,1500,4363,4694,1.0,0.07051555176821474,0.9294844482317852,1067,0.4531316574350234,0.3195568811248402,0.22731146144013634
1051,019,3099,132,1690,1408,2967,3099,1.0237937871777925,0.04259438528557599,0.957405614714424,1,0.5453372055501775,0.4543401097128106,0.00032268473701193933
1052,019,4211,309,373,16,3902,4211,1.0,0.07337924483495607,0.9266207551650439,3822,0.08857753502730943,0.00379957254808834,0.9076228924246023
1053,019,4233,299,786,1095,3934,4233,1.0,0.07063548310890622,0.9293645168910938,2352,0.1856839121190645,0.258681785967399,0.5556343019135365
1054,019,1006,0,499,507,1006,1006,20.958333333333332,0.0,1.0,0,0.4960238568588469,0.5039761431411531,0.0
1055,019,2287,130,374,525,2157,2287,1.0,0.05684302579798863,0.9431569742020114,1388,0.1635330126803673,0.22955837341495408,0.6069086139046787
1056,019,3782,70,2135,1476,3712,3782,1.0,0.01850872554204125,0.9814912744579588,171,0.5645161290322581,0.390269698572184,0.0452141723955579
1057,019,5319,118,1837,1833,5201,5319,1.0,0.022184621169392744,0.9778153788306072,1649,0.3453656702387667,0.34461364918217713,0.31002068057905624
1058,019,3114,136,590,307,2978,3114,1.0,0.04367373153500321,0.9563262684649968,2217,0.1894669235709698,0.09858702633269108,0.7119460500963392
1059,019,8402,324,1494,2580,8078,8402,1.0,0.03856224708402761,0.9614377529159723,4328,0.17781480599857177,0.3070697452987384,0.5151154487026899
1060,019,3441,135,2125,936,3306,3441,1.0,0.03923278116826504,0.960767218831735,380,0.6175530369078757,0.27201394943330426,0.1104330136588201
1061,019,2884,170,1532,921,2714,2884,1.0,0.05894590846047157,0.9410540915395285,431,0.5312066574202496,0.3193481276005548,0.14944521497919555
1062,019,1234,24,769,464,1210,1234,1.6550335570469799,0.019448946515397084,0.9805510534846029,1,0.6231766612641815,0.3760129659643436,0.0008103727714748784
1063,019,8696,481,318,238,8215,8696,1.0,0.05531278748850046,0.9446872125114996,8140,0.036568537258509656,0.027368905243790247,0.9360625574977001
1064,019,2837,230,1620,1216,2607,2837,1.396356474643033,0.08107155445893549,0.9189284455410645,1,0.5710257314064152,0.4286217835741981,0.00035248501938667606
1065,019,4376,240,1603,1033,4136,4376,1.0,0.054844606946983544,0.9451553930530164,1740,0.3663162705667276,0.23606032906764168,0.3976234003656307
1066,019,4135,106,1218,1158,4029,4135,1.0,0.025634824667472793,0.9743651753325272,1759,0.29455864570737605,0.2800483675937122,0.42539298669891173
1067,019,3757,126,745,77,3631,3757,1.0,0.03353739685919617,0.9664626031408038,2935,0.19829651317540592,0.020495075858397657,0.7812084109661964
1068,019,9000,689,1509,1463,8311,9000,1.0,0.07655555555555556,0.9234444444444444,6028,0.16766666666666666,0.16255555555555556,0.6697777777777778
1069,019,8586,327,1936,2131,8259,8586,1.0,0.038085255066387144,0.9619147449336128,4519,0.22548334498020034,0.24819473561611927,0.5263219194036804
1070,019,3812,740,1923,1888,3072,3812,1.5093069306930693,0.19412381951731375,0.8058761804826863,1,0.5044596012591815,0.49527806925498424,0.00026232948583420777
1071,019,3296,111,903,494,3185,3296,1.0,0.033677184466019416,0.9663228155339806,1899,0.27396844660194175,0.14987864077669902,0.5761529126213593
1072,019,2243,106,1606,389,2137,2243,1.0,0.047258136424431565,0.9527418635755684,248,0.7160053499777084,0.1734284440481498,0.11056620597414177
1073,019,1954,38,1585,368,1916,1954,1.9569138276553106,0.019447287615148412,0.9805527123848515,1,0.8111566018423746,0.18833162743091095,0.0005117707267144319
1074,019,5340,621,1445,499,4719,5340,1.0,0.11629213483146067,0.8837078651685393,3396,0.2705992509363296,0.09344569288389513,0.6359550561797753
1075,019,5671,257,2949,793,5414,5671,1.0,0.04531828601657556,0.9546817139834244,1929,0.5200141068594604,0.13983424440134015,0.34015164873919945
1076,019,2117,58,1467,649,2059,2117,1.1671263099834528,0.0273972602739726,0.9726027397260274,1,0.6929617383089277,0.30656589513462446,0.0004723665564478035
1077,019,3940,249,1051,255,3691,3940,1.0,0.06319796954314721,0.9368020304568528,2634,0.266751269035533,0.06472081218274112,0.6685279187817259
1078,019,3362,193,8,3,3169,3362,1.0,0.057406305770374776,0.9425936942296252,3351,0.002379535990481856,0.000892325996430696,0.9967281380130875
1079,019,3821,283,1094,553,3538,3821,1.0,0.0740643810520806,0.9259356189479194,2174,0.28631248364302536,0.14472651138445433,0.5689610049725203
1080,019,10586,562,1124,240,10024,10586,1.0,0.053088985452484416,0.9469110145475156,9222,0.10617797090496883,0.022671452862270923,0.8711505762327603
1081,019,8436,366,2332,687,8070,8436,1.0,0.04338549075391181,0.9566145092460882,5417,0.27643432906590804,0.0814366998577525,0.6421289710763395
1082,019,2603,79,1410,1192,2524,2603,1.4057266342517558,0.03034959661928544,0.9696504033807145,1,0.5416826738378794,0.45793315405301577,0.000384172109104879
1083,019,2441,46,1427,481,2395,2441,1.0,0.018844735764031135,0.9811552642359689,533,0.5845964768537485,0.19705038918476034,0.2183531339614912
1084,019,7312,313,2016,2597,6999,7312,1.0,0.042806345733041574,0.9571936542669585,2699,0.27571115973741794,0.3551695842450766,0.36911925601750545
1085,019,4924,276,2453,1123,4648,4924,1.0,0.056051990251827784,0.9439480097481722,1348,0.4981722177091795,0.22806661251015434,0.2737611697806661
1086,019,3014,186,1593,948,2828,3014,1.0,0.0617120106171201,0.9382879893828799,473,0.5285335102853351,0.31453218314532183,0.15693430656934307
1087,019,2684,164,112,8,2520,2684,1.0,0.06110283159463487,0.9388971684053651,2564,0.041728763040238454,0.0029806259314456036,0.9552906110283159
1088,019,3376,16,1596,1779,3360,3376,1.596499526963103,0.004739336492890996,0.995260663507109,1,0.4727488151658768,0.5269549763033176,0.0002962085308056872
1089,019,10424,221,1852,1706,10203,10424,1.0,0.021201074443591712,0.9787989255564082,6866,0.17766692248656946,0.16366078280890253,0.658672294704528
1090,019,1735,49,794,753,1686,1735,1.0,0.02824207492795389,0.9717579250720461,188,0.45763688760806914,0.4340057636887608,0.10835734870317003
1091,019,3424,290,811,277,3134,3424,1.0,0.084696261682243,0.915303738317757,2336,0.236857476635514,0.08089953271028037,0.6822429906542056
1092,019,623,0,278,345,623,623,29.666666666666668,0.0,1.0,0,0.4462279293739968,0.5537720706260032,0.0
1093,019,5029,359,1577,686,4670,5029,1.0,0.07138596142374229,0.9286140385762577,2766,0.31358122887253925,0.1364088287930006,0.5500099423344601
1094,019,5008,327,1610,520,4681,5008,1.0,0.06529552715654952,0.9347044728434505,2878,0.3214856230031949,0.10383386581469649,0.5746805111821086
1095,019,3193,100,1236,388,3093,3193,1.0,0.03131850923896023,0.9686814907610398,1569,0.3870967741935484,0.12151581584716567,0.4913874099592859
1096,019,6423,181,2035,1938,6242,6423,1.0,0.028179978203331776,0.9718200217966683,2450,0.31683014167834345,0.3017281644091546,0.38144169391250193
1097,019,3043,121,989,1045,2922,3043,1.0,0.039763391390075585,0.9602366086099244,1009,0.3250082155767335,0.3434111074597437,0.33158067696352284
1098,019,2645,2630,1289,1355,15,2645,7.447887323943662,0.994328922495274,0.005671077504725898,1,0.4873345935727788,0.5122873345935728,0.0003780718336483932
1099,019,6557,302,555,578,6255,6557,1.0,0.0460576483147781,0.9539423516852219,5424,0.08464236693609882,0.08815006862894617,0.827207564434955
1100,019,3394,97,1472,572,3297,3394,1.0,0.028579846788450207,0.9714201532115498,1350,0.4337065409546258,0.16853270477312904,0.39776075427224517
1101,019,2851,17,972,1454,2834,2851,1.0,0.005962820063135742,0.9940371799368642,425,0.34093300596282006,0.5099964924587864,0.14907050157839355
1102,019,4436,220,1079,931,4216,4436,1.0,0.04959422903516682,0.9504057709648331,2426,0.24323715058611362,0.2098737601442741,0.5468890892696122
1103,019,3227,3146,2683,543,81,3227,3.4913419913419914,0.9748992872637124,0.025100712736287573,1,0.831422373721723,0.16826774093585373,0.0003098853424233034
1104,019,2633,50,54,55,2583,2633,1.0,0.0189897455374098,0.9810102544625902,2524,0.020508925180402583,0.020888720091150777,0.9586023547284467
1105,019,2270,43,1571,699,2227,2270,1.0,0.01894273127753304,0.981057268722467,0,0.6920704845814978,0.3079295154185022,0.0
1106,019,3993,113,1274,273,3880,3993,1.0,0.028299524167292762,0.9717004758327072,2446,0.31905835211620337,0.06836964688204357,0.612572001001753
1107,019,3371,124,124,16,3247,3371,1.0,0.036784336991990504,0.9632156630080095,3231,0.036784336991990504,0.004746366063482646,0.9584692969445269
1108,019,1368,45,145,5,1323,1368,1.0,0.03289473684210526,0.9671052631578947,1218,0.10599415204678363,0.003654970760233918,0.8903508771929824
1109,019,4813,321,2297,2515,4492,4813,1.741585233441911,0.06669436941616455,0.9333056305838354,1,0.4772491169748598,0.522543112403906,0.00020777062123415748
1110,019,2167,73,699,1195,2094,2167,1.0,0.03368712505768343,0.9663128749423165,273,0.32256575911398244,0.5514536225196124,0.12598061836640517
1111,019,6324,85,1040,219,6239,6324,1.0,0.013440860215053764,0.9865591397849462,5065,0.1644528779253637,0.03462998102466793,0.8009171410499684
1112,019,3322,119,1687,1634,3203,3322,1.5606203007518797,0.0358217940999398,0.9641782059000602,1,0.5078266104756171,0.4918723660445515,0.00030102347983142685
1113,019,5227,305,1340,683,4922,5227,1.0,0.05835087048019897,0.9416491295198011,3204,0.2563612014539889,0.13066768700975703,0.612971111536254
1114,019,1647,47,1348,298,1600,1647,1.6042884990253412,0.02853673345476624,0.9714632665452337,1,0.8184578020643595,0.1809350333940498,0.0006071645415907711
1115,019,3275,43,659,750,3232,3275,1.0,0.013129770992366412,0.9868702290076335,1866,0.20122137404580154,0.22900763358778625,0.5697709923664123
1116,019,4141,119,394,135,4022,4141,1.0,0.028737020043467763,0.9712629799565322,3612,0.09514609997585124,0.03260082105771553,0.8722530789664332
1117,019,3110,74,2008,1101,3036,3110,1.5733805668016194,0.023794212218649517,0.9762057877813505,1,0.6456591639871383,0.3540192926045016,0.0003215434083601286
1118,019,4924,316,585,1061,4608,4924,1.0,0.06417546709991877,0.9358245329000813,3278,0.11880584890333062,0.2154752233956133,0.665718927701056
1119,019,3420,107,1945,1255,3313,3420,1.0,0.03128654970760234,0.9687134502923976,220,0.5687134502923976,0.3669590643274854,0.06432748538011696
1120,019,2885,164,2118,377,2721,2885,1.0,0.05684575389948007,0.9431542461005199,390,0.7341421143847487,0.13067590987868286,0.13518197573656845
1121,019,3276,134,2275,782,3142,3276,1.0,0.040903540903540904,0.9590964590964591,219,0.6944444444444444,0.23870573870573872,0.06684981684981685
1122,019,1623,44,689,466,1579,1623,1.0,0.027110289587184228,0.9728897104128158,468,0.42452248921749847,0.2871226124460875,0.28835489833641403
1123,019,2909,99,1033,367,2810,2909,1.0,0.03403231350979718,0.9659676864902028,1509,0.35510484702646955,0.12616019250601582,0.5187349604675147
1124,019,2530,178,1857,462,2352,2530,1.0,0.07035573122529644,0.9296442687747035,211,0.7339920948616601,0.1826086956521739,0.08339920948616601
1125,019,5738,344,438,417,5394,5738,1.0,0.05995120250958522,0.9400487974904148,4883,0.07633321714883234,0.07267340536772394,0.8509933774834437
1126,019,3052,52,2287,764,3000,3052,1.1171731966312706,0.01703800786369594,0.9829619921363041,1,0.7493446920052425,0.2503276539973788,0.000327653997378768
1127,019,3987,156,2060,551,3831,3987,1.0,0.03912716328066215,0.9608728367193379,1376,0.5166792074241284,0.1381991472284926,0.345121645347379
1128,019,2659,141,0,0,2518,2659,1.0,0.05302745393004889,0.9469725460699511,2659,0.0,0.0,1.0
1129,019,3978,307,2214,1233,3671,3978,1.0,0.07717445952740071,0.9228255404725993,531,0.5565610859728507,0.30995475113122173,0.1334841628959276
1130,019,2841,120,2008,832,2721,2841,1.780564263322884,0.042238648363252376,0.9577613516367476,1,0.7067933826117564,0.29285462865188316,0.00035198873636043646
1131,019,4490,144,998,204,4346,4490,1.0,0.032071269487750555,0.9679287305122495,3288,0.222271714922049,0.04543429844097996,0.7322939866369711
1132,019,2963,173,798,1089,2790,2963,1.0,0.058386770165372935,0.941613229834627,1076,0.2693216334795815,0.36753290583867704,0.36314546068174147
1133,019,2919,48,1470,1448,2871,2919,2.0534834623504574,0.01644398766700925,0.9835560123329907,1,0.5035971223021583,0.4960602946214457,0.00034258307639602604
1134,019,5174,256,496,270,4918,5174,1.0,0.04947816003092385,0.9505218399690761,4408,0.09586393505991496,0.052183996907615,0.85195206803247
1135,019,6057,235,615,1400,5822,6057,1.0,0.038798084860491994,0.961201915139508,4042,0.10153541357107479,0.23113752682846295,0.6673270596004622
1136,019,5785,154,1258,528,5631,5785,1.0,0.02662057044079516,0.9733794295592049,3999,0.2174589455488332,0.0912705272255834,0.6912705272255834
1137,019,2230,1951,821,727,279,2230,1.0,0.8748878923766816,0.1251121076233184,682,0.3681614349775785,0.32600896860986545,0.305829596412556
1138,019,2677,98,265,16,2579,2677,1.0,0.036608143444153904,0.9633918565558461,2396,0.09899140829286515,0.005976839745984311,0.8950317519611506
1139,019,3412,65,199,153,3347,3412,1.0,0.019050410316529893,0.9809495896834701,3060,0.058323563892145366,0.04484173505275498,0.8968347010550997
1140,019,4815,203,1980,1728,4612,4815,1.0,0.042159916926272065,0.9578400830737279,1107,0.411214953271028,0.35887850467289717,0.22990654205607478
1141,019,3933,126,1658,1518,3807,3933,1.0,0.032036613272311214,0.9679633867276888,757,0.42156114924993643,0.38596491228070173,0.1924739384693618
1142,019,5229,103,762,1277,5126,5229,1.0,0.01969783897494741,0.9803021610250526,3190,0.1457257601835915,0.24421495505832855,0.6100592847580799
1143,019,6181,214,1057,1150,5967,6181,1.0,0.034622229412716386,0.9653777705872836,3974,0.1710079275198188,0.18605403656366284,0.6429380359165183
1144,019,3271,165,1127,1232,3106,3271,1.0,0.05044328951391012,0.9495567104860899,912,0.34454295322531336,0.3766432283705289,0.27881381840415775
1145,019,3529,98,1451,1439,3431,3529,1.0,0.027769906489090394,0.9722300935109096,639,0.41116463587418534,0.4077642391612355,0.1810711249645792
1146,019,3214,122,1628,1530,3092,3214,1.0,0.037958929682638455,0.9620410703173615,56,0.5065339141257,0.4760423148724331,0.017423771001866834
1147,019,4144,135,1569,1586,4009,4144,1.0,0.032577220077220075,0.9674227799227799,989,0.3786196911196911,0.3827220077220077,0.23865830115830117
1148,019,2205,36,870,479,2169,2205,1.0,0.0163265306122449,0.9836734693877551,856,0.3945578231292517,0.21723356009070294,0.38820861678004537
1149,019,3213,129,1592,1340,3084,3213,1.0,0.040149393090569564,0.9598506069094305,281,0.4954870837223778,0.4170557111733582,0.08745720510426393
1150,019,6944,314,2345,1531,6630,6944,1.0,0.04521889400921659,0.9547811059907834,3068,0.3377016129032258,0.22047811059907835,0.44182027649769584
1151,019,2765,103,1131,1633,2662,2765,1.2339285714285715,0.03725135623869801,0.962748643761302,1,0.40904159132007234,0.5905967450271248,0.0003616636528028933
1152,019,2213,27,1607,309,2186,2213,1.0,0.012200632625395391,0.9877993673746046,297,0.7261635788522368,0.1396294622684139,0.1342069588793493
1153,019,2710,73,1080,1629,2637,2710,1.506674082313682,0.026937269372693726,0.9730627306273063,1,0.3985239852398524,0.6011070110701107,0.00036900369003690036
1154,019,9262,169,1531,1122,9093,9262,1.0,0.01824659900669402,0.981753400993306,6609,0.16529907147484343,0.12114014251781473,0.7135607860073419
1155,019,5063,153,2327,2735,4910,5063,1.8630842841369157,0.030219237606162356,0.9697807623938376,1,0.45960892751333204,0.5401935611297649,0.00019751135690302193
1156,019,3287,100,736,897,3187,3287,1.0,0.030422878004259205,0.9695771219957408,1654,0.22391238211134773,0.27289321569820507,0.5031944021904472
1157,019,5165,182,1365,274,4983,5165,1.0,0.035237173281703775,0.9647628267182963,3526,0.26427879961277834,0.05304937076476283,0.6826718296224589
1158,019,2261,45,465,550,2216,2261,1.0,0.019902697921273773,0.9800973020787263,1246,0.20566121185316233,0.24325519681556834,0.5510835913312694
1159,019,3804,134,1723,632,3670,3804,1.0,0.035226077812828605,0.9647739221871714,1449,0.452944269190326,0.1661409043112513,0.38091482649842273
1160,019,5321,195,1068,1057,5126,5321,1.0,0.03664724675812817,0.9633527532418719,3196,0.2007141514752866,0.19864687088893065,0.6006389776357828
1161,019,2786,89,1373,1067,2697,2786,1.0,0.03194544149318019,0.9680545585068198,346,0.4928212491026561,0.38298636037329503,0.12419239052404882
1162,019,2996,2986,2086,909,10,2996,9.538216560509554,0.9966622162883845,0.0033377837116154874,1,0.6962616822429907,0.30340453938584777,0.0003337783711615487
1163,019,311,304,187,4,7,311,1.0,0.977491961414791,0.022508038585209004,120,0.6012861736334405,0.012861736334405145,0.3858520900321543
1164,019,1160,1121,933,226,39,1160,4.849372384937238,0.9663793103448276,0.03362068965517241,1,0.8043103448275862,0.19482758620689655,0.0008620689655172414
1165,019,3948,3858,2128,1819,90,3948,4.495444191343964,0.9772036474164134,0.022796352583586626,1,0.5390070921985816,0.46073961499493415,0.00025329280648429586
1166,019,1358,58,1011,346,1300,1358,1.7949735449735449,0.042709867452135494,0.9572901325478645,1,0.7444771723122239,0.2547864506627393,0.0007363770250368188
1167,019,2682,88,1463,1218,2594,2682,2.7190669371196754,0.03281133482475764,0.9671886651752424,1,0.5454884414615958,0.4541387024608501,0.0003728560775540641
1168,019,5586,59,625,683,5527,5586,1.0,0.010562119584675976,0.989437880415324,4278,0.11188686000716076,0.12226996061582528,0.765843179377014
1169,019,3830,121,1115,729,3709,3830,1.0,0.03159268929503917,0.9684073107049609,1986,0.29112271540469975,0.19033942558746736,0.5185378590078329
1170,019,1316,99,752,550,1217,1316,1.0,0.07522796352583587,0.9247720364741642,14,0.5714285714285714,0.41793313069908816,0.010638297872340425
1171,019,3089,182,1176,689,2907,3089,1.0,0.05891874393007446,0.9410812560699255,1224,0.38070573000971186,0.22304953059242474,0.39624473939786337
1172,019,6433,61,1002,821,6372,6433,1.0,0.009482356598787501,0.9905176434012125,4610,0.15575936577024715,0.12762319291154983,0.716617441318203
1173,019,4494,146,1481,614,4348,4494,1.0,0.032487761459724075,0.9675122385402759,2399,0.3295505117935024,0.13662661326212727,0.5338228749443703
1174,019,3466,113,1141,1317,3353,3466,1.0,0.032602423542989034,0.967397576457011,1008,0.32919792267743797,0.37997691863819966,0.2908251586843624
1175,019,2840,69,1148,122,2771,2840,1.0,0.024295774647887323,0.9757042253521127,1570,0.4042253521126761,0.04295774647887324,0.5528169014084507
1176,019,3167,81,1221,607,3086,3167,1.0,0.02557625513103884,0.9744237448689612,1339,0.38553836438269656,0.19166403536469845,0.422797600252605
1177,019,2000,81,1134,865,1919,2000,1.5484120836560806,0.0405,0.9595,1,0.567,0.4325,0.0005
1178,019,928,14,369,442,914,928,1.0,0.015086206896551725,0.9849137931034483,117,0.39762931034482757,0.47629310344827586,0.12607758620689655
1179,019,2203,136,1391,811,2067,2203,1.628698224852071,0.06173399909214707,0.938266000907853,1,0.631411711302769,0.3681343622333182,0.00045392646391284613
1180,019,4524,155,828,513,4369,4524,1.0,0.03426171529619806,0.965738284703802,3183,0.1830238726790451,0.11339522546419098,0.7035809018567639
1181,019,4555,332,206,265,4223,4555,1.0,0.07288693743139407,0.9271130625686059,4084,0.04522502744237102,0.05817782656421515,0.8965971459934138
1182,019,3324,120,10,10,3204,3324,1.0,0.036101083032490974,0.9638989169675091,3304,0.0030084235860409147,0.0030084235860409147,0.9939831528279182
1183,019,3238,108,1516,1721,3130,3238,1.152367390530438,0.033353922174181594,0.9666460778258185,1,0.46819024088943795,0.5315009264978382,0.00030883261272390367
1184,019,5007,329,1993,2106,4678,5007,1.0,0.06570800878769723,0.9342919912123028,908,0.3980427401637707,0.42061114439784303,0.18134611543838625
1185,019,2158,39,1187,822,2119,2158,1.0,0.018072289156626505,0.9819277108433735,149,0.5500463392029658,0.3809082483781279,0.0690454124189064
1186,019,7759,378,2776,1371,7381,7759,1.0,0.048717618249774455,0.9512823817502255,3612,0.3577780641835288,0.17669802809640417,0.465523907720067
1187,019,2963,204,790,347,2759,2963,1.0,0.06884913938575768,0.9311508606142423,1826,0.26662166722915964,0.1171110361120486,0.6162672966587918
1188,019,1555,44,974,580,1511,1555,1.895121951219512,0.02829581993569132,0.9717041800643087,1,0.6263665594855305,0.3729903536977492,0.0006430868167202572
1189,019,2140,37,268,211,2103,2140,1.0,0.017289719626168223,0.9827102803738318,1661,0.1252336448598131,0.0985981308411215,0.7761682242990654
1190,019,2752,22,808,1943,2730,2752,1.201834862385321,0.007994186046511628,0.9920058139534884,1,0.2936046511627907,0.706031976744186,0.0003633720930232558
1191,019,3253,111,589,650,3142,3253,1.0,0.03412234860129112,0.9658776513987088,2014,0.18106363356901323,0.19981555487242544,0.6191208115585614
1192,019,4971,317,3272,1698,4654,4971,12.646310432569974,0.06376986521826594,0.936230134781734,1,0.6582176624421645,0.3415811707905854,0.0002011667672500503
1193,019,5264,306,1935,886,4958,5264,1.0,0.058130699088145894,0.9418693009118541,2443,0.36759118541033436,0.1683130699088146,0.4640957446808511
1194,019,2383,113,1724,658,2270,2383,1.0374564459930313,0.04741921947125472,0.9525807805287453,1,0.7234578262694084,0.2761225346202266,0.000419639110365086
1195,019,1637,70,1354,282,1567,1637,1.4140017286084703,0.04276114844227245,0.9572388515577276,1,0.8271227855833843,0.17226634086744044,0.0006108735491753207
1196,019,4098,66,814,70,4032,4098,1.0,0.016105417276720352,0.9838945827232797,3214,0.19863347974621767,0.01708150317227916,0.7842850170815032
1197,019,3059,68,1772,1098,2991,3059,1.0,0.022229486760379207,0.9777705132396208,189,0.579274272638117,0.35894083033671137,0.06178489702517163
1198,019,3146,47,1683,954,3099,3146,1.0,0.014939605848696759,0.9850603941513032,509,0.534965034965035,0.30324221233312143,0.16179275270184362
1199,019,4019,59,1028,2360,3960,4019,1.0,0.014680268723563076,0.9853197312764369,631,0.25578502114953966,0.587210748942523,0.1570042299079373
1200,019,3208,64,693,599,3144,3208,1.0,0.0199501246882793,0.9800498753117207,1916,0.2160224438902743,0.1867206982543641,0.5972568578553616
1201,019,4820,147,2342,1845,4673,4820,1.0,0.03049792531120332,0.9695020746887967,633,0.4858921161825726,0.38278008298755184,0.13132780082987552
1202,019,4651,232,263,67,4419,4651,1.0,0.04988174586110514,0.9501182541388948,4321,0.05654697914427005,0.014405504192646742,0.9290475166630832
1203,019,2143,84,306,246,2059,2143,1.0,0.03919738684087728,0.9608026131591227,1591,0.14279048063462435,0.11479234717685488,0.7424171721885208
1204,019,5215,208,620,501,5007,5215,1.0,0.039884947267497604,0.9601150527325024,4094,0.11888782358581017,0.09606903163950144,0.7850431447746884
1205,019,3071,86,160,243,2985,3071,1.0,0.02800390752197981,0.9719960924780202,2668,0.052100293064148484,0.07912732009117551,0.868772386844676
1206,019,3576,58,1666,941,3518,3576,1.0,0.01621923937360179,0.9837807606263982,969,0.4658836689038031,0.26314317673378074,0.2709731543624161
1207,019,4155,127,1603,430,4028,4155,1.0,0.03056558363417569,0.9694344163658243,2122,0.3858002406738869,0.10348977135980746,0.5107099879663056
1208,019,3929,71,543,708,3858,3929,1.0,0.01807075591753627,0.9819292440824637,2678,0.13820310511580555,0.18019852379740392,0.6815983710867906
1209,019,4401,136,1555,363,4265,4401,1.0,0.03090206771188366,0.9690979322881164,2483,0.353328788911611,0.08248125426039536,0.5641899568279937
1210,019,2967,105,1669,512,2862,2967,1.0,0.03538928210313448,0.9646107178968655,786,0.5625210650488709,0.17256488035052242,0.2649140546006067
1211,019,3263,66,577,651,3197,3263,1.0,0.02022678516702421,0.9797732148329757,2035,0.17683113699049954,0.19950965369292062,0.6236592093165798
1212,019,2665,95,1386,1278,2570,2665,1.1725352112676057,0.03564727954971857,0.9643527204502814,1,0.5200750469043152,0.47954971857410883,0.000375234521575985
1213,019,2513,17,1479,1033,2496,2513,8.345514950166113,0.006764822920811779,0.9932351770791882,1,0.5885395941106247,0.4110624751293275,0.0003979307600477517
1214,019,3913,75,1560,626,3838,3913,1.0,0.01916687963199591,0.9808331203680041,1727,0.39867109634551495,0.15997955532839253,0.4413493483260925
1215,019,3238,122,1395,1287,3116,3238,1.0,0.03767757875231625,0.9623224212476837,556,0.4308214947498456,0.397467572575664,0.17171093267449042
1216,019,2358,108,1518,306,2250,2358,1.0,0.04580152671755725,0.9541984732824428,534,0.6437659033078881,0.1297709923664122,0.22646310432569974
1217,019,2812,231,1389,177,2581,2812,1.0,0.0821479374110953,0.9178520625889047,1246,0.49395448079658605,0.06294452347083926,0.44310099573257467
1218,019,1847,63,900,946,1784,1847,1.3504023408924652,0.03410936654033568,0.9658906334596643,1,0.48727666486193827,0.5121819166215484,0.0005414185165132648
1219,019,3742,108,1292,1550,3634,3742,1.0,0.028861571352218066,0.9711384286477819,900,0.3452699091394976,0.4142169962586852,0.24051309460181722
1220,019,2039,26,1116,390,2013,2039,1.0,0.012751348700343305,0.9872486512996567,533,0.5473271211378127,0.19127023050514957,0.26140264835703775
1221,019,3544,68,720,724,3476,3544,1.0,0.019187358916478554,0.9808126410835214,2100,0.20316027088036118,0.20428893905191872,0.59255079006772
1222,019,2126,63,84,364,2063,2126,1.0,0.029633113828786452,0.9703668861712136,1678,0.03951081843838194,0.17121354656632173,0.7892756349952963
1223,019,2214,332,1769,444,1882,2214,36.88333333333333,0.14995483288166214,0.8500451671183379,1,0.7990063233965673,0.2005420054200542,0.00045167118337850043
1224,019,2927,94,801,813,2833,2927,1.0,0.03211479330372395,0.9678852066962761,1313,0.2736590365562009,0.2777587974034848,0.4485821660403143
1225,019,2282,76,579,701,2206,2282,1.0,0.033304119193689745,0.9666958808063103,1002,0.2537248028045574,0.30718667835232255,0.43908851884312006
1226,019,2782,68,1208,764,2714,2782,1.0,0.024442846872753415,0.9755571531272466,810,0.43421998562185476,0.27462257368799425,0.291157440690151
1227,019,7301,243,3334,3966,7058,7301,4.486785494775661,0.03328311190247911,0.9667168880975209,1,0.45664977400356116,0.5432132584577455,0.00013696753869332968
1228,019,3794,113,301,466,3681,3794,1.0,0.0297838692672641,0.9702161307327359,3027,0.07933579335793357,0.12282551396942541,0.797838692672641
1229,019,3632,90,1149,917,3542,3632,1.0,0.02477973568281938,0.9752202643171806,1566,0.3163546255506608,0.25247797356828194,0.43116740088105726
1230,019,2892,159,1827,1064,2733,2892,1.2596949891067537,0.054979253112033194,0.9450207468879668,1,0.6317427385892116,0.367911479944675,0.00034578146611341634
1231,019,1958,49,976,981,1909,1958,3.21875,0.02502553626149132,0.9749744637385087,1,0.49846782431052095,0.5010214504596527,0.0005107252298263534
1232,019,3305,27,997,421,3278,3305,1.0,0.008169440242057489,0.9918305597579425,1887,0.3016641452344932,0.12738275340393343,0.5709531013615734
1233,019,1440,80,598,841,1360,1440,2.3247172859450727,0.05555555555555555,0.9444444444444444,1,0.4152777777777778,0.5840277777777778,0.0006944444444444445
1234,019,3569,41,1324,275,3528,3569,1.0,0.011487811711964136,0.9885121882880359,1970,0.37097226113757353,0.07705239562902774,0.5519753432333987
1235,019,2175,148,761,186,2027,2175,1.0,0.06804597701149426,0.9319540229885057,1228,0.34988505747126436,0.08551724137931034,0.5645977011494253
1236,019,3493,78,1155,706,3415,3493,1.0,0.022330375035785856,0.9776696249642142,1632,0.3306613226452906,0.20211852275980532,0.46722015459490407
1237,019,2321,39,1674,477,2282,2321,1.0,0.01680310211115898,0.983196897888841,170,0.7212408444635933,0.2055148642826368,0.07324429125376992
1238,019,2501,51,1530,970,2450,2501,1.112099644128114,0.02039184326269492,0.9796081567373051,1,0.6117552978808477,0.38784486205517793,0.00039984006397441024
1239,019,3254,73,1315,1938,3181,3254,2.0129950495049505,0.022433927473878304,0.9775660725261217,1,0.4041180086047941,0.5955746773202213,0.00030731407498463427
1240,019,2993,34,1701,1291,2959,2993,6.678571428571429,0.011359839625793518,0.9886401603742064,1,0.5683260942198463,0.4313397928499833,0.0003341129301703976
1241,019,3598,78,1287,1295,3520,3598,1.0,0.0216787103946637,0.9783212896053363,1016,0.3576987215119511,0.35992217898832685,0.28237909949972206
1242,019,1929,66,1006,922,1863,1929,1.0332261521972133,0.03421461897356143,0.9657853810264385,1,0.5215137376879212,0.47796785899429756,0.0005184033177812338
1243,019,2572,48,1134,767,2524,2572,1.0,0.01866251944012442,0.9813374805598756,671,0.44090202177293936,0.29821150855365475,0.2608864696734059
1244,019,6964,180,1576,1600,6784,6964,1.0,0.025847214244686962,0.974152785755313,3788,0.22630672027570362,0.22975301550832855,0.5439402642159679
1245,019,5235,121,1286,1350,5114,5235,1.0,0.02311365807067813,0.9768863419293219,2599,0.24565425023877746,0.25787965616045844,0.4964660936007641
1246,019,3348,118,1107,1126,3230,3348,1.0,0.03524492234169654,0.9647550776583035,1115,0.33064516129032256,0.3363201911589008,0.3330346475507766
1247,019,3304,64,701,747,3240,3304,1.0,0.01937046004842615,0.9806295399515739,1856,0.21216707021791767,0.22608958837772397,0.5617433414043583
1248,019,2766,120,1594,272,2646,2766,1.0,0.04338394793926247,0.9566160520607375,900,0.5762834417932032,0.09833694866232827,0.32537960954446854
1249,019,2553,113,1082,608,2440,2553,1.0,0.04426165295730513,0.9557383470426949,863,0.4238151194672934,0.2381511946729338,0.33803368585977284
1250,019,2924,133,2261,662,2791,2924,1.8641581632653061,0.045485636114911084,0.9545143638850889,1,0.7732558139534884,0.22640218878248974,0.0003419972640218878
1251,019,5676,163,1030,754,5513,5676,1.0,0.02871740662438337,0.9712825933756166,3892,0.1814658210007047,0.1328400281888654,0.6856941508104298
1252,019,6306,231,913,699,6075,6306,1.0,0.03663177925784967,0.9633682207421503,4694,0.14478274659054868,0.11084681255946717,0.7443704408499842
1253,019,2411,69,1479,931,2342,2411,2.2800378429517503,0.02861883036084612,0.9713811696391539,1,0.6134384072998755,0.38614682704272085,0.00041476565740356696
1254,019,6937,261,1464,1741,6676,6937,1.0,0.03762433328528182,0.9623756667147182,3732,0.2110422372783624,0.2509730431022056,0.5379847196194321
1255,019,2168,67,1486,681,2101,2168,1.7953603976801988,0.030904059040590407,0.9690959409594095,1,0.6854243542435424,0.31411439114391143,0.00046125461254612545
1256,019,5960,197,1147,225,5763,5960,1.0,0.03305369127516779,0.9669463087248322,4588,0.1924496644295302,0.037751677852348994,0.7697986577181208
1257,019,1239,35,559,670,1204,1239,1.0,0.02824858757062147,0.9717514124293786,10,0.45117029862792574,0.5407586763518967,0.008071025020177562
1258,019,10268,440,94,214,9828,10268,1.0,0.04285157771717959,0.9571484222828204,9960,0.009154655239579276,0.020841449162446436,0.9700038955979743
1259,019,2481,118,2033,447,2363,2481,1.007311129163282,0.0475614671503426,0.9524385328496574,1,0.8194276501410721,0.18016928657799275,0.00040306328093510683
1260,019,5310,331,775,1004,4979,5310,1.0,0.06233521657250471,0.9376647834274953,3531,0.14595103578154425,0.18907721280602638,0.6649717514124294
1261,019,3201,262,146,137,2939,3201,1.0,0.08184942205560762,0.9181505779443924,2918,0.04561074664167448,0.04279912527335208,0.9115901280849734
1262,019,3782,235,1601,976,3547,3782,1.0,0.06213643574828133,0.9378635642517187,1205,0.423320994182972,0.25806451612903225,0.31861448968799577
1263,019,2024,1206,1216,807,818,2024,1.2290400972053463,0.5958498023715415,0.4041501976284585,1,0.6007905138339921,0.3987154150197628,0.0004940711462450593
1264,019,4560,39,2379,2180,4521,4560,2.271549576482312,0.008552631578947369,0.9914473684210526,1,0.5217105263157895,0.4780701754385965,0.0002192982456140351
1265,019,3545,46,1845,706,3499,3545,1.0,0.012976022566995768,0.9870239774330042,994,0.5204513399153737,0.1991537376586742,0.28039492242595204
1266,019,4293,53,1908,748,4240,4293,1.0,0.012345679012345678,0.9876543209876543,1637,0.4444444444444444,0.17423713021197298,0.38131842534358257
1267,019,433,14,262,170,419,433,6.967741935483871,0.03233256351039261,0.9676674364896074,1,0.605080831408776,0.39260969976905313,0.0023094688221709007
1268,019,2938,63,1792,1145,2875,2938,1.420899854862119,0.021443158611300205,0.9785568413886998,1,0.6099387338325392,0.3897208985704561,0.0003403675970047651
1269,019,2621,82,760,728,2539,2621,1.0,0.03128576879053796,0.968714231209462,1133,0.28996566196108353,0.27775658145745896,0.43227775658145745
1270,019,2096,113,634,1040,1983,2096,1.0,0.053912213740458015,0.9460877862595419,422,0.30248091603053434,0.4961832061068702,0.2013358778625954
1271,019,1519,132,98,5,1387,1519,1.0,0.086899275839368,0.913100724160632,1416,0.06451612903225806,0.0032916392363396972,0.9321922317314022
1272,019,2446,107,790,1065,2339,2446,1.0,0.0437448896156991,0.9562551103843009,591,0.32297628781684384,0.43540474243663124,0.24161896974652494
1273,019,2676,186,761,356,2490,2676,1.0,0.06950672645739911,0.9304932735426009,1559,0.2843796711509716,0.13303437967115098,0.5825859491778774
1274,019,1664,158,937,726,1506,1664,2.8623063683304646,0.09495192307692307,0.9050480769230769,1,0.5631009615384616,0.4362980769230769,0.0006009615384615385
1275,019,2033,121,1647,385,1912,2033,1.6947456213511258,0.059517953762911954,0.9404820462370881,1,0.8101328086571569,0.18937530742744713,0.0004918839153959665
1276,019,2013,44,1468,188,1969,2013,1.0,0.02185792349726776,0.9781420765027322,357,0.7292598112270243,0.09339294585196224,0.17734724292101342
1277,021,1556,70,435,640,1486,1556,1.0,0.04498714652956298,0.9550128534704371,481,0.2795629820051414,0.41131105398457585,0.30912596401028275
1278,021,738,47,259,193,691,738,1.0,0.06368563685636856,0.9363143631436315,286,0.3509485094850949,0.26151761517615174,0.3875338753387534
1279,021,2531,96,674,883,2435,2531,1.0,0.03792967206637693,0.9620703279336231,974,0.2662979059660213,0.3488739628605294,0.3848281311734492
1280,021,1021,48,412,205,973,1021,1.0,0.04701273261508325,0.9529872673849168,404,0.40352595494613125,0.2007835455435847,0.395690499510284
1281,021,2988,67,1160,1449,2921,2988,1.0,0.02242302543507363,0.9775769745649264,379,0.38821954484605087,0.48493975903614456,0.12684069611780455
1282,021,3063,25,1208,1372,3038,3063,1.0,0.008161932745674175,0.9918380672543258,483,0.39438459027097617,0.44792686908259877,0.15768854064642507
1283,021,3147,179,633,1083,2968,3147,1.0,0.05687956784238958,0.9431204321576104,1431,0.2011439466158246,0.34413727359389895,0.4547187797902765
1284,021,3334,170,633,1188,3164,3334,1.0,0.05098980203959208,0.9490101979604079,1513,0.1898620275944811,0.35632873425314937,0.4538092381523695
1285,021,6398,140,72,165,6258,6398,1.0,0.02188183807439825,0.9781181619256017,6161,0.011253516723976243,0.025789309159112223,0.9629571741169115
1286,021,1586,127,436,162,1459,1586,1.0,0.08007566204287515,0.9199243379571248,988,0.27490542244640603,0.1021437578814628,0.6229508196721312
1287,021,3681,137,1014,1268,3544,3681,1.0,0.03721814724259712,0.9627818527574029,1399,0.2754686226568867,0.34447161097527845,0.38005976636783484
1288,021,1827,154,493,211,1673,1827,1.0,0.0842911877394636,0.9157088122605364,1123,0.2698412698412698,0.11548987411056376,0.6146688560481663
1289,021,3037,25,1106,1449,3012,3037,1.0,0.008231807704972012,0.991768192295028,482,0.3641751728679618,0.4771155745801778,0.15870925255186039
1290,021,2736,103,576,1290,2633,2736,1.0,0.03764619883040936,0.9623538011695907,870,0.21052631578947367,0.47149122807017546,0.31798245614035087
1291,021,2370,174,429,451,2196,2370,1.0,0.07341772151898734,0.9265822784810127,1490,0.1810126582278481,0.19029535864978903,0.6286919831223629
1292,021,4173,297,947,1283,3876,4173,1.0,0.07117181883537024,0.9288281811646297,1943,0.22693505871075964,0.3074526719386532,0.4656122693505871
1293,021,2578,188,585,623,2390,2578,1.0,0.07292474786656322,0.9270752521334368,1370,0.2269200930954228,0.24166020170674943,0.5314197051978278
1294,021,1471,66,173,413,1405,1471,1.0,0.04486743711760707,0.9551325628823929,885,0.11760707002039429,0.2807613868116927,0.601631543167913
1295,021,1270,60,265,569,1210,1270,1.0,0.047244094488188976,0.952755905511811,436,0.20866141732283464,0.44803149606299214,0.34330708661417325
1296,021,1225,61,194,459,1164,1225,1.0,0.04979591836734694,0.950204081632653,572,0.15836734693877552,0.3746938775510204,0.4669387755102041
1297,021,9160,629,531,939,8531,9160,1.0,0.06866812227074236,0.9313318777292576,7690,0.05796943231441048,0.10251091703056768,0.8395196506550219
1298,021,10438,681,439,698,9757,10438,1.0,0.06524238359839049,0.9347576164016095,9301,0.04205786549147346,0.0668710480935045,0.8910710864150221
1299,021,1891,57,292,1033,1834,1891,1.0,0.030142781597038603,0.9698572184029614,566,0.15441565309360128,0.5462718138551031,0.2993125330512956
1300,021,4300,82,1025,1682,4218,4300,1.0,0.019069767441860466,0.9809302325581395,1593,0.23837209302325582,0.3911627906976744,0.37046511627906975
1301,021,9216,266,2228,3820,8950,9216,1.0,0.028862847222222224,0.9711371527777778,3168,0.2417534722222222,0.4144965277777778,0.34375
1302,021,7501,186,2041,3460,7315,7501,1.0,0.024796693774163443,0.9752033062258365,2000,0.2720970537261698,0.46127183042261033,0.26663111585121985
1303,021,2244,2120,507,68,124,2244,1.0,0.9447415329768271,0.05525846702317291,1669,0.22593582887700533,0.030303030303030304,0.7437611408199644
1304,021,5246,302,1541,1514,4944,5246,1.0,0.05756767060617613,0.9424323293938238,2191,0.2937476172321769,0.2886008387342737,0.41765154403354937
1305,021,833,56,125,187,777,833,1.0,0.06722689075630252,0.9327731092436975,521,0.15006002400960383,0.22448979591836735,0.6254501800720288
1306,021,2870,217,676,673,2653,2870,1.0,0.07560975609756097,0.9243902439024391,1521,0.23554006968641114,0.23449477351916376,0.5299651567944251
1307,021,2632,222,689,723,2410,2632,1.0,0.08434650455927052,0.9156534954407295,1220,0.26177811550151975,0.27469604863221886,0.4635258358662614
1308,021,2982,219,745,757,2763,2982,1.0,0.07344064386317907,0.9265593561368209,1480,0.24983232729711602,0.25385647216633134,0.49631120053655264
1309,021,3180,70,889,1072,3110,3180,1.0,0.0220125786163522,0.9779874213836478,1219,0.27955974842767295,0.3371069182389937,0.38333333333333336
1310,021,3229,259,745,534,2970,3229,1.0,0.08021059151440074,0.9197894084855992,1950,0.23072158563022607,0.16537627748528957,0.6039021368844844
1311,021,4515,194,1064,1483,4321,4515,1.0,0.04296788482834994,0.9570321151716501,1968,0.23565891472868217,0.3284606866002215,0.43588039867109635
1312,021,2552,165,434,591,2387,2552,1.0,0.06465517241379311,0.9353448275862069,1527,0.1700626959247649,0.23158307210031348,0.5983542319749217
1313,021,3677,162,1037,1396,3515,3677,1.0,0.04405765569757955,0.9559423443024204,1244,0.28202338863203696,0.37965732934457436,0.3383192820233886
1314,021,3707,95,885,1220,3612,3707,1.0,0.025627191799298624,0.9743728082007014,1602,0.23873752360399245,0.3291070946857297,0.43215538171027784
1315,021,3962,149,912,1469,3813,3962,1.0,0.03760726905603231,0.9623927309439677,1581,0.23018677435638565,0.3707723372034326,0.3990408884401817
1316,021,3200,94,538,898,3106,3200,1.0,0.029375,0.970625,1764,0.168125,0.280625,0.55125
1317,021,4081,100,796,1319,3981,4081,1.0,0.02450379808870375,0.9754962019112963,1966,0.19505023278608186,0.3232050967900025,0.4817446704239157
1318,021,4172,124,786,1490,4048,4172,1.0,0.029721955896452542,0.9702780441035475,1896,0.188398849472675,0.35714285714285715,0.45445829338446786
1319,021,3179,118,563,1416,3061,3179,1.0,0.03711859075180875,0.9628814092481912,1200,0.17709971689210444,0.44542308902170497,0.3774771940861906
1320,021,2676,64,597,1250,2612,2676,1.0,0.02391629297458894,0.976083707025411,829,0.22309417040358745,0.4671150971599402,0.30979073243647237
1321,021,3156,124,643,1033,3032,3156,1.0,0.03929024081115336,0.9607097591888466,1480,0.20373891001267427,0.32731305449936626,0.46894803548795944
1322,021,3138,80,937,1456,3058,3138,1.0,0.025493945188017845,0.9745060548119822,745,0.29859783301465903,0.4639898024219248,0.2374123645634162
1323,021,892,16,137,364,876,892,1.0,0.017937219730941704,0.9820627802690582,391,0.15358744394618834,0.4080717488789238,0.4383408071748879
1324,021,1940,81,737,409,1859,1940,1.0,0.041752577319587626,0.9582474226804124,794,0.37989690721649483,0.21082474226804124,0.4092783505154639
1325,021,44,1,4,27,43,44,1.0,0.022727272727272728,0.9772727272727273,13,0.09090909090909091,0.6136363636363636,0.29545454545454547
1326,021,193,10,28,84,183,193,1.0,0.05181347150259067,0.9481865284974094,81,0.14507772020725387,0.43523316062176165,0.41968911917098445
1327,021,332,324,138,11,8,332,1.0,0.9759036144578314,0.024096385542168676,183,0.41566265060240964,0.03313253012048193,0.5512048192771084
1328,021,2253,132,406,914,2121,2253,1.0,0.05858854860186418,0.9414114513981359,933,0.18020417221482468,0.4056813138038171,0.4141145139813582
1329,021,3627,238,727,1061,3389,3627,1.0,0.06561896884477529,0.9343810311552248,1839,0.2004411359250069,0.29252826027019574,0.5070306038047974
1330,021,3561,128,607,1215,3433,3561,1.0,0.035944959281100815,0.9640550407188991,1739,0.17045773659084526,0.34119629317607414,0.4883459702330806
1331,021,2748,82,703,1430,2666,2748,1.0,0.029839883551673944,0.970160116448326,615,0.25582241630276564,0.5203784570596798,0.22379912663755458
1332,021,2576,82,441,1050,2494,2576,1.0,0.03183229813664596,0.968167701863354,1085,0.17119565217391305,0.4076086956521739,0.421195652173913
1333,021,4369,92,893,1470,4277,4369,1.0,0.021057450217441064,0.9789425497825589,2006,0.20439459830624856,0.3364614328221561,0.4591439688715953
1334,021,1291,1224,415,45,67,1291,1.0,0.9481022463206816,0.051897753679318356,831,0.3214562354763749,0.034856700232378,0.6436870642912471
1335,021,1834,1712,422,63,122,1834,1.0,0.9334787350054525,0.06652126499454744,1349,0.2300981461286805,0.03435114503816794,0.7355507088331515
1336,021,1606,1537,438,58,69,1606,1.0,0.9570361145703612,0.04296388542963885,1110,0.2727272727272727,0.0361145703611457,0.6911581569115816
1337,021,2642,74,417,701,2568,2642,1.0,0.028009084027252083,0.9719909159727479,1524,0.1578349735049205,0.26532929598788796,0.5768357305071915
1338,021,3405,26,894,1507,3379,3405,1.0,0.0076358296622613805,0.9923641703377386,1004,0.26255506607929513,0.44258443465491926,0.2948604992657856
1339,021,2197,24,511,877,2173,2197,1.0,0.010923987255348202,0.9890760127446518,809,0.2325898953117888,0.3991807009558489,0.3682294037323623
1340,021,2063,112,376,687,1951,2063,1.0,0.05428986912263694,0.9457101308773631,1000,0.18225884634028114,0.3330101793504605,0.4847309743092584
1341,021,4897,136,1279,1849,4761,4897,1.0,0.027772105370635083,0.9722278946293649,1769,0.261180314478252,0.3775781090463549,0.3612415764753931
1342,021,2393,66,570,856,2327,2393,1.0,0.027580442958629336,0.9724195570413706,967,0.2381947346427079,0.357709987463435,0.4040952778938571
1343,021,5317,210,1132,2078,5107,5317,1.0,0.039495956366372015,0.960504043633628,2107,0.21290201241301485,0.39082189204438594,0.3962760955425992
1344,021,3108,111,597,1379,2997,3108,1.0,0.03571428571428571,0.9642857142857143,1132,0.1920849420849421,0.4436936936936937,0.3642213642213642
1345,021,1309,27,324,640,1282,1309,1.0,0.020626432391138275,0.9793735676088617,345,0.2475171886936593,0.48892284186401835,0.2635599694423224
1346,021,2194,93,711,714,2101,2194,1.0,0.04238833181403829,0.9576116681859617,769,0.3240656335460346,0.325432999088423,0.3505013673655424
1347,021,3570,128,1128,1070,3442,3570,1.0,0.035854341736694675,0.9641456582633053,1372,0.31596638655462184,0.29971988795518206,0.3843137254901961
1348,021,4039,154,948,1489,3885,4039,1.0,0.038128249566724434,0.9618717504332756,1602,0.23471156226788809,0.36865560782371876,0.39663282990839316
1349,021,4055,126,851,1583,3929,4055,1.0,0.031072749691738594,0.9689272503082614,1621,0.20986436498150432,0.3903822441430333,0.3997533908754624
1350,021,669,585,279,45,84,669,1.0,0.874439461883408,0.12556053811659193,345,0.4170403587443946,0.06726457399103139,0.515695067264574
1351,021,3421,145,1053,1202,3276,3421,1.0,0.04238526746565332,0.9576147325343467,1166,0.30780473545746856,0.35135925168079507,0.3408360128617363
1352,021,3828,170,1200,1240,3658,3828,1.0,0.044409613375130615,0.9555903866248694,1388,0.31347962382445144,0.3239289446185998,0.3625914315569488
1353,021,7825,270,2495,2853,7555,7825,1.0,0.03450479233226837,0.9654952076677317,2477,0.31884984025559104,0.3646006389776358,0.3165495207667732
1354,021,4169,142,1012,1176,4027,4169,1.0,0.03406092588150636,0.9659390741184937,1981,0.24274406332453827,0.28208203406092586,0.47517390261453585
1355,021,1894,203,376,264,1691,1894,1.0,0.10718057022175291,0.8928194297782471,1254,0.19852164730728616,0.13938753959873285,0.662090813093981
1356,021,3766,193,970,1443,3573,3766,1.0,0.05124800849707913,0.9487519915029209,1353,0.2575677110993096,0.3831651619755709,0.3592671269251195
1357,021,1348,20,382,604,1328,1348,1.0,0.01483679525222552,0.9851632047477745,362,0.28338278931750743,0.44807121661721067,0.2685459940652819
1358,021,3637,147,883,1460,3490,3637,1.0,0.04041792686279901,0.959582073137201,1294,0.24278251306021445,0.4014297497937861,0.3557877371459994
1359,021,5848,185,1474,2337,5663,5848,1.0,0.03163474692202462,0.9683652530779754,2037,0.25205198358413133,0.39962380300957595,0.34832421340629277
1360,021,3699,146,910,1149,3553,3699,1.0,0.03947012706136794,0.960529872938632,1640,0.2460124357934577,0.31062449310624496,0.4433630711002974
1361,021,9102,226,1929,4435,8876,9102,1.0,0.024829707756537023,0.975170292243463,2738,0.2119314436387607,0.48725554823115796,0.3008130081300813
1362,021,4749,149,806,1920,4600,4749,1.0,0.03137502632133081,0.9686249736786692,2023,0.16971994104021898,0.40429564118761846,0.42598441777216256
1363,021,3198,156,1015,812,3042,3198,1.0,0.04878048780487805,0.9512195121951219,1371,0.31738586616635395,0.25390869293308316,0.42870544090056284
1364,021,2229,138,425,855,2091,2229,1.0,0.06191117092866756,0.9380888290713324,949,0.19066846119336026,0.3835800807537012,0.4257514580529385
1365,021,4201,84,1562,1848,4117,4201,1.0,0.019995239228755058,0.980004760771245,791,0.37181623422994525,0.4398952630326113,0.18828850273744346
1366,021,1631,73,616,591,1558,1631,1.0,0.04475781729000613,0.9552421827099938,424,0.3776824034334764,0.3623543838136113,0.25996321275291234
1367,021,4120,181,976,1496,3939,4120,1.0,0.043932038834951455,0.9560679611650486,1648,0.23689320388349513,0.36310679611650487,0.4
1368,021,3594,93,760,1389,3501,3594,1.0,0.02587646076794658,0.9741235392320534,1445,0.21146355036171396,0.38647746243739567,0.4020589872008904
1369,021,2477,76,439,1174,2401,2477,1.0,0.03068227694792087,0.9693177230520791,864,0.17723052079127977,0.473960436011304,0.34880904319741624
1370,021,3680,141,935,1339,3539,3680,1.0,0.03831521739130435,0.9616847826086956,1406,0.25407608695652173,0.36385869565217394,0.38206521739130433
1371,021,2855,106,630,1175,2749,2855,1.0,0.03712784588441331,0.9628721541155867,1050,0.22066549912434325,0.4115586690017513,0.36777583187390545
1372,021,3687,200,790,1200,3487,3687,1.0,0.05424464334147003,0.9457553566585299,1697,0.2142663411988066,0.32546786004882017,0.4602657987523732
1373,021,4009,163,1278,1146,3846,4009,1.0,0.04065851833374907,0.9593414816662509,1585,0.3187827388376154,0.2858568221501621,0.3953604390122225
1374,021,3521,133,1096,944,3388,3521,1.0,0.03777335984095427,0.9622266401590457,1481,0.31127520590741264,0.2681056518034649,0.4206191422891224
1375,021,4818,210,1481,1617,4608,4818,1.0,0.043586550435865505,0.9564134495641345,1720,0.3073889580738896,0.3356164383561644,0.35699460356994606
1377,021,469,14,80,138,455,469,1.0,0.029850746268656716,0.9701492537313433,251,0.17057569296375266,0.2942430703624733,0.535181236673774
1378,021,274,14,51,57,260,274,1.0,0.051094890510948905,0.948905109489051,166,0.18613138686131386,0.20802919708029197,0.6058394160583942
1379,023,747,20,293,66,727,747,1.0,0.02677376171352075,0.9732262382864793,388,0.392235609103079,0.08835341365461848,0.5194109772423026
1380,023,2237,20,641,161,2217,2237,1.0,0.008940545373267769,0.9910594546267323,1435,0.286544479213232,0.07197139025480555,0.6414841305319624
1381,023,1084,10,385,130,1074,1084,1.0,0.00922509225092251,0.9907749077490775,569,0.3551660516605166,0.11992619926199262,0.5249077490774908
1382,023,718,7,188,58,711,718,1.0,0.009749303621169917,0.9902506963788301,472,0.2618384401114206,0.0807799442896936,0.6573816155988857
1383,023,1354,14,694,218,1340,1354,1.0,0.0103397341211226,0.9896602658788775,442,0.5125553914327917,0.16100443131462333,0.32644017725258495
1384,023,646,22,221,354,624,646,1.0,0.034055727554179564,0.9659442724458205,71,0.34210526315789475,0.5479876160990712,0.10990712074303406
1385,023,4351,108,1691,1046,4243,4351,1.0,0.024821880027579867,0.9751781199724201,1614,0.388646288209607,0.24040450471156055,0.37094920707883244
1386,023,2472,51,1069,284,2421,2472,1.0,0.02063106796116505,0.9793689320388349,1119,0.4324433656957929,0.11488673139158576,0.4526699029126214
1387,023,663,5,174,80,658,663,1.0,0.007541478129713424,0.9924585218702866,409,0.26244343891402716,0.12066365007541478,0.6168929110105581
1388,023,1599,35,491,158,1564,1599,1.0,0.021888680425265792,0.9781113195747342,950,0.3070669168230144,0.09881175734834272,0.5941213258286429
1389,023,2084,59,1008,605,2025,2084,1.0,0.02831094049904031,0.9716890595009597,471,0.4836852207293666,0.2903071017274472,0.22600767754318618
1390,023,845,13,310,81,832,845,1.0,0.015384615384615385,0.9846153846153847,454,0.3668639053254438,0.09585798816568047,0.5372781065088758
1391,023,492,17,178,108,475,492,1.0,0.034552845528455285,0.9654471544715447,206,0.3617886178861789,0.21951219512195122,0.4186991869918699
1392,023,953,27,496,246,926,953,1.0,0.02833158447009444,0.9716684155299056,211,0.5204616998950682,0.25813221406086045,0.22140608604407136
1393,023,940,24,290,525,916,940,1.0,0.02553191489361702,0.9744680851063829,125,0.30851063829787234,0.5585106382978723,0.13297872340425532
1394,023,700,10,205,82,690,700,1.0,0.014285714285714285,0.9857142857142858,413,0.29285714285714287,0.11714285714285715,0.59
1395,023,3823,56,1444,639,3767,3823,1.0,0.014648182055976981,0.985351817944023,1740,0.3777138373005493,0.1671462202458802,0.4551399424535705
1396,023,606,14,317,140,592,606,1.0,0.0231023102310231,0.976897689768977,149,0.523102310231023,0.23102310231023102,0.24587458745874588
1397,023,3451,69,1229,515,3382,3451,1.0,0.01999420457838308,0.9800057954216169,1707,0.35612865835989566,0.14923210663575776,0.4946392350043466
1398,023,1447,24,517,135,1423,1447,1.0,0.0165860400829302,0.9834139599170698,795,0.35729094678645473,0.09329647546648238,0.5494125777470629
1399,023,3096,77,972,402,3019,3096,1.0,0.02487080103359173,0.9751291989664083,1722,0.313953488372093,0.1298449612403101,0.5562015503875969
1400,023,676,1,226,81,675,676,1.0,0.0014792899408284023,0.9985207100591716,369,0.3343195266272189,0.11982248520710059,0.5458579881656804
1401,023,71,10,26,26,61,71,1.0,0.14084507042253522,0.8591549295774648,19,0.36619718309859156,0.36619718309859156,0.2676056338028169
1402,023,160,7,73,54,153,160,1.0,0.04375,0.95625,33,0.45625,0.3375,0.20625
1403,025,10387,370,1592,5725,10017,10387,1.0,0.03562144988928468,0.9643785501107153,3070,0.15326850871281408,0.551169731395013,0.2955617598921729
1405,025,10242,269,2250,5132,9973,10242,1.0,0.02626440148408514,0.9737355985159148,2860,0.21968365553602812,0.5010740089826206,0.2792423354813513
1406,025,9030,318,2764,3166,8712,9030,1.0,0.03521594684385382,0.9647840531561461,3100,0.3060908084163898,0.350609080841639,0.3433001107419712
1407,025,5799,170,1888,2512,5629,5799,1.0,0.029315399206759785,0.9706846007932403,1399,0.32557337471977926,0.43317813416106227,0.24124849111915847
1408,025,9977,317,2985,4909,9660,9977,1.0,0.03177307807958304,0.9682269219204169,2083,0.299188132705222,0.49203167284754934,0.20878019444722862
1409,025,4772,73,1141,3266,4699,4772,1.0,0.015297569153394803,0.9847024308466052,365,0.23910310142497904,0.684409052808047,0.07648784576697401
1410,025,8628,357,1572,3196,8271,8628,1.0,0.041376912378303196,0.9586230876216968,3860,0.18219749652294853,0.3704218822438572,0.4473806212331943
1411,025,1167,64,153,638,1103,1167,1.0,0.054841473864610114,0.9451585261353899,376,0.13110539845758354,0.5467009425878321,0.3221936589545844
1412,025,1525,77,140,655,1448,1525,1.0,0.050491803278688525,0.9495081967213115,730,0.09180327868852459,0.42950819672131146,0.4786885245901639
1413,025,61,1,13,19,60,61,1.0,0.01639344262295082,0.9836065573770492,29,0.21311475409836064,0.3114754098360656,0.47540983606557374
1414,025,1979,76,280,1044,1903,1979,1.0,0.03840323395654371,0.9615967660434563,655,0.1414855987872663,0.5275391611925214,0.3309752400202122
1415,025,1100,19,270,729,1081,1100,1.0,0.017272727272727273,0.9827272727272728,101,0.24545454545454545,0.6627272727272727,0.09181818181818181
1416,025,7869,176,2916,3538,7693,7869,1.0,0.0223662472995298,0.9776337527004701,1415,0.37056805184902786,0.4496124031007752,0.17981954505019698
1417,025,6670,168,1839,3790,6502,6670,1.0,0.025187406296851574,0.9748125937031484,1041,0.275712143928036,0.568215892053973,0.156071964017991
1418,025,79,3,2,76,76,79,1.1470588235294117,0.0379746835443038,0.9620253164556962,1,0.02531645569620253,0.9620253164556962,0.012658227848101266
1419,025,969,36,150,487,933,969,1.0,0.03715170278637771,0.9628482972136223,332,0.15479876160990713,0.5025799793601651,0.34262125902992774
1420,025,435,25,86,267,410,435,1.0,0.05747126436781609,0.9425287356321839,82,0.19770114942528735,0.6137931034482759,0.18850574712643678
1421,025,88,8,16,38,80,88,1.0,0.09090909090909091,0.9090909090909091,34,0.18181818181818182,0.4318181818181818,0.38636363636363635
1422,025,1023,34,194,554,989,1023,1.0,0.033235581622678395,0.9667644183773216,275,0.18963831867057673,0.541544477028348,0.26881720430107525
1423,025,62,2,7,23,60,62,1.0,0.03225806451612903,0.967741935483871,32,0.11290322580645161,0.3709677419354839,0.5161290322580645
1424,025,14383,535,2994,6217,13848,14383,1.0,0.037196690537440034,0.96280330946256,5172,0.2081624139609261,0.4322464020023639,0.35959118403671003
1425,025,8168,291,1620,4626,7877,8168,1.0,0.035626836434867776,0.9643731635651323,1922,0.19833496571988246,0.566356513222331,0.2353085210577865
1426,025,6200,157,2789,2010,6043,6200,1.0,0.02532258064516129,0.9746774193548388,1401,0.44983870967741935,0.3241935483870968,0.22596774193548388
1427,025,11217,328,3131,4113,10889,11217,1.0,0.02924133012391905,0.970758669876081,3973,0.27912989212802,0.36667558170633857,0.35419452616564145
1428,025,10097,394,2668,3516,9703,10097,1.0,0.039021491532138255,0.9609785084678617,3913,0.2642369020501139,0.3482222442309597,0.38754085371892644
1429,025,88,3,21,42,85,88,1.0,0.03409090909090909,0.9659090909090909,25,0.23863636363636365,0.4772727272727273,0.2840909090909091
1430,025,3335,123,997,1374,3212,3335,1.0,0.036881559220389805,0.9631184407796102,964,0.2989505247376312,0.41199400299850075,0.2890554722638681
1431,025,7074,153,3423,2118,6921,7074,1.0,0.021628498727735368,0.9783715012722646,1533,0.48388464800678543,0.29940627650551316,0.21670907548770144
1432,025,848,42,125,429,806,848,1.0,0.049528301886792456,0.9504716981132075,294,0.1474056603773585,0.5058962264150944,0.3466981132075472
1433,025,429,14,109,266,415,429,1.0,0.03263403263403263,0.9673659673659674,54,0.2540792540792541,0.62004662004662,0.1258741258741259
1434,025,4903,200,811,2316,4703,4903,1.0,0.040791352233326535,0.9592086477666735,1776,0.1654089333061391,0.4723638588619213,0.3622272078319396
1435,025,5245,132,1286,2974,5113,5245,1.0,0.02516682554814109,0.9748331744518589,985,0.2451858913250715,0.5670162059103908,0.18779790276453764
1436,025,11690,283,2957,5512,11407,11690,1.0,0.024208725406330196,0.9757912745936698,3221,0.25295124037639005,0.47151411462788706,0.27553464499572283
1437,025,9791,1028,1726,4184,8763,9791,1.0,0.10499438259626187,0.8950056174037381,3881,0.17628434276376265,0.42733122255132266,0.39638443468491474
1438,025,2396,83,360,1287,2313,2396,1.0,0.034641068447412354,0.9653589315525877,749,0.15025041736227046,0.5371452420701168,0.3126043405676127
1439,025,91,2,15,75,89,91,1.0344827586206897,0.02197802197802198,0.978021978021978,1,0.16483516483516483,0.8241758241758241,0.01098901098901099
1440,025,8768,382,1243,4547,8386,8768,1.0,0.04356751824817518,0.9564324817518248,2978,0.1417655109489051,0.5185903284671532,0.3396441605839416
1441,025,3400,218,1271,1152,3182,3400,1.0,0.06411764705882353,0.9358823529411765,977,0.3738235294117647,0.3388235294117647,0.2873529411764706
1442,025,119,10,35,29,109,119,1.0,0.08403361344537816,0.9159663865546218,55,0.29411764705882354,0.24369747899159663,0.46218487394957986
1443,025,641,12,129,446,629,641,1.0,0.0187207488299532,0.9812792511700468,66,0.20124804992199688,0.6957878315132605,0.1029641185647426
1444,025,416,6,114,266,410,416,1.0,0.014423076923076924,0.9855769230769231,36,0.27403846153846156,0.6394230769230769,0.08653846153846154
1445,025,4152,289,924,1652,3863,4152,1.0,0.06960500963391136,0.9303949903660886,1576,0.22254335260115607,0.3978805394990366,0.37957610789980734
1446,025,3673,97,555,2545,3576,3673,1.0,0.02640893002994827,0.9735910699700517,573,0.151102640893003,0.6928940920228696,0.15600326708412743
1447,025,165,6,41,67,159,165,1.0,0.03636363636363636,0.9636363636363636,57,0.24848484848484848,0.40606060606060607,0.34545454545454546
1448,027,2495,121,510,260,2374,2495,1.0,0.04849699398797595,0.9515030060120241,1725,0.20440881763527055,0.10420841683366733,0.6913827655310621
1449,027,2245,68,533,388,2177,2245,1.0,0.030289532293986638,0.9697104677060133,1324,0.2374164810690423,0.17282850779510023,0.5897550111358575
1450,027,3528,165,546,386,3363,3528,1.0,0.0467687074829932,0.9532312925170068,2596,0.15476190476190477,0.10941043083900227,0.735827664399093
1451,027,5911,174,1515,1208,5737,5911,1.0,0.029436643545931316,0.9705633564540687,3188,0.25630181018440196,0.20436474369818983,0.5393334461174082
1452,027,3153,71,754,1234,3082,3153,1.0,0.02251823660006343,0.9774817633999365,1165,0.2391373295274342,0.3913732952743419,0.3694893751982239
1453,027,3963,71,1060,580,3892,3963,1.0,0.01791572041382791,0.9820842795861721,2323,0.2674741357557406,0.14635377239465053,0.5861720918496088
1454,027,5896,92,1554,556,5804,5896,1.0,0.015603799185888738,0.9843962008141113,3786,0.2635685210312076,0.09430122116689281,0.6421302578018996
1455,027,2091,37,427,635,2054,2091,1.0,0.017694882831181254,0.9823051171688187,1029,0.20420851267336204,0.3036824485891918,0.4921090387374462
1456,027,4008,132,450,1443,3876,4008,1.0,0.03293413173652695,0.9670658682634731,2115,0.1122754491017964,0.36002994011976047,0.5276946107784432
1457,027,7840,229,1543,2516,7611,7840,1.0,0.029209183673469388,0.9707908163265306,3781,0.1968112244897959,0.3209183673469388,0.48227040816326533
1458,027,3331,112,728,1234,3219,3331,1.0,0.03362353647553287,0.9663764635244672,1369,0.21855298709096369,0.37045932152506755,0.4109876913839688
1459,027,3135,102,599,1142,3033,3135,1.0,0.03253588516746411,0.9674641148325359,1394,0.19106858054226475,0.36427432216905903,0.44465709728867625
1460,027,3429,97,735,531,3332,3429,1.0,0.028288130650335374,0.9717118693496646,2163,0.21434820647419073,0.15485564304461943,0.6307961504811899
1461,027,928,37,207,219,891,928,1.0,0.03987068965517242,0.9601293103448276,502,0.22306034482758622,0.23599137931034483,0.540948275862069
1462,027,3968,156,854,1127,3812,3968,1.0,0.03931451612903226,0.9606854838709677,1987,0.21522177419354838,0.2840221774193548,0.5007560483870968
1463,027,3398,138,698,761,3260,3398,1.0,0.04061212477928193,0.9593878752207181,1939,0.20541494997057091,0.22395526780459094,0.5706297822248382
1464,027,5382,145,893,1838,5237,5382,1.0,0.026941657376439984,0.9730583426235601,2651,0.1659234485321442,0.34150873281308064,0.49256781865477517
1465,027,333,12,53,213,321,333,1.0,0.036036036036036036,0.963963963963964,67,0.15915915915915915,0.6396396396396397,0.2012012012012012
1466,027,287,0,55,62,287,287,1.0,0.0,1.0,170,0.1916376306620209,0.21602787456445993,0.5923344947735192
1467,027,3569,99,541,1449,3470,3569,1.0,0.027738862426449986,0.97226113757355,1579,0.15158307649201458,0.40599607733258614,0.4424208461753993
1468,027,1,1,0,0,0,1,1.0,1.0,0.0,1,0.0,0.0,1.0
1469,027,4538,148,864,1512,4390,4538,1.0,0.03261348611723226,0.9673865138827678,2162,0.19039224327897752,0.33318642573821067,0.4764213309828118
1470,027,3652,81,611,1301,3571,3652,1.0,0.02217962760131435,0.9778203723986857,1740,0.16730558598028478,0.3562431544359255,0.4764512595837897
1471,027,9660,256,1396,3633,9404,9660,1.0,0.02650103519668737,0.9734989648033127,4631,0.14451345755693581,0.3760869565217391,0.47939958592132503
1472,027,4576,86,780,1975,4490,4576,1.0,0.018793706293706292,0.9812062937062938,1821,0.17045454545454544,0.43159965034965037,0.3979458041958042
1473,027,1587,46,353,218,1541,1587,1.0,0.028985507246376812,0.9710144927536232,1016,0.22243226212980466,0.13736609955891618,0.6402016383112792
1474,027,1624,106,394,355,1518,1624,1.0,0.06527093596059114,0.9347290640394089,875,0.24261083743842365,0.2185960591133005,0.5387931034482759
1475,027,1182,185,309,178,997,1182,1.0,0.15651438240270726,0.8434856175972927,695,0.2614213197969543,0.1505922165820643,0.5879864636209814
1476,027,6502,67,1784,470,6435,6502,1.0,0.01030452168563519,0.9896954783143648,4248,0.274377114733928,0.0722854506305752,0.6533374346354968
1477,027,4601,75,1498,482,4526,4601,1.0,0.01630080417300587,0.9836991958269942,2621,0.32558139534883723,0.10475983481851771,0.5696587698326451
1478,027,14463,325,2421,865,14138,14463,1.0,0.022471133236534605,0.9775288667634654,11177,0.16739265712507778,0.059807785383392105,0.7727995574915301
1479,027,2422,167,567,347,2255,2422,1.0,0.06895127993393889,0.9310487200660611,1508,0.23410404624277456,0.14327002477291495,0.6226259289843105
1480,027,940,38,192,286,902,940,1.0,0.04042553191489362,0.9595744680851064,462,0.20425531914893616,0.30425531914893617,0.49148936170212765
1481,027,927,33,182,482,894,927,1.0,0.03559870550161812,0.9644012944983819,263,0.19633225458468176,0.5199568500539374,0.2837108953613808
1482,027,2774,122,620,801,2652,2774,1.0,0.04397981254506128,0.9560201874549387,1353,0.22350396539293438,0.28875270367700073,0.4877433309300649
1483,027,3666,154,850,869,3512,3666,1.0,0.042007637752318604,0.9579923622476814,1947,0.23186033824331698,0.23704309874522642,0.5310965630114566
1484,027,3358,159,850,565,3199,3358,1.0,0.047349612864800474,0.9526503871351996,1943,0.2531268612269208,0.16825491363907089,0.5786182251340083
1485,027,3205,145,797,731,3060,3205,1.0,0.0452418096723869,0.9547581903276131,1677,0.2486739469578783,0.2280811232449298,0.5232449297971918
1486,027,3424,133,754,828,3291,3424,1.0,0.038843457943925234,0.9611565420560748,1842,0.22021028037383178,0.24182242990654207,0.5379672897196262
1487,027,3101,94,714,827,3007,3101,1.0,0.03031280232183167,0.9696871976781684,1560,0.23024830699774265,0.2666881651080297,0.5030635278942277
1488,027,3430,129,888,998,3301,3430,1.0,0.03760932944606414,0.9623906705539359,1544,0.2588921282798834,0.2909620991253644,0.4501457725947522
1489,027,4601,120,1120,1011,4481,4601,1.0,0.02608128667680939,0.9739187133231906,2470,0.24342534231688764,0.21973484025211912,0.5368398174309933
1490,027,45,5,11,18,40,45,1.0,0.1111111111111111,0.8888888888888888,16,0.24444444444444444,0.4,0.35555555555555557
